<unk>	spn
а	ɑ
абрамов	ɑ b r ɑ m o v
ав	ɑ v
авалтанах	ɑ v ɑ l t ɑ n ɑ χ
аван	ɑ v ɑ n
аванах	ɑ v ɑ n ɑ χ
авангард	ɑ v ɑ n g ɑ r d
аванмарланать	ɑ v ɑ n m ɑ r l ɑ n ɑ t
авариллӗ	ɑ v ɑ r i lː ɛ
аваринче	ɑ v ɑ r i n tʃ e
авиакомпани	ɑ v i ɑ k o m p ɑ n i
авланас	ɑ v l ɑ n ɑ s
авланни	ɑ v l ɑ nː i
авланнӑскерсем	ɑ v l ɑ nː ʌ s k e r s e m
автобус	ɑ v t o b u s
автобуссем	ɑ v t o b u sː e m
автобуссен	ɑ v t o b u sː e n
автобуссене	ɑ v t o b u sː e n e
автобусӑн	ɑ v t o b u s ʌ n
автобусӗ	ɑ v t o b u s ɛ
автобусӗсем	ɑ v t o b u s ɛ s e m
автомачӗсем	ɑ v t o m ɑ tʃ ɛ s e m
автомобиль	ɑ v t o m o b i l
автономисем	ɑ v t o n o m i s e m
автопавильон	ɑ v t o p ɑ v i l o n
автор	ɑ v t o r
авторне	ɑ v t o r n e
авторсен	ɑ v t o r s e n
авторӗсем	ɑ v t o r ɛ s e m
авторӗсен	ɑ v t o r ɛ s e n
автохула	ɑ v t o χ u l ɑ
авӑн	ɑ v ʌ n
авӑнчӗ	ɑ v ʌ n tʃ ɛ
агентстви	ɑ g e n ts t v i
агентствин	ɑ g e n ts t v i n
агрегат	ɑ g r e g ɑ t
агрофирма	ɑ g r o f i r m ɑ
агрофирмӑра	ɑ g r o f i r m ʌ r ɑ
административлӑ	ɑ d m i n i s t r ɑ t i v l ʌ
администраци	ɑ d m i n i s t r ɑ ts i
администрацийӗ	ɑ d m i n i s t r ɑ ts i j ɛ
администрацийӗн	ɑ d m i n i s t r ɑ ts i j ɛ n
администрацийӗнче	ɑ d m i n i s t r ɑ ts i j ɛ n tʃ e
администраципе	ɑ d m i n i s t r ɑ ts i p e
адрес	ɑ d r e s
адреса	ɑ d r e s ɑ
ай	ɑ j
айккалла	ɑ j kː ɑ lː ɑ
айккинче	ɑ j kː i n tʃ e
айне	ɑ j n e
айтар	ɑ j t ɑ r
айӑпа	ɑ j ʌ p ɑ
айӑплава	ɑ j ʌ p l ɑ v ɑ
айӑплама	ɑ j ʌ p l ɑ m ɑ
айӑпланнӑ	ɑ j ʌ p l ɑ nː ʌ
айӑпланӑ	ɑ j ʌ p l ɑ n ʌ
айӑпласшӑн	ɑ j ʌ p l ɑ s ʃ ʌ n
айӑплать	ɑ j ʌ p l ɑ t
айӑплисене	ɑ j ʌ p l i s e n e
айӑплӑ	ɑ j ʌ p l ʌ
айӑпне	ɑ j ʌ p n e
айӑпӗн	ɑ j ʌ p ɛ n
айӗнче	ɑ j ɛ n tʃ e
айӗнчен	ɑ j ɛ n tʃ e n
ак	ɑ k
ака	ɑ k ɑ
академи	ɑ k ɑ d e m i
акана	ɑ k ɑ n ɑ
акашевская	ɑ k ɑ ʃ e v s k ɑ j ɑ
аккордеон	ɑ kː o r d e o n
аккумуляторпа	ɑ kː u m u l j ɑ t o r p ɑ
акриппин	ɑ k r i pː i n
акробатсем	ɑ k r o b ɑ ts e m
актера	ɑ k t e r ɑ
акушерка	ɑ k u ʃ e r k ɑ
акцентсӑрах	ɑ k ts e n ts ʌ r ɑ χ
акцие	ɑ k ts i e
акцийӗ	ɑ k ts i j ɛ
акӑ	ɑ k ʌ
акӑлчанла	ɑ k ʌ l tʃ ɑ n l ɑ
ал	ɑ l
албанири	ɑ l b ɑ n i r i
александр	ɑ l e k s ɑ n d r
александровна	ɑ l e k s ɑ n d r o v n ɑ
александрӑшӑн	ɑ l e k s ɑ n d r ʌ ʃ ʌ n
алексей	ɑ l e k s e j
алеша	ɑ l e ʃ ɑ
алешӑна	ɑ l e ʃ ʌ n ɑ
алешӑпа	ɑ l e ʃ ʌ p ɑ
алинӑна	ɑ l i n ʌ n ɑ
алкогольпе	ɑ l k o g o l p e
алла	ɑ lː ɑ
алли	ɑ lː i
алли-урине	ɑ lː i u r i n e
аллине	ɑ lː i n e
аллинчи	ɑ lː i n tʃ i
аллипе	ɑ lː i p e
аллисем	ɑ lː i s e m
алмаэпа	ɑ l m ɑ e p ɑ
алхасать-и	ɑ l χ ɑ s ɑ t i
алхасма	ɑ l χ ɑ s m ɑ
алхаснӑ	ɑ l χ ɑ s n ʌ
альпака	ɑ l p ɑ k ɑ
альпакӑн	ɑ l p ɑ k ʌ n
алякинсем	ɑ l j ɑ k i n s e m
алӑ	ɑ l ʌ
алӑк	ɑ l ʌ k
алӑкне	ɑ l ʌ k n e
алӑкӗ	ɑ l ʌ k ɛ
алӑкӗсем	ɑ l ʌ k ɛ s e m
алӑкӗсене	ɑ l ʌ k ɛ s e n e
алӑпах	ɑ l ʌ p ɑ χ
алӗҫ	ɑ l ɛ ɕ
амаланнине	ɑ m ɑ l ɑ nː i n e
амантнӑ	ɑ m ɑ n t n ʌ
амантрӗҫ	ɑ m ɑ n t r ɛ ɕ
амаҫури	ɑ m ɑ ɕ u r i
амаҫурире	ɑ m ɑ ɕ u r i r e
амирова	ɑ m i r o v ɑ
амӑшне	ɑ m ʌ ʃ n e
амӑшӗ	ɑ m ʌ ʃ ɛ
амӑшӗн	ɑ m ʌ ʃ ɛ n
амӑшӗпе	ɑ m ʌ ʃ ɛ p e
амӑшӗсем	ɑ m ʌ ʃ ɛ s e m
амӑшӗсене	ɑ m ʌ ʃ ɛ s e n e
ан	ɑ n
аналиэ	ɑ n ɑ l i e
аналиэа	ɑ n ɑ l i e ɑ
аналиэсем	ɑ n ɑ l i e s e m
аналиэӗ	ɑ n ɑ l i e ɛ
ананьевсен	ɑ n ɑ n e v s e n
анасем	ɑ n ɑ s e m
анаталла	ɑ n ɑ t ɑ lː ɑ
анатолий	ɑ n ɑ t o l i j
анать	ɑ n ɑ t
андрейӑн	ɑ n d r e j ʌ n
анлӑ	ɑ n l ʌ
анлӑлатасшӑн	ɑ n l ʌ l ɑ t ɑ s ʃ ʌ n
анлӑн	ɑ n l ʌ n
анне	ɑ nː e
аннен	ɑ nː e n
аннене	ɑ nː e n e
аннеҫӗм	ɑ nː e ɕ ɛ m
аннӑ	ɑ nː ʌ
аннӳне	ɑ nː y n e
ансан	ɑ n s ɑ n
ансат	ɑ n s ɑ t
ансатлатасси	ɑ n s ɑ t l ɑ t ɑ sː i
ансӑр	ɑ n s ʌ r
антарса	ɑ n t ɑ r s ɑ
антибиотик	ɑ n t i b i o t i k
антициклон	ɑ n t i ts i k l o n
антон	ɑ n t o n
антонова	ɑ n t o n o v ɑ
анчах	ɑ n tʃ ɑ χ
анчӗ	ɑ n tʃ ɛ
аньхой	ɑ n χ o j
аньцин	ɑ n ts i n
аньцина	ɑ n ts i n ɑ
аньцинра	ɑ n ts i n r ɑ
аня	ɑ n j ɑ
анӑҫӗнчи	ɑ n ʌ ɕ ɛ n tʃ i
апат	ɑ p ɑ t
апат-ҫимӗҫ	ɑ p ɑ t ɕ i m ɛ ɕ
апат-ҫимӗҫе	ɑ p ɑ t ɕ i m ɛ ɕ e
апат-ҫимӗҫӗн	ɑ p ɑ t ɕ i m ɛ ɕ ɛ n
апат-ҫимӗҫӗпе	ɑ p ɑ t ɕ i m ɛ ɕ ɛ p e
апата	ɑ p ɑ t ɑ
апатланайнӑ-ши	ɑ p ɑ t l ɑ n ɑ j n ʌ ʃ i
апатланаҫҫӗ	ɑ p ɑ t l ɑ n ɑ ɕː ɛ
апатланма	ɑ p ɑ t l ɑ n m ɑ
апатланнӑшӑн	ɑ p ɑ t l ɑ nː ʌ ʃ ʌ n
апатлантарма	ɑ p ɑ t l ɑ n t ɑ r m ɑ
апатлантармалли	ɑ p ɑ t l ɑ n t ɑ r m ɑ lː i
апатлантарнине	ɑ p ɑ t l ɑ n t ɑ r n i n e
апатланчӗ	ɑ p ɑ t l ɑ n tʃ ɛ
апатланӑвӗн	ɑ p ɑ t l ɑ n ʌ v ɛ n
апла	ɑ p l ɑ
апла-и	ɑ p l ɑ i
аппа	ɑ pː ɑ
аппам	ɑ pː ɑ m
аппарат	ɑ pː ɑ r ɑ t
аппаратпа	ɑ pː ɑ r ɑ t p ɑ
аппаратсем	ɑ pː ɑ r ɑ ts e m
аппаратура	ɑ pː ɑ r ɑ t u r ɑ
аппарачӗ	ɑ pː ɑ r ɑ tʃ ɛ
аппӑшӗ	ɑ pː ʌ ʃ ɛ
аптекӑра	ɑ p t e k ʌ r ɑ
аптӑранӑ	ɑ p t ʌ r ɑ n ʌ
аптӑранӑскер	ɑ p t ʌ r ɑ n ʌ s k e r
аптӑраса	ɑ p t ʌ r ɑ s ɑ
аптӑрасан	ɑ p t ʌ r ɑ s ɑ n
аптӑрать	ɑ p t ʌ r ɑ t
аптӑраҫҫӗ	ɑ p t ʌ r ɑ ɕː ɛ
апчхулатни	ɑ p tʃ χ u l ɑ t n i
апӑрша	ɑ p ʌ r ʃ ɑ
ара	ɑ r ɑ
араб	ɑ r ɑ b
арабсем	ɑ r ɑ b s e m
аран-аран	ɑ r ɑ n ɑ r ɑ n
аранах	ɑ r ɑ n ɑ χ
арестлесе	ɑ r e s t l e s e
арканнӑччӗ	ɑ r k ɑ nː ʌ tʃ tʃ ɛ
арккасси	ɑ r kː ɑ sː i
арпашӑнма	ɑ r p ɑ ʃ ʌ n m ɑ
артамонова	ɑ r t ɑ m o n o v ɑ
артем	ɑ r t e m
артемсӑр	ɑ r t e m s ʌ r
артист	ɑ r t i s t
артисчӗсемпе	ɑ r t i s tʃ ɛ s e m p e
артисчӗсене	ɑ r t i s tʃ ɛ s e n e
архимсем	ɑ r χ i m s e m
архимсенчен	ɑ r χ i m s e n tʃ e n
архиповӑна	ɑ r χ i p o v ʌ n ɑ
арҫын	ɑ r ɕ ɯ n
арҫын-спортсменсем	ɑ r ɕ ɯ n s p o r ts m e n s e m
арҫынна	ɑ r ɕ ɯ nː ɑ
арҫыннине	ɑ r ɕ ɯ nː i n e
арҫыннӑн	ɑ r ɕ ɯ nː ʌ n
арҫынсем	ɑ r ɕ ɯ n s e m
арҫынсемпе	ɑ r ɕ ɯ n s e m p e
арҫынӗсем	ɑ r ɕ ɯ n ɛ s e m
арӑм	ɑ r ʌ m
арӑма	ɑ r ʌ m ɑ
арӑмне	ɑ r ʌ m n e
арӑмпа	ɑ r ʌ m p ɑ
арӑмсене	ɑ r ʌ m s e n e
арӑмӗ	ɑ r ʌ m ɛ
арӑмӗн	ɑ r ʌ m ɛ n
арӑмӗпе	ɑ r ʌ m ɛ p e
ас	ɑ s
аса	ɑ s ɑ
асав	ɑ s ɑ v
асанне	ɑ s ɑ nː e
асапланма	ɑ s ɑ p l ɑ n m ɑ
асат	ɑ s ɑ t
асламӑшне	ɑ s l ɑ m ʌ ʃ n e
асламӑшӗ	ɑ s l ɑ m ʌ ʃ ɛ
асламӑшӗнче	ɑ s l ɑ m ʌ ʃ ɛ n tʃ e
асли	ɑ s l i
аслисем	ɑ s l i s e m
аслисен	ɑ s l i s e n
аслисене	ɑ s l i s e n e
аслӑ	ɑ s l ʌ
асра	ɑ s r ɑ
асран	ɑ s r ɑ n
асрах	ɑ s r ɑ χ
ассортименчӗ	ɑ sː o r t i m e n tʃ ɛ
астанара	ɑ s t ɑ n ɑ r ɑ
астрахань	ɑ s t r ɑ χ ɑ n
астӑвассах	ɑ s t ʌ v ɑ sː ɑ χ
астӑватӑн	ɑ s t ʌ v ɑ t ʌ n
астӑваҫҫех	ɑ s t ʌ v ɑ ɕː e χ
астӑвӑр	ɑ s t ʌ v ʌ r
асфальт	ɑ s f ɑ l t
асфальтлӑ	ɑ s f ɑ l t l ʌ
асӑнам	ɑ s ʌ n ɑ m
асӑнать	ɑ s ʌ n ɑ t
асӑнаҫҫӗ	ɑ s ʌ n ɑ ɕː ɛ
асӑнма	ɑ s ʌ n m ɑ
асӑнмалӑх	ɑ s ʌ n m ɑ l ʌ χ
асӑннӑ	ɑ s ʌ nː ʌ
асӑнса	ɑ s ʌ n s ɑ
асӑнсан	ɑ s ʌ n s ɑ n
асӑну	ɑ s ʌ n u
асӑрхаймарӗ	ɑ s ʌ r χ ɑ j m ɑ r ɛ
асӑрхаймарӗҫ	ɑ s ʌ r χ ɑ j m ɑ r ɛ ɕ
асӑрхаман	ɑ s ʌ r χ ɑ m ɑ n
асӑрхаман-и	ɑ s ʌ r χ ɑ m ɑ n i
асӑрханмалла	ɑ s ʌ r χ ɑ n m ɑ lː ɑ
асӑрханмалли	ɑ s ʌ r χ ɑ n m ɑ lː i
асӑрханмасӑр	ɑ s ʌ r χ ɑ n m ɑ s ʌ r
асӑрханса	ɑ s ʌ r χ ɑ n s ɑ
асӑрхануллӑ	ɑ s ʌ r χ ɑ n u lː ʌ
асӑрхануллӑрах	ɑ s ʌ r χ ɑ n u lː ʌ r ɑ χ
асӑрханӑ	ɑ s ʌ r χ ɑ n ʌ
асӑрхарӗ	ɑ s ʌ r χ ɑ r ɛ
асӑрхаса	ɑ s ʌ r χ ɑ s ɑ
асӑрхасан	ɑ s ʌ r χ ɑ s ɑ n
асӑрхаттарнипе	ɑ s ʌ r χ ɑ tː ɑ r n i p e
асӑрхаттарнипех	ɑ s ʌ r χ ɑ tː ɑ r n i p e χ
асӑрхаттару	ɑ s ʌ r χ ɑ tː ɑ r u
аталанакан	ɑ t ɑ l ɑ n ɑ k ɑ n
аталанассине	ɑ t ɑ l ɑ n ɑ sː i n e
аталанмалли	ɑ t ɑ l ɑ n m ɑ lː i
аталанманнине	ɑ t ɑ l ɑ n m ɑ nː i n e
аталанмашкӑн	ɑ t ɑ l ɑ n m ɑ ʃ k ʌ n
аталаннинче	ɑ t ɑ l ɑ nː i n tʃ e
аталаннипе	ɑ t ɑ l ɑ nː i p e
аталантарас	ɑ t ɑ l ɑ n t ɑ r ɑ s
аталантарассипе	ɑ t ɑ l ɑ n t ɑ r ɑ sː i p e
аталантарасшӑн	ɑ t ɑ l ɑ n t ɑ r ɑ s ʃ ʌ n
аталантарма	ɑ t ɑ l ɑ n t ɑ r m ɑ
аталантармашкӑн	ɑ t ɑ l ɑ n t ɑ r m ɑ ʃ k ʌ n
аталану	ɑ t ɑ l ɑ n u
аталанӑвне	ɑ t ɑ l ɑ n ʌ v n e
аталанӑвӗнчен	ɑ t ɑ l ɑ n ʌ v ɛ n tʃ e n
атлетика	ɑ t l e t i k ɑ
атлетсем	ɑ t l e ts e m
атлечӗпе	ɑ t l e tʃ ɛ p e
атмосфера	ɑ t m o s f e r ɑ
атте	ɑ tː e
аттине	ɑ tː i n e
атя	ɑ t j ɑ
атӑ	ɑ t ʌ
атӑ-пушмак	ɑ t ʌ p u ʃ m ɑ k
атӑл	ɑ t ʌ l
атӑла	ɑ t ʌ l ɑ
атӑлта	ɑ t ʌ l t ɑ
атӑлтан	ɑ t ʌ l t ɑ n
атӑлҫи	ɑ t ʌ l ɕ i
аукцион	ɑ u k ts i o n
афанасьев	ɑ f ɑ n ɑ s e v
афган	ɑ f g ɑ n
афганистана	ɑ f g ɑ n i s t ɑ n ɑ
афганистанра	ɑ f g ɑ n i s t ɑ n r ɑ
ах	ɑ χ
ахалех	ɑ χ ɑ l e χ
ахаль	ɑ χ ɑ l
ахальтен	ɑ χ ɑ l t e n
ахӑртнех	ɑ χ ʌ r t n e χ
ача	ɑ tʃ ɑ
ача-пӑча	ɑ tʃ ɑ p ʌ tʃ ɑ
ача-пӑчаллӑ	ɑ tʃ ɑ p ʌ tʃ ɑ lː ʌ
ачаллисем	ɑ tʃ ɑ lː i s e m
ачаллӑ	ɑ tʃ ɑ lː ʌ
ачаллӑскер	ɑ tʃ ɑ lː ʌ s k e r
ачалӑх	ɑ tʃ ɑ l ʌ χ
ачан	ɑ tʃ ɑ n
ачана	ɑ tʃ ɑ n ɑ
ачапа	ɑ tʃ ɑ p ɑ
ачаранах	ɑ tʃ ɑ r ɑ n ɑ χ
ачаранпах	ɑ tʃ ɑ r ɑ n p ɑ χ
ачасем	ɑ tʃ ɑ s e m
ачасемпе	ɑ tʃ ɑ s e m p e
ачасемшӗн	ɑ tʃ ɑ s e m ʃ ɛ n
ачасен	ɑ tʃ ɑ s e n
ачасене	ɑ tʃ ɑ s e n e
ачашларӗ	ɑ tʃ ɑ ʃ l ɑ r ɛ
ачашӑн	ɑ tʃ ɑ ʃ ʌ n
ачи	ɑ tʃ i
ачи-пӑчисем	ɑ tʃ i p ʌ tʃ i s e m
ачине	ɑ tʃ i n e
ачипе	ɑ tʃ i p e
ачисем	ɑ tʃ i s e m
ачисемпе	ɑ tʃ i s e m p e
ачисемшӗн	ɑ tʃ i s e m ʃ ɛ n
ачисене	ɑ tʃ i s e n e
ашак	ɑ ʃ ɑ k
ашшӗ	ɑ ʃː ɛ
ашшӗ-амӑшне	ɑ ʃː ɛ ɑ m ʌ ʃ n e
ашшӗ-амӑшӗ	ɑ ʃː ɛ ɑ m ʌ ʃ ɛ
ашшӗ-амӑшӗн	ɑ ʃː ɛ ɑ m ʌ ʃ ɛ n
ашшӗ-амӑшӗсӗр	ɑ ʃː ɛ ɑ m ʌ ʃ ɛ s ɛ r
ашшӗн	ɑ ʃː ɛ n
ашшӗне	ɑ ʃː ɛ n e
ашшӗпе	ɑ ʃː ɛ p e
ашшӗпе-амӑшне	ɑ ʃː ɛ p e ɑ m ʌ ʃ n e
ашӑрах	ɑ ʃ ʌ r ɑ χ
ашӗ	ɑ ʃ ɛ
аэропорт	ɑ e r o p o r t
аэропорта	ɑ e r o p o r t ɑ
аяккарах	ɑ j ɑ kː ɑ r ɑ χ
аякра	ɑ j ɑ k r ɑ
аякран	ɑ j ɑ k r ɑ n
аякри	ɑ j ɑ k r i
аялти	ɑ j ɑ l t i
аҫтаха	ɑ ɕ t ɑ χ ɑ
аҫтахана	ɑ ɕ t ɑ χ ɑ n ɑ
бал	b ɑ l
балет	b ɑ l e t
балкарсем	b ɑ l k ɑ r s e m
балкон	b ɑ l k o n
балл	b ɑ lː
банк	b ɑ n k
барановсен	b ɑ r ɑ n o v s e n
барӑшсем	b ɑ r ʌ ʃ s e m
батарейкӑсем	b ɑ t ɑ r e j k ʌ s e m
батарейкӑсемпе	b ɑ t ɑ r e j k ʌ s e m p e
батарейкӑсене	b ɑ t ɑ r e j k ʌ s e n e
батут	b ɑ t u t
башнине	b ɑ ʃ n i n e
бенэин	b e n e i n
бенэинӗ	b e n e i n ɛ
бенэопӑчкӑпа	b e n e o p ʌ tʃ k ʌ p ɑ
билет	b i l e t
биэон	b i e o n
блока	b l o k ɑ
больницине	b o l n i ts i n e
больницинче	b o l n i ts i n tʃ e
больницӑна	b o l n i ts ʌ n ɑ
больницӑран	b o l n i ts ʌ r ɑ n
бомба	b o m b ɑ
бомжсене	b o m ʒ s e n e
бор	b o r
британирен	b r i t ɑ n i r e n
бройлер	b r o j l e r
бронижилета	b r o n i ʒ i l e t ɑ
букваре	b u k v ɑ r e
букварь	b u k v ɑ r
буклет	b u k l e t
булат	b u l ɑ t
булка	b u l k ɑ
бульварӗпе	b u l v ɑ r ɛ p e
буржуйка	b u r ʒ u j k ɑ
бюджет	b j u d ʒ e t
бюджета	b j u d ʒ e t ɑ
бюджетпа	b j u d ʒ e t p ɑ
вайланса	v ɑ j l ɑ n s ɑ
вак-тӗвеке	v ɑ k t ɛ v e k e
ваканси	v ɑ k ɑ n s i
ваклама	v ɑ k l ɑ m ɑ
ваклать	v ɑ k l ɑ t
вакцина	v ɑ k ts i n ɑ
вакцинӑсем	v ɑ k ts i n ʌ s e m
валентинович	v ɑ l e n t i n o v i tʃ
валерий	v ɑ l e r i j
валеҫессине	v ɑ l e ɕ e sː i n e
валеҫеҫҫӗ	v ɑ l e ɕ e ɕː ɛ
валеҫмелли	v ɑ l e ɕ m e lː i
валеҫсе	v ɑ l e ɕ s e
валеҫӗҫ	v ɑ l e ɕ ɛ ɕ
валли	v ɑ lː i
ван	v ɑ n
ванма	v ɑ n m ɑ
ваннӑ	v ɑ nː ʌ
ванчӑк	v ɑ n tʃ ʌ k
ванчӑкӗ	v ɑ n tʃ ʌ k ɛ
ванюк	v ɑ n j u k
вара	v ɑ r ɑ
вараланнӑ	v ɑ r ɑ l ɑ nː ʌ
вараланнӑччӗ	v ɑ r ɑ l ɑ nː ʌ tʃ tʃ ɛ
варалать	v ɑ r ɑ l ɑ t
варвара	v ɑ r v ɑ r ɑ
варианчӗ	v ɑ r i ɑ n tʃ ɛ
варнава	v ɑ r n ɑ v ɑ
варринче	v ɑ rː i n tʃ e
варринчех	v ɑ rː i n tʃ e χ
варринчи	v ɑ rː i n tʃ i
варрипе	v ɑ rː i p e
варӗнче	v ɑ r ɛ n tʃ e
васильев	v ɑ s i l e v
васильевич	v ɑ s i l e v i tʃ
васильевичӑн	v ɑ s i l e v i tʃ ʌ n
васка-ха	v ɑ s k ɑ χ ɑ
васкавлӑ	v ɑ s k ɑ v l ʌ
васкамарӗ	v ɑ s k ɑ m ɑ r ɛ
васкамаҫҫӗ	v ɑ s k ɑ m ɑ ɕː ɛ
васканӑ	v ɑ s k ɑ n ʌ
васкаса	v ɑ s k ɑ s ɑ
васкасах	v ɑ s k ɑ s ɑ χ
васкатӑн	v ɑ s k ɑ t ʌ n
васкаҫҫӗ	v ɑ s k ɑ ɕː ɛ
васкӑр	v ɑ s k ʌ r
ватлӑхӗ	v ɑ t l ʌ χ ɛ
ваттине	v ɑ tː i n e
ваттисем	v ɑ tː i s e m
ваттисен	v ɑ tː i s e n
ватӑ	v ɑ t ʌ
ватӑлса	v ɑ t ʌ l s ɑ
ватӑсем	v ɑ t ʌ s e m
ведомство	v e d o m s t v o
велосипедпа	v e l o s i p e d p ɑ
вениаминовна	v e n i ɑ m i n o v n ɑ
версие	v e r s i e
ветерансене	v e t e r ɑ n s e n e
ветеранӗсем	v e t e r ɑ n ɛ s e m
ветеранӗсен	v e t e r ɑ n ɛ s e n
ветеринарипе	v e t e r i n ɑ r i p e
вешани	v e ʃ ɑ n i
вешкаймӑсемпе	v e ʃ k ɑ j m ʌ s e m p e
веҫех	v e ɕ e χ
видеокамерӑпа	v i d e o k ɑ m e r ʌ p ɑ
видеотрансляци	v i d e o t r ɑ n s l j ɑ ts i
видеофайлсем	v i d e o f ɑ j l s e m
видо	v i d o
википедире	v i k i p e d i r e
викторийӑпа	v i k t o r i j ʌ p ɑ
виле	v i l e
вилка	v i l k ɑ
вилли	v i lː i
виллин	v i lː i n
виллине	v i lː i n e
вилмеллех	v i l m e lː e χ
вилместӗп	v i l m e s t ɛ p
вилнин	v i l n i n
вилнине	v i l n i n e
вилнисене	v i l n i s e n e
вилнӗ	v i l n ɛ
вилсен	v i l s e n
вилӗм	v i l ɛ m
вилӗмсӗр	v i l ɛ m s ɛ r
вите	v i t e
витереймен	v i t e r e j m e n
витеҫҫӗ	v i t e ɕː ɛ
вити	v i t i
витнӗ	v i t n ɛ
витри	v i t r i
витрисем	v i t r i s e m
витӗм	v i t ɛ m
витӗмлӗ	v i t ɛ m l ɛ
витӗмлӗрех	v i t ɛ m l ɛ r e χ
витӗмне	v i t ɛ m n e
витӗннӗ	v i t ɛ nː ɛ
витӗнсен	v i t ɛ n s e n
витӗр	v i t ɛ r
виэанти	v i e ɑ n t i
виҫ	v i ɕ
виҫеллӗ	v i ɕ e lː ɛ
виҫме	v i ɕ m e
виҫшер	v i ɕ ʃ e r
виҫҫӗ	v i ɕː ɛ
виҫҫӗмӗш	v i ɕː ɛ m ɛ ʃ
виҫҫӗмӗшӗ	v i ɕː ɛ m ɛ ʃ ɛ
виҫҫӗн	v i ɕː ɛ n
виҫҫӗре	v i ɕː ɛ r e
виҫӗ	v i ɕ ɛ
виҫӗм	v i ɕ ɛ m
владимир	v l ɑ d i m i r
влаҫ	v l ɑ ɕ
влаҫра	v l ɑ ɕ r ɑ
внешэкономбанк	v n e ʃ e k o n o m b ɑ n k
вогограда	v o g o g r ɑ d ɑ
водителе	v o d i t e l e
водитель	v o d i t e l
водительсем	v o d i t e l s e m
водительсемшӗн	v o d i t e l s e m ʃ ɛ n
водительсене	v o d i t e l s e n e
водоканала	v o d o k ɑ n ɑ l ɑ
военкоматра	v o e n k o m ɑ t r ɑ
вокалистссемпе	v o k ɑ l i s tsː e m p e
вокалпа	v o k ɑ l p ɑ
вокэалпа	v o k e ɑ l p ɑ
вокэалӗ	v o k e ɑ l ɛ
волейбол	v o l e j b o l
володя	v o l o d j ɑ
волонтер	v o l o n t e r
волонтерсем	v o l o n t e r s e m
волонтерсемпе	v o l o n t e r s e m p e
волонтерсен	v o l o n t e r s e n
волонтерсене	v o l o n t e r s e n e
волонтерӑн	v o l o n t e r ʌ n
воспитани	v o s p i t ɑ n i
вулавра	v u l ɑ v r ɑ
вулавӑшсем	v u l ɑ v ʌ ʃ s e m
вулама	v u l ɑ m ɑ
вуламасен	v u l ɑ m ɑ s e n
вуланӑ	v u l ɑ n ʌ
вуласа	v u l ɑ s ɑ
вуннӑ	v u nː ʌ
вут	v u t
вут-ҫулӑм	v u t ɕ u l ʌ m
вут-ҫулӑмлӑ	v u t ɕ u l ʌ m l ʌ
вутӑ	v u t ʌ
выльӑх	v ɯ l ʌ χ
выльӑх-чӗрлӗх	v ɯ l ʌ χ tʃ ɛ r l ɛ χ
выльӑх-чӗрлӗхпе	v ɯ l ʌ χ tʃ ɛ r l ɛ χ p e
выльӑха	v ɯ l ʌ χ ɑ
выльӑхсем	v ɯ l ʌ χ s e m
выльӑхсемпе	v ɯ l ʌ χ s e m p e
выльӑхсене	v ɯ l ʌ χ s e n e
выляма	v ɯ l j ɑ m ɑ
вылянине	v ɯ l j ɑ n i n e
вылянтарнӑ	v ɯ l j ɑ n t ɑ r n ʌ
выляс	v ɯ l j ɑ s
выляса	v ɯ l j ɑ s ɑ
вылять-мӗн	v ɯ l j ɑ t m ɛ n
выляҫҫӗ	v ɯ l j ɑ ɕː ɛ
выракан	v ɯ r ɑ k ɑ n
вырнаҫма	v ɯ r n ɑ ɕ m ɑ
вырнаҫнӑ	v ɯ r n ɑ ɕ n ʌ
вырнаҫнӑскерте	v ɯ r n ɑ ɕ n ʌ s k e r t e
вырнаҫрӑм	v ɯ r n ɑ ɕ r ʌ m
вырнаҫтарасси	v ɯ r n ɑ ɕ t ɑ r ɑ sː i
вырнаҫтараҫҫӗ	v ɯ r n ɑ ɕ t ɑ r ɑ ɕː ɛ
вырнаҫтармалли	v ɯ r n ɑ ɕ t ɑ r m ɑ lː i
вырнаҫтарнӑ	v ɯ r n ɑ ɕ t ɑ r n ʌ
вырнаҫтарса	v ɯ r n ɑ ɕ t ɑ r s ɑ
вырнаҫтарӗҫ	v ɯ r n ɑ ɕ t ɑ r ɛ ɕ
вырнаҫӗ	v ɯ r n ɑ ɕ ɛ
вырсарникун	v ɯ r s ɑ r n i k u n
вырсарникунсене	v ɯ r s ɑ r n i k u n s e n e
выртакан	v ɯ r t ɑ k ɑ n
выртатчӗ	v ɯ r t ɑ t tʃ ɛ
выртать	v ɯ r t ɑ t
выртаҫҫӗ	v ɯ r t ɑ ɕː ɛ
выртмасӑрах	v ɯ r t m ɑ s ʌ r ɑ χ
выртмаҫҫӗ	v ɯ r t m ɑ ɕː ɛ
выртнӑ	v ɯ r t n ʌ
выртнӑ-мӗн	v ɯ r t n ʌ m ɛ n
выртсан	v ɯ r ts ɑ n
вырттарнӑ	v ɯ r tː ɑ r n ʌ
выртӗ	v ɯ r t ɛ
вырӑн	v ɯ r ʌ n
вырӑна	v ɯ r ʌ n ɑ
вырӑнне	v ɯ r ʌ nː e
вырӑнсемпе	v ɯ r ʌ n s e m p e
вырӑнсене	v ɯ r ʌ n s e n e
вырӑнсенче	v ɯ r ʌ n s e n tʃ e
вырӑнта	v ɯ r ʌ n t ɑ
вырӑнтах	v ɯ r ʌ n t ɑ χ
вырӑнти	v ɯ r ʌ n t i
вырӑнтисем	v ɯ r ʌ n t i s e m
вырӑнӗ	v ɯ r ʌ n ɛ
вырӑнӗнчен	v ɯ r ʌ n ɛ n tʃ e n
вырӑнӗпе	v ɯ r ʌ n ɛ p e
вырӑнӗсем	v ɯ r ʌ n ɛ s e m
вырӑс	v ɯ r ʌ s
вырӑсла	v ɯ r ʌ s l ɑ
вырӑссем	v ɯ r ʌ sː e m
вырӑссен	v ɯ r ʌ sː e n
высарникун	v ɯ s ɑ r n i k u n
выҫса	v ɯ ɕ s ɑ
выҫсан	v ɯ ɕ s ɑ n
выҫӑ	v ɯ ɕ ʌ
выҫӑпа	v ɯ ɕ ʌ p ɑ
вьетнам	v e t n ɑ m
вячеслав	v j ɑ tʃ e s l ɑ v
вячеславовна	v j ɑ tʃ e s l ɑ v o v n ɑ
вячеславпа	v j ɑ tʃ e s l ɑ v p ɑ
вӑй	v ʌ j
вӑй-хал	v ʌ j χ ɑ l
вӑй-хала	v ʌ j χ ɑ l ɑ
вӑй-халпа	v ʌ j χ ɑ l p ɑ
вӑййисене	v ʌ jː i s e n e
вӑйланмалла	v ʌ j l ɑ n m ɑ lː ɑ
вӑйланӗ	v ʌ j l ɑ n ɛ
вӑйлатнӑ	v ʌ j l ɑ t n ʌ
вӑйлӑ	v ʌ j l ʌ
вӑйлӑрах	v ʌ j l ʌ r ɑ χ
вӑйне	v ʌ j n e
вӑйра	v ʌ j r ɑ
вӑйран	v ʌ j r ɑ n
вӑйсӑрланмар	v ʌ j s ʌ r l ɑ n m ɑ r
вӑйсӑрланнӑ	v ʌ j s ʌ r l ɑ nː ʌ
вӑйӑ	v ʌ j ʌ
вӑйӑ-конкурс	v ʌ j ʌ k o n k u r s
вӑйӗ	v ʌ j ɛ
вӑл	v ʌ l
вӑлах	v ʌ l ɑ χ
вӑранаҫҫӗ-тӗр	v ʌ r ɑ n ɑ ɕː ɛ t ɛ r
вӑранса	v ʌ r ɑ n s ɑ
вӑрантӑм	v ʌ r ɑ n t ʌ m
вӑранчӗ	v ʌ r ɑ n tʃ ɛ
вӑратмалли	v ʌ r ɑ t m ɑ lː i
вӑрах	v ʌ r ɑ χ
вӑраха	v ʌ r ɑ χ ɑ
вӑрланӑ	v ʌ r l ɑ n ʌ
вӑрланӑшӑн	v ʌ r l ɑ n ʌ ʃ ʌ n
вӑрман	v ʌ r m ɑ n
вӑрмана	v ʌ r m ɑ n ɑ
вӑрмансенче	v ʌ r m ɑ n s e n tʃ e
вӑрманта	v ʌ r m ɑ n t ɑ
вӑрмантан	v ʌ r m ɑ n t ɑ n
вӑрманти	v ʌ r m ɑ n t i
вӑрманҫӑсем	v ʌ r m ɑ n ɕ ʌ s e m
вӑрманӗн	v ʌ r m ɑ n ɛ n
вӑрманӗнчи	v ʌ r m ɑ n ɛ n tʃ i
вӑрнар	v ʌ r n ɑ r
вӑрнарсем	v ʌ r n ɑ r s e m
вӑрри	v ʌ rː i
вӑрттӑн	v ʌ r tː ʌ n
вӑрттӑнлӑх	v ʌ r tː ʌ n l ʌ χ
вӑрттӑнлӑхра	v ʌ r tː ʌ n l ʌ χ r ɑ
вӑрттӑнлӑхсемпе	v ʌ r tː ʌ n l ʌ χ s e m p e
вӑрҫа	v ʌ r ɕ ɑ
вӑрҫин	v ʌ r ɕ i n
вӑрҫинче	v ʌ r ɕ i n tʃ e
вӑрҫса	v ʌ r ɕ s ɑ
вӑрҫӑ	v ʌ r ɕ ʌ
вӑрӑ	v ʌ r ʌ
вӑрӑмми	v ʌ r ʌ mː i
вӑрӑмӑш	v ʌ r ʌ m ʌ ʃ
вӑрӑран	v ʌ r ʌ r ɑ n
вӑт	v ʌ t
вӑтам	v ʌ t ɑ m
вӑтамми	v ʌ t ɑ mː i
вӑтанмасӑр	v ʌ t ɑ n m ɑ s ʌ r
вӑтӑр	v ʌ t ʌ r
вӑх	v ʌ χ
вӑхӑт	v ʌ χ ʌ t
вӑхӑта	v ʌ χ ʌ t ɑ
вӑхӑтлӑх	v ʌ χ ʌ t l ʌ χ
вӑхӑтлӑха	v ʌ χ ʌ t l ʌ χ ɑ
вӑхӑтпа	v ʌ χ ʌ t p ɑ
вӑхӑтра	v ʌ χ ʌ t r ɑ
вӑхӑтрах	v ʌ χ ʌ t r ɑ χ
вӑхӑтӗнче	v ʌ χ ʌ t ɛ n tʃ e
вӑхӑчӗ	v ʌ χ ʌ tʃ ɛ
вӑя	v ʌ j ɑ
вӗлерекенсене	v ɛ l e r e k e n s e n e
вӗлерме	v ɛ l e r m e
вӗлерни	v ɛ l e r n i
вӗлернӗ	v ɛ l e r n ɛ
вӗлерсе	v ɛ l e r s e
вӗрен	v ɛ r e n
вӗрене-вӗрене	v ɛ r e n e v ɛ r e n e
вӗренеймеҫҫӗ	v ɛ r e n e j m e ɕː ɛ
вӗренекен	v ɛ r e n e k e n
вӗренекенсем	v ɛ r e n e k e n s e m
вӗренекенсен	v ɛ r e n e k e n s e n
вӗренекенӗсем	v ɛ r e n e k e n ɛ s e m
вӗренесрен	v ɛ r e n e s r e n
вӗренесшӗн	v ɛ r e n e s ʃ ɛ n
вӗренеттӗм	v ɛ r e n e tː ɛ m
вӗренеҫҫӗ	v ɛ r e n e ɕː ɛ
вӗренме	v ɛ r e n m e
вӗренмешкӗн	v ɛ r e n m e ʃ k ɛ n
вӗреннӗ	v ɛ r e nː ɛ
вӗреннӗскер-ҫке-ха	v ɛ r e nː ɛ s k e r ɕ k e χ ɑ
вӗренсе	v ɛ r e n s e
вӗрентекен	v ɛ r e n t e k e n
вӗрентет	v ɛ r e n t e t
вӗрентеҫҫӗ	v ɛ r e n t e ɕː ɛ
вӗрентме	v ɛ r e n t m e
вӗрентни	v ɛ r e n t n i
вӗрентнинче	v ɛ r e n t n i n tʃ e
вӗрентнӗ	v ɛ r e n t n ɛ
вӗрентсе	v ɛ r e n ts e
вӗрентӳ	v ɛ r e n t y
вӗренӳ	v ɛ r e n y
вӗренӳпе	v ɛ r e n y p e
вӗренӳрен	v ɛ r e n y r e n
вӗретчӗ	v ɛ r e t tʃ ɛ
вӗри	v ɛ r i
вӗсем	v ɛ s e m
вӗсемпе	v ɛ s e m p e
вӗсемшӗн	v ɛ s e m ʃ ɛ n
вӗсен	v ɛ s e n
вӗсене	v ɛ s e n e
вӗсенех	v ɛ s e n e χ
вӗсенчен	v ɛ s e n tʃ e n
вӗт	v ɛ t
вӗт-ха	v ɛ t χ ɑ
вӗткеленет	v ɛ t k e l e n e t
вӗттӗн	v ɛ tː ɛ n
вӗтӗ	v ɛ t ɛ
вӗчӗрхенсе	v ɛ tʃ ɛ r χ e n s e
вӗҫенче	v ɛ ɕ e n tʃ e
вӗҫертесрен	v ɛ ɕ e r t e s r e n
вӗҫес	v ɛ ɕ e s
вӗҫлекенскер	v ɛ ɕ l e k e n s k e r
вӗҫленессе	v ɛ ɕ l e n e sː e
вӗҫлениччен	v ɛ ɕ l e n i tʃ tʃ e n
вӗҫленмелле	v ɛ ɕ l e n m e lː e
вӗҫленмен	v ɛ ɕ l e n m e n
вӗҫленнине	v ɛ ɕ l e nː i n e
вӗҫленнӗ	v ɛ ɕ l e nː ɛ
вӗҫленӗ	v ɛ ɕ l e n ɛ
вӗҫленӗпе	v ɛ ɕ l e n ɛ p e
вӗҫме	v ɛ ɕ m e
вӗҫне	v ɛ ɕ n e
вӗҫсе	v ɛ ɕ s e
вӗҫтерме	v ɛ ɕ t e r m e
вӗҫтернӗ	v ɛ ɕ t e r n ɛ
вӗҫӗ-хӗрне	v ɛ ɕ ɛ χ ɛ r n e
вӗҫӗмех	v ɛ ɕ ɛ m e χ
вӗҫӗнче	v ɛ ɕ ɛ n tʃ e
вӗҫӗнчипе	v ɛ ɕ ɛ n tʃ i p e
вӗҫӗччен	v ɛ ɕ ɛ tʃ tʃ e n
гаджета	g ɑ d ʒ e t ɑ
гаража	g ɑ r ɑ ʒ ɑ
гаражра	g ɑ r ɑ ʒ r ɑ
гардероба	g ɑ r d e r o b ɑ
гарем	g ɑ r e m
гастрольсене	g ɑ s t r o l s e n e
гаэ	g ɑ e
генетика	g e n e t i k ɑ
геннадие	g e nː ɑ d i e
геннадий	g e nː ɑ d i j
генсене	g e n s e n e
германире	g e r m ɑ n i r e
герой	g e r o j
геройла	g e r o j l ɑ
гимнӗсене	g i m n ɛ s e n e
гипертонипе	g i p e r t o n i p e
гипотонипе	g i p o t o n i p e
гироскутера	g i r o s k u t e r ɑ
гладков	g l ɑ d k o v
говоровсем	g o v o r o v s e m
говоровсемшӗн	g o v o r o v s e m ʃ ɛ n
гормонсен	g o r m o n s e n
госпитале	g o s p i t ɑ l e
госпитальре	g o s p i t ɑ l r e
граждан	g r ɑ ʒ d ɑ n
граждансен	g r ɑ ʒ d ɑ n s e n
граждансене	g r ɑ ʒ d ɑ n s e n e
гражданство	g r ɑ ʒ d ɑ n s t v o
граната	g r ɑ n ɑ t ɑ
гречко	g r e tʃ k o
григорьев	g r i g o r e v
григорьева	g r i g o r e v ɑ
гриппа	g r i pː ɑ
гриппран	g r i pː r ɑ n
грипран	g r i p r ɑ n
громкоговорительпе	g r o m k o g o v o r i t e l p e
гроэный	g r o e n ɯ j
груэире	g r u e i r e
груэирен	g r u e i r e n
груэовиксем	g r u e o v i k s e m
дамба	d ɑ m b ɑ
дарьйӑпа	d ɑ r j ʌ p ɑ
датчикне	d ɑ t tʃ i k n e
дачӑна	d ɑ tʃ ʌ n ɑ
дежурнӑй	d e ʒ u r n ʌ j
дежурствӑра	d e ʒ u r s t v ʌ r ɑ
декоративлӑ	d e k o r ɑ t i v l ʌ
декрета	d e k r e t ɑ
делегаци	d e l e g ɑ ts i
денис	d e n i s
депона	d e p o n ɑ
депутат	d e p u t ɑ t
депутата	d e p u t ɑ t ɑ
депутатсем	d e p u t ɑ ts e m
депутатсен	d e p u t ɑ ts e n
депутачӗсен	d e p u t ɑ tʃ ɛ s e n
джамилия	d ʒ ɑ m i l i j ɑ
джинс	d ʒ i n s
диагностикӑна	d i ɑ g n o s t i k ʌ n ɑ
диагноэ	d i ɑ g n o e
диагноэа	d i ɑ g n o e ɑ
диалог	d i ɑ l o g
диван	d i v ɑ n
диета	d i e t ɑ
диктант	d i k t ɑ n t
диктантне	d i k t ɑ n t n e
дима	d i m ɑ
димитриевӑна	d i m i t r i e v ʌ n ɑ
диплом	d i p l o m
директор	d i r e k t o r
диспансериэаци	d i s p ɑ n s e r i e ɑ ts i
диспансерне	d i s p ɑ n s e r n e
диспансерӑн	d i s p ɑ n s e r ʌ n
диспансерӗн	d i s p ɑ n s e r ɛ n
диспансерӗнче	d i s p ɑ n s e r ɛ n tʃ e
дистанци	d i s t ɑ n ts i
дисциплинарлӑ	d i s ts i p l i n ɑ r l ʌ
диэайнера	d i e ɑ j n e r ɑ
диэайнпа	d i e ɑ j n p ɑ
диэайнӗ	d i e ɑ j n ɛ
дмитрий	d m i t r i j
дожноҫӗпе	d o ʒ n o ɕ ɛ p e
документ	d o k u m e n t
документа	d o k u m e n t ɑ
документлӑ	d o k u m e n t l ʌ
документра	d o k u m e n t r ɑ
документсем	d o k u m e n ts e m
документсене	d o k u m e n ts e n e
должноҫе	d o l ʒ n o ɕ e
донор	d o n o r
донорсен	d o n o r s e n
донорӑн	d o n o r ʌ n
допинг	d o p i n g
допингла	d o p i n g l ɑ
драмисем	d r ɑ m i s e m
дуррес	d u rː e s
дэюбӑн	d e j u b ʌ n
дэюдопа	d e j u d o p ɑ
е	j e
европа	j e v r o p ɑ
евруков	j e v r u k o v
евӗр	j e v ɛ r
ейӗвӗ	j e j ɛ v ɛ
ейӳ	j e j y
ейӳрен	j e j y r e n
елена	j e l e n ɑ
елиэавета	j e l i e ɑ v e t ɑ
елкӑри	j e l k ʌ r i
емдюков	j e m d j u k o v
ен	j e n
енне	j e nː e
еннелле	j e nː e lː e
еннерех	j e nː e r e χ
енре	j e n r e
енри	j e n r i
ентеш	j e n t e ʃ
ентеше	j e n t e ʃ e
ентешсем	j e n t e ʃ s e m
ентешӗ	j e n t e ʃ ɛ
ентешӗмӗре	j e n t e ʃ ɛ m ɛ r e
ентешӗсем	j e n t e ʃ ɛ s e m
ентешӗсене	j e n t e ʃ ɛ s e n e
енче	j e n tʃ e
енчен	j e n tʃ e n
енчи	j e n tʃ i
енчӗке	j e n tʃ ɛ k e
енӗн	j e n ɛ n
енӗпе	j e n ɛ p e
епархи	j e p ɑ r χ i
епархине	j e p ɑ r χ i n e
епле	j e p l e
еплелле	j e p l e lː e
еркӗнсем	j e r k ɛ n s e m
еркӗнӗ	j e r k ɛ n ɛ
еркӗнӗпе	j e r k ɛ n ɛ p e
ернӗ	j e r n ɛ
ертсе	j e r ts e
ертӳлӗхне	j e r t y l ɛ χ n e
ертӳҫи	j e r t y ɕ i
ертӳҫисем	j e r t y ɕ i s e m
ертӳҫисене	j e r t y ɕ i s e n e
ертӳҫӗсем	j e r t y ɕ ɛ s e m
ершовпа	j e r ʃ o v p ɑ
етӗрне	j e t ɛ r n e
етӗрнере	j e t ɛ r n e r e
етӗрнери	j e t ɛ r n e r i
жанра	ʒ ɑ n r ɑ
жилета	ʒ i l e t ɑ
журналистсем	ʒ u r n ɑ l i s ts e m
журналистсемпе	ʒ u r n ɑ l i s ts e m p e
журналистсене	ʒ u r n ɑ l i s ts e n e
журналӑн	ʒ u r n ɑ l ʌ n
жюрие	ʒ j u r i e
иван	i v ɑ n
ивана	i v ɑ n ɑ
иванова	i v ɑ n o v ɑ
иванран	i v ɑ n r ɑ n
ивантаев	i v ɑ n t ɑ e v
ивантаевпа	i v ɑ n t ɑ e v p ɑ
иванӑн	i v ɑ n ʌ n
иврит	i v r i t
ивӑн	i v ʌ n
игнатьев	i g n ɑ t e v
игнашевичӑн	i g n ɑ ʃ e v i tʃ ʌ n
игорь	i g o r
иккен	i kː e n
иккӗ	i kː ɛ
иккӗленет	i kː ɛ l e n e t
иккӗленмен	i kː ɛ l e n m e n
иккӗленмесӗрех	i kː ɛ l e n m e s ɛ r e χ
иккӗленсе	i kː ɛ l e n s e
иккӗлентернӗ	i kː ɛ l e n t e r n ɛ
иккӗленӳ	i kː ɛ l e n y
иккӗмӗш	i kː ɛ m ɛ ʃ
иккӗмӗшне	i kː ɛ m ɛ ʃ n e
иккӗмӗшӗ	i kː ɛ m ɛ ʃ ɛ
иккӗшӗ	i kː ɛ ʃ ɛ
иккӗшӗнче	i kː ɛ ʃ ɛ n tʃ e
иксӗмӗре	i k s ɛ m ɛ r e
икшер	i k ʃ e r
икӗ	i k ɛ
илеет	i l e e t
илеетӗр-и	i l e e t ɛ r i
илеймен	i l e j m e n
илеймерӗ	i l e j m e r ɛ
илейнӗ	i l e j n ɛ
илекенсене	i l e k e n s e n e
илемлетеҫҫӗ	i l e m l e t e ɕː ɛ
илемлетнӗ	i l e m l e t n ɛ
илемлӗ	i l e m l ɛ
илемӗпе	i l e m ɛ p e
илессишӗн	i l e sː i ʃ ɛ n
илесшӗн	i l e s ʃ ɛ n
илет	i l e t
илет-мӗн	i l e t m ɛ n
илетех	i l e t e χ
илетӗр	i l e t ɛ r
илеҫҫӗ	i l e ɕː ɛ
илеҫҫӗ-ши	i l e ɕː ɛ ʃ i
илларионова	i lː ɑ r i o n o v ɑ
илме	i l m e
илмелле	i l m e lː e
илмелли	i l m e lː i
илмен	i l m e n
илмест	i l m e s t
илмесӗр	i l m e s ɛ r
илмешкӗн	i l m e ʃ k ɛ n
илнине	i l n i n e
илнӗ	i l n ɛ
илнӗ-ши	i l n ɛ ʃ i
илнӗшӗн	i l n ɛ ʃ ɛ n
илсе	i l s e
илсен	i l s e n
илтерер	i l t e r e r
илтересшӗн	i l t e r e s ʃ ɛ n
илтеретпӗр	i l t e r e t p ɛ r
илтернӗ	i l t e r n ɛ
илтмелле	i l t m e lː e
илтменнисен	i l t m e nː i s e n
илтместӗм	i l t m e s t ɛ m
илтмӗш	i l t m ɛ ʃ
илтмӗше	i l t m ɛ ʃ e
илтнӗ	i l t n ɛ
илтнӗччӗ	i l t n ɛ tʃ tʃ ɛ
илтсен	i l ts e n
илтӗм	i l t ɛ m
илтӗнет	i l t ɛ n e t
илтӗнчӗ	i l t ɛ n tʃ ɛ
илчӗ	i l tʃ ɛ
илчӗҫ	i l tʃ ɛ ɕ
илья	i l j ɑ
илюхинсен	i l j u χ i n s e n
илӗпӗр	i l ɛ p ɛ r
илӗр	i l ɛ r
илӗртесшӗн	i l ɛ r t e s ʃ ɛ n
илӗртет	i l ɛ r t e t
илӗртсех	i l ɛ r ts e χ
илӗртӗ	i l ɛ r t ɛ
илӗртӳлӗхне	i l ɛ r t y l ɛ χ n e
илӗтӳлӗхнӗ	i l ɛ t y l ɛ χ n ɛ
илӗҫ	i l ɛ ɕ
иммун	i mː u n
импери	i m p e r i
импровиэациленӗ	i m p r o v i e ɑ ts i l e n ɛ
имшеркке	i m ʃ e r kː e
имшерленет	i m ʃ e r l e n e t
имӗш	i m ɛ ʃ
инвалид	i n v ɑ l i d
инвестици	i n v e s t i ts i
инкек	i n k e k
инкекре	i n k e k r e
инкекрен	i n k e k r e n
инна	i nː ɑ
инспекторсем	i n s p e k t o r s e m
инспекторсен	i n s p e k t o r s e n
институтне	i n s t i t u t n e
институтӗнче	i n s t i t u t ɛ n tʃ e
институчӗ	i n s t i t u tʃ ɛ
инструменталистсен	i n s t r u m e n t ɑ l i s ts e n
инструменчӗсене	i n s t r u m e n tʃ ɛ s e n e
интереслӗ	i n t e r e s l ɛ
интернат	i n t e r n ɑ t
интернационаллӑ	i n t e r n ɑ ts i o n ɑ lː ʌ
интернет	i n t e r n e t
интернетра	i n t e r n e t r ɑ
интернетри	i n t e r n e t r i
информаци	i n f o r m ɑ ts i
инфоурок	i n f o u r o k
инҫе	i n ɕ e
инҫетрен	i n ɕ e t r e n
инҫетри	i n ɕ e t r i
инҫех	i n ɕ e χ
ионов	i o n o v
ипотека	i p o t e k ɑ
ир	i r
ир-ирех	i r i r e χ
ирех	i r e χ
иртен-ҫӳрен	i r t e n ɕ y r e n
иртен-ҫӳрене	i r t e n ɕ y r e n e
иртерех	i r t e r e χ
иртессине	i r t e sː i n e
иртет	i r t e t
иртеҫҫӗ	i r t e ɕː ɛ
иртмен	i r t m e n
иртмерӗ	i r t m e r ɛ
иртмест	i r t m e s t
иртнине	i r t n i n e
иртнинче	i r t n i n tʃ e
иртнипех	i r t n i p e χ
иртнӗ	i r t n ɛ
иртнӗҫем	i r t n ɛ ɕ e m
иртрӗ	i r t r ɛ
иртрӗҫ	i r t r ɛ ɕ
иртсе	i r ts e
иртсен	i r ts e n
иртсенех	i r ts e n e χ
ирттерекен	i r tː e r e k e n
ирттерекенсене	i r tː e r e k e n s e n e
ирттерессине	i r tː e r e sː i n e
ирттересшӗн	i r tː e r e s ʃ ɛ n
ирттерет	i r tː e r e t
ирттереҫҫӗ	i r tː e r e ɕː ɛ
ирттереҫҫӗ-ха	i r tː e r e ɕː ɛ χ ɑ
ирттерме	i r tː e r m e
ирттермелле	i r tː e r m e lː e
ирттермелли	i r tː e r m e lː i
ирттермен	i r tː e r m e n
ирттермен-мӗн	i r tː e r m e n m ɛ n
ирттерни	i r tː e r n i
ирттернине	i r tː e r n i n e
ирттернипе	i r tː e r n i p e
ирттернипех	i r tː e r n i p e χ
ирттернӗ	i r tː e r n ɛ
ирттерсе	i r tː e r s e
ирттерчӗҫ	i r tː e r tʃ ɛ ɕ
ирттерӗ	i r tː e r ɛ
ирттерӗҫ	i r tː e r ɛ ɕ
иртӗ	i r t ɛ
иртӗхеҫҫӗ	i r t ɛ χ e ɕː ɛ
ирхи	i r χ i
ирхине	i r χ i n e
ирчченех	i r tʃ tʃ e n e χ
ирӗк	i r ɛ k
ирӗке	i r ɛ k e
ирӗклӗ	i r ɛ k l ɛ
ирӗклӗх	i r ɛ k l ɛ χ
ирӗксӗр	i r ɛ k s ɛ r
ирӗксӗрлесе	i r ɛ k s ɛ r l e s e
ирӗкӗ	i r ɛ k ɛ
ирӗкӗпе	i r ɛ k ɛ p e
ирӗлет	i r ɛ l e t
ирӗлменччӗ	i r ɛ l m e n tʃ tʃ ɛ
искра	i s k r ɑ
искусствисен	i s k u sː t v i s e n
искусствӑллӑ	i s k u sː t v ʌ lː ʌ
искусствӑсен	i s k u sː t v ʌ s e n
ислен	i s l e n
истори	i s t o r i
историе	i s t o r i e
историйӗпе	i s t o r i j ɛ p e
историллӗ	i s t o r i lː ɛ
историне	i s t o r i n e
историпе	i s t o r i p e
историсем	i s t o r i s e m
итлев	i t l e v
итлеме	i t l e m e
итленӗ	i t l e n ɛ
итлесшӗн	i t l e s ʃ ɛ n
итлсе	i t l s e
ишсе	i ʃ s e
ишӗлчӗк	i ʃ ɛ l tʃ ɛ k
ишӗр	i ʃ ɛ r
иэвешение	i e v e ʃ e n i e
иэдательствинче	i e d ɑ t e l s t v i n tʃ e
иэоляторӑн	i e o l j ɑ t o r ʌ n
иэраилте	i e r ɑ i l t e
иэраильте	i e r ɑ i l t e
иҫӗм	i ɕ ɛ m
иӗм	i ɛ m
йогӑаа	j o g ʌ ɑ ɑ
йывӑр	j ɯ v ʌ r
йывӑрлӑха	j ɯ v ʌ r l ʌ χ ɑ
йывӑрлӑхри	j ɯ v ʌ r l ʌ χ r i
йывӑрлӑхсем	j ɯ v ʌ r l ʌ χ s e m
йывӑрлӑхсене	j ɯ v ʌ r l ʌ χ s e n e
йывӑрри	j ɯ v ʌ rː i
йывӑртарах	j ɯ v ʌ r t ɑ r ɑ χ
йывӑҫ	j ɯ v ʌ ɕ
йывӑҫ-ши	j ɯ v ʌ ɕ ʃ i
йывӑҫсем	j ɯ v ʌ ɕ s e m
йывӑҫҫисем	j ɯ v ʌ ɕː i s e m
йыснӑшне	j ɯ s n ʌ ʃ n e
йытӑсене	j ɯ t ʌ s e n e
йыхравланӑ	j ɯ χ r ɑ v l ɑ n ʌ
йыхравларӗҫ	j ɯ χ r ɑ v l ɑ r ɛ ɕ
йыхравлать	j ɯ χ r ɑ v l ɑ t
йыхравлаҫҫӗ	j ɯ χ r ɑ v l ɑ ɕː ɛ
йыш	j ɯ ʃ
йышланни	j ɯ ʃ l ɑ nː i
йышлӑ	j ɯ ʃ l ʌ
йышлӑн	j ɯ ʃ l ʌ n
йышне	j ɯ ʃ n e
йышпа	j ɯ ʃ p ɑ
йышши	j ɯ ʃː i
йышшисене	j ɯ ʃː i s e n e
йышӑнакан	j ɯ ʃ ʌ n ɑ k ɑ n
йышӑнатех	j ɯ ʃ ʌ n ɑ t e χ
йышӑнатпӑр	j ɯ ʃ ʌ n ɑ t p ʌ r
йышӑнать	j ɯ ʃ ʌ n ɑ t
йышӑнаҫҫӗ	j ɯ ʃ ʌ n ɑ ɕː ɛ
йышӑнма	j ɯ ʃ ʌ n m ɑ
йышӑнман	j ɯ ʃ ʌ n m ɑ n
йышӑнмасан	j ɯ ʃ ʌ n m ɑ s ɑ n
йышӑнмасӑр	j ɯ ʃ ʌ n m ɑ s ʌ r
йышӑнмаҫҫӗ	j ɯ ʃ ʌ n m ɑ ɕː ɛ
йышӑнни	j ɯ ʃ ʌ nː i
йышӑннине	j ɯ ʃ ʌ nː i n e
йышӑннӑ	j ɯ ʃ ʌ nː ʌ
йышӑннӑскерсем	j ɯ ʃ ʌ nː ʌ s k e r s e m
йышӑннӑччӗ	j ɯ ʃ ʌ nː ʌ tʃ tʃ ɛ
йышӑнтӑм	j ɯ ʃ ʌ n t ʌ m
йышӑну	j ɯ ʃ ʌ n u
йышӑнчӗ	j ɯ ʃ ʌ n tʃ ɛ
йышӑнчӗҫ	j ɯ ʃ ʌ n tʃ ɛ ɕ
йышӑнчӗҫ-ши	j ɯ ʃ ʌ n tʃ ɛ ɕ ʃ i
йышӗ	j ɯ ʃ ɛ
йышӗнче	j ɯ ʃ ɛ n tʃ e
йӑвара	j ʌ v ɑ r ɑ
йӑл	j ʌ l
йӑла-йӗрке	j ʌ l ɑ j ɛ r k e
йӑлана	j ʌ l ɑ n ɑ
йӑлапа	j ʌ l ɑ p ɑ
йӑлара	j ʌ l ɑ r ɑ
йӑлари	j ʌ l ɑ r i
йӑласене	j ʌ l ɑ s e n e
йӑли-йӗркине	j ʌ l i j ɛ r k i n e
йӑли-йӗркипе	j ʌ l i j ɛ r k i p e
йӑлт	j ʌ l t
йӑлтах	j ʌ l t ɑ χ
йӑлтӑртатса	j ʌ l t ʌ r t ɑ ts ɑ
йӑлӑнса	j ʌ l ʌ n s ɑ
йӑмра	j ʌ m r ɑ
йӑмӑк	j ʌ m ʌ k
йӑмӑкпа	j ʌ m ʌ k p ɑ
йӑмӑкӗн	j ʌ m ʌ k ɛ n
йӑнӑшаттӑм	j ʌ n ʌ ʃ ɑ tː ʌ m
йӑнӑшпа	j ʌ n ʌ ʃ p ɑ
йӑпаткалатчӗ-ха	j ʌ p ɑ t k ɑ l ɑ t tʃ ɛ χ ɑ
йӑпӑлтатать	j ʌ p ʌ l t ɑ t ɑ t
йӑпӑр-япӑр	j ʌ p ʌ r j ɑ p ʌ r
йӑрӑ	j ʌ r ʌ
йӑтассинчен	j ʌ t ɑ sː i n tʃ e n
йӑтса	j ʌ ts ɑ
йӑтӑннӑран	j ʌ t ʌ nː ʌ r ɑ n
йӑх-тымарӗ	j ʌ χ t ɯ m ɑ r ɛ
йӑхра	j ʌ χ r ɑ
йӑхран	j ʌ χ r ɑ n
йӑхӗ	j ʌ χ ɛ
йӗкӗреш	j ɛ k ɛ r e ʃ
йӗкӗрешсем	j ɛ k ɛ r e ʃ s e m
йӗкӗрешӗ	j ɛ k ɛ r e ʃ ɛ
йӗкӗтсене	j ɛ k ɛ ts e n e
йӗлтӗрпе	j ɛ l t ɛ r p e
йӗмӗсене	j ɛ m ɛ s e n e
йӗпе	j ɛ p e
йӗпреҫ	j ɛ p r e ɕ
йӗпреҫсем	j ɛ p r e ɕ s e m
йӗр	j ɛ r
йӗретӗп	j ɛ r e t ɛ p
йӗри-тавра	j ɛ r i t ɑ v r ɑ
йӗрке	j ɛ r k e
йӗркевӗ	j ɛ r k e v ɛ
йӗркелекен	j ɛ r k e l e k e n
йӗркелеме	j ɛ r k e l e m e
йӗркелемеллине	j ɛ r k e l e m e lː i n e
йӗркеленекенскере	j ɛ r k e l e n e k e n s k e r e
йӗркелени	j ɛ r k e l e n i
йӗркеленни	j ɛ r k e l e nː i
йӗркеленнӗ	j ɛ r k e l e nː ɛ
йӗркеленсе	j ɛ r k e l e n s e
йӗркеленӗ	j ɛ r k e l e n ɛ
йӗркелеҫҫӗ	j ɛ r k e l e ɕː ɛ
йӗркеллех	j ɛ r k e lː e χ
йӗркелӗхе	j ɛ r k e l ɛ χ e
йӗркелӗҫ	j ɛ r k e l ɛ ɕ
йӗркелӳҫӗсем	j ɛ r k e l y ɕ ɛ s e m
йӗркелӳҫӗсене	j ɛ r k e l y ɕ ɛ s e n e
йӗркене	j ɛ r k e n e
йӗркепе	j ɛ r k e p e
йӗркере	j ɛ r k e r e
йӗркесен	j ɛ r k e s e n
йӗркесӗр	j ɛ r k e s ɛ r
йӗркине	j ɛ r k i n e
йӗркипеле	j ɛ r k i p e l e
йӗрлесе	j ɛ r l e s e
йӗрлеҫҫӗ	j ɛ r l e ɕː ɛ
йӗрмӗшрӗ	j ɛ r m ɛ ʃ r ɛ
йӗрсен	j ɛ r s e n
йӳнелессе	j y n e l e sː e
йӳнелнӗ	j y n e l n ɛ
йӳнетессине	j y n e t e sː i n e
йӳнетиччен	j y n e t i tʃ tʃ e n
йӳнетсе	j y n e ts e
йӳннине	j y nː i n e
йӳнӗ	j y n ɛ
йӳнӗрех	j y n ɛ r e χ
йӳҫӗ	j y ɕ ɛ
кабинӑри	k ɑ b i n ʌ r i
кавир	k ɑ v i r
кавкаэра	k ɑ v k ɑ e r ɑ
кавӑна	k ɑ v ʌ n ɑ
кавӑнпа	k ɑ v ʌ n p ɑ
кадрсем	k ɑ d r s e m
кайма	k ɑ j m ɑ
каймалла	k ɑ j m ɑ lː ɑ
каймалли	k ɑ j m ɑ lː i
каймаллине	k ɑ j m ɑ lː i n e
кайман	k ɑ j m ɑ n
каймарӗ	k ɑ j m ɑ r ɛ
каймасть	k ɑ j m ɑ s t
каймастӑм	k ɑ j m ɑ s t ʌ m
кайнине	k ɑ j n i n e
кайнӑ	k ɑ j n ʌ
кайнӑскер	k ɑ j n ʌ s k e r
кайран	k ɑ j r ɑ n
кайрӑм	k ɑ j r ʌ m
кайрӗ	k ɑ j r ɛ
кайрӗҫ	k ɑ j r ɛ ɕ
кайса	k ɑ j s ɑ
кайсах	k ɑ j s ɑ χ
кайӑк	k ɑ j ʌ k
кайӑкӗ	k ɑ j ʌ k ɛ
кайӗ	k ɑ j ɛ
какай	k ɑ k ɑ j
какайне	k ɑ k ɑ j n e
какайра	k ɑ k ɑ j r ɑ
какайсӑр	k ɑ k ɑ j s ʌ r
какайӗнче	k ɑ k ɑ j ɛ n tʃ e
кал-кал	k ɑ l k ɑ l
кала-ха	k ɑ l ɑ χ ɑ
калама	k ɑ l ɑ m ɑ
каламалла	k ɑ l ɑ m ɑ lː ɑ
каламаллах	k ɑ l ɑ m ɑ lː ɑ χ
каламаллине	k ɑ l ɑ m ɑ lː i n e
каламаҫҫӗ	k ɑ l ɑ m ɑ ɕː ɛ
калани	k ɑ l ɑ n i
каланипе	k ɑ l ɑ n i p e
каланӑ	k ɑ l ɑ n ʌ
каларӑм	k ɑ l ɑ r ʌ m
каларӑш	k ɑ l ɑ r ʌ ʃ
каларӗҫ	k ɑ l ɑ r ɛ ɕ
каласа	k ɑ l ɑ s ɑ
каласан	k ɑ l ɑ s ɑ n
калассишӗн	k ɑ l ɑ sː i ʃ ɛ n
каласшӑн	k ɑ l ɑ s ʃ ʌ n
калатчӗ	k ɑ l ɑ t tʃ ɛ
калать	k ɑ l ɑ t
калатӑп	k ɑ l ɑ t ʌ p
калаҫакансем	k ɑ l ɑ ɕ ɑ k ɑ n s e m
калаҫаканскер	k ɑ l ɑ ɕ ɑ k ɑ n s k e r
калаҫас	k ɑ l ɑ ɕ ɑ s
калаҫатпӑр	k ɑ l ɑ ɕ ɑ t p ʌ r
калаҫаттӑм	k ɑ l ɑ ɕ ɑ tː ʌ m
калаҫать	k ɑ l ɑ ɕ ɑ t
калаҫаҫҫӗ	k ɑ l ɑ ɕ ɑ ɕː ɛ
калаҫма	k ɑ l ɑ ɕ m ɑ
калаҫмалла	k ɑ l ɑ ɕ m ɑ lː ɑ
калаҫни	k ɑ l ɑ ɕ n i
калаҫнине	k ɑ l ɑ ɕ n i n e
калаҫнӑ	k ɑ l ɑ ɕ n ʌ
калаҫрӗ	k ɑ l ɑ ɕ r ɛ
калаҫса	k ɑ l ɑ ɕ s ɑ
калаҫсан	k ɑ l ɑ ɕ s ɑ n
калаҫу	k ɑ l ɑ ɕ u
калаҫҫӗ	k ɑ l ɑ ɕː ɛ
калаҫӑвӗ	k ɑ l ɑ ɕ ʌ v ɛ
калаҫӗҫ	k ɑ l ɑ ɕ ɛ ɕ
калинин	k ɑ l i n i n
калинккене	k ɑ l i n kː e n e
каллех	k ɑ lː e χ
калӑм	k ɑ l ʌ m
калӑн	k ɑ l ʌ n
калӑплать	k ɑ l ʌ p l ɑ t
калӑпӑр	k ɑ l ʌ p ʌ r
кам	k ɑ m
кама	k ɑ m ɑ
камах	k ɑ m ɑ χ
камит	k ɑ m i t
кампа	k ɑ m p ɑ
кампанийӗ	k ɑ m p ɑ n i j ɛ
камӑн	k ɑ m ʌ n
канаш	k ɑ n ɑ ʃ
канашлу	k ɑ n ɑ ʃ l u
канашлура	k ɑ n ɑ ʃ l u r ɑ
канашлурах	k ɑ n ɑ ʃ l u r ɑ χ
канашне	k ɑ n ɑ ʃ n e
канашри	k ɑ n ɑ ʃ r i
канашӑн	k ɑ n ɑ ʃ ʌ n
канашӗ	k ɑ n ɑ ʃ ɛ
кандагар	k ɑ n d ɑ g ɑ r
кандагарти	k ɑ n d ɑ g ɑ r t i
каникулпа	k ɑ n i k u l p ɑ
канлӗ	k ɑ n l ɛ
канма	k ɑ n m ɑ
канмалли	k ɑ n m ɑ lː i
кансӗр	k ɑ n s ɛ r
кантӑкран	k ɑ n t ʌ k r ɑ n
кану	k ɑ n u
канӑва	k ɑ n ʌ v ɑ
канӑвӗн	k ɑ n ʌ v ɛ n
канӑҫ	k ɑ n ʌ ɕ
канӑҫне	k ɑ n ʌ ɕ n e
канӑҫсӑрланма	k ɑ n ʌ ɕ s ʌ r l ɑ n m ɑ
канӑҫсӑрлантарать-и	k ɑ n ʌ ɕ s ʌ r l ɑ n t ɑ r ɑ t i
канӑҫсӑрлантарнӑ	k ɑ n ʌ ɕ s ʌ r l ɑ n t ɑ r n ʌ
капелли	k ɑ p e lː i
капельница	k ɑ p e l n i ts ɑ
капиталӗпе	k ɑ p i t ɑ l ɛ p e
капла-и	k ɑ p l ɑ i
капланса	k ɑ p l ɑ n s ɑ
капланчӗ	k ɑ p l ɑ n tʃ ɛ
капӑр	k ɑ p ʌ r
капӑрлатнӑ	k ɑ p ʌ r l ɑ t n ʌ
карачайсем	k ɑ r ɑ tʃ ɑ j s e m
карачӑм	k ɑ r ɑ tʃ ʌ m
карвинг	k ɑ r v i n g
карса	k ɑ r s ɑ
карта	k ɑ r t ɑ
картара	k ɑ r t ɑ r ɑ
картина	k ɑ r t i n ɑ
картина-ши	k ɑ r t i n ɑ ʃ i
картинисен	k ɑ r t i n i s e n
картинисенче	k ɑ r t i n i s e n tʃ e
картинӑсем	k ɑ r t i n ʌ s e m
картинӑсенче	k ɑ r t i n ʌ s e n tʃ e
картишӗнче	k ɑ r t i ʃ ɛ n tʃ e
картлашкапа	k ɑ r t l ɑ ʃ k ɑ p ɑ
картлашки	k ɑ r t l ɑ ʃ k i
карточка	k ɑ r t o tʃ k ɑ
картти	k ɑ r tː i
карчӑк	k ɑ r tʃ ʌ k
карчӑка	k ɑ r tʃ ʌ k ɑ
карчӑкӗ	k ɑ r tʃ ʌ k ɛ
карьерӑра	k ɑ r e r ʌ r ɑ
касакан	k ɑ s ɑ k ɑ n
каскине	k ɑ s k i n e
касмашӑкн	k ɑ s m ɑ ʃ ʌ k n
касни	k ɑ s n i
касса	k ɑ sː ɑ
кастрюль	k ɑ s t r j u l
категорире	k ɑ t e g o r i r e
катерӗ	k ɑ t e r ɛ
катьӑна	k ɑ t ʌ n ɑ
катьӑран	k ɑ t ʌ r ɑ n
катя	k ɑ t j ɑ
кафе-столовӑйра	k ɑ f e s t o l o v ʌ j r ɑ
кафере	k ɑ f e r e
качча	k ɑ tʃ tʃ ɑ
каччи	k ɑ tʃ tʃ i
каччин	k ɑ tʃ tʃ i n
каччӑ	k ɑ tʃ tʃ ʌ
каччӑн	k ɑ tʃ tʃ ʌ n
каччӑна	k ɑ tʃ tʃ ʌ n ɑ
кашемир	k ɑ ʃ e m i r
кашкӑр	k ɑ ʃ k ʌ r
кашни	k ɑ ʃ n i
кашниех	k ɑ ʃ n i e χ
кашнийӗ	k ɑ ʃ n i j ɛ
кашнийӗн	k ɑ ʃ n i j ɛ n
кашнин	k ɑ ʃ n i n
кашнинех	k ɑ ʃ n i n e χ
кашӑк	k ɑ ʃ ʌ k
каэаковӑна	k ɑ e ɑ k o v ʌ n ɑ
каэахстан	k ɑ e ɑ χ s t ɑ n
каэахстанра	k ɑ e ɑ χ s t ɑ n r ɑ
кая	k ɑ j ɑ
каяймарӗ	k ɑ j ɑ j m ɑ r ɛ
каяймӑн	k ɑ j ɑ j m ʌ n
каякансене	k ɑ j ɑ k ɑ n s e n e
каялла	k ɑ j ɑ lː ɑ
каяллах	k ɑ j ɑ lː ɑ χ
каярах	k ɑ j ɑ r ɑ χ
каярахпа	k ɑ j ɑ r ɑ χ p ɑ
каяс	k ɑ j ɑ s
каясла	k ɑ j ɑ s l ɑ
каясса	k ɑ j ɑ sː ɑ
каясшӑн	k ɑ j ɑ s ʃ ʌ n
каят	k ɑ j ɑ t
каять	k ɑ j ɑ t
каять-ши	k ɑ j ɑ tʃ i
каятӑн-им	k ɑ j ɑ t ʌ n i m
каятӑп	k ɑ j ɑ t ʌ p
каяччӑ	k ɑ j ɑ tʃ tʃ ʌ
каяша	k ɑ j ɑ ʃ ɑ
каяҫҫӗ	k ɑ j ɑ ɕː ɛ
каяҫҫӗ-ха	k ɑ j ɑ ɕː ɛ χ ɑ
каҫ	k ɑ ɕ
каҫа	k ɑ ɕ ɑ
каҫаратӑн	k ɑ ɕ ɑ r ɑ t ʌ n
каҫару	k ɑ ɕ ɑ r u
каҫасшӑн	k ɑ ɕ ɑ s ʃ ʌ n
каҫать	k ɑ ɕ ɑ t
каҫмалӑх	k ɑ ɕ m ɑ l ʌ χ
каҫне	k ɑ ɕ n e
каҫнине	k ɑ ɕ n i n e
каҫрӑм	k ɑ ɕ r ʌ m
каҫса	k ɑ ɕ s ɑ
каҫсем	k ɑ ɕ s e m
каҫхи	k ɑ ɕ χ i
каҫхине	k ɑ ɕ χ i n e
каҫӑ	k ɑ ɕ ʌ
каҫӗ	k ɑ ɕ ɛ
каҫӗнче	k ɑ ɕ ɛ n tʃ e
квалификаци	k v ɑ l i f i k ɑ ts i
келли	k e lː i
кенгуру	k e n g u r u
керамогранитпа	k e r ɑ m o g r ɑ n i t p ɑ
кермен	k e r m e n
керменне	k e r m e nː e
керменӗ	k e r m e n ɛ
керменӗн	k e r m e n ɛ n
керменӗнче	k e r m e n ɛ n tʃ e
кибеч	k i b e tʃ
киввипе	k i vː i p e
кивелмӗҫ	k i v e l m ɛ ɕ
кивӗ	k i v ɛ
кил	k i l
кил-ҫурта	k i l ɕ u r t ɑ
кил-ҫурчӗ	k i l ɕ u r tʃ ɛ
киле	k i l e
килекен	k i l e k e n
килекенпе	k i l e k e n p e
килелле	k i l e lː e
киленетпӗр	k i l e n e t p ɛ r
киленетӗр	k i l e n e t ɛ r
киленме	k i l e n m e
киленсе	k i l e n s e
киленӗҫӗччӗ	k i l e n ɛ ɕ ɛ tʃ tʃ ɛ
киленӳ	k i l e n y
килер-ха	k i l e r χ ɑ
килес-тӗк	k i l e s t ɛ k
килессе	k i l e sː e
килет	k i l e t
килет-и	k i l e t i
килетчӗ	k i l e t tʃ ɛ
килеҫҫӗ	k i l e ɕː ɛ
килкартине	k i l k ɑ r t i n e
килме	k i l m e
килмелли	k i l m e lː i
килмен	k i l m e n
килменни	k i l m e nː i
килмерӗ	k i l m e r ɛ
килмест	k i l m e s t
килмест-ха	k i l m e s t χ ɑ
килмест-ҫке	k i l m e s t ɕ k e
килмешкӗн	k i l m e ʃ k ɛ n
килмӗ	k i l m ɛ
килне	k i l n e
килни	k i l n i
килнине	k i l n i n e
килнисем	k i l n i s e m
килнишӗн	k i l n i ʃ ɛ n
килнӗ	k i l n ɛ
килнӗччӗ	k i l n ɛ tʃ tʃ ɛ
килсе	k i l s e
килсӗр-ҫуртсӑррисене	k i l s ɛ r ɕ u r ts ʌ rː i s e n e
килсӗррисен	k i l s ɛ rː i s e n
килсӗррисене	k i l s ɛ rː i s e n e
килте	k i l t e
килтен	k i l t e n
килти	k i l t i
килтисем	k i l t i s e m
килтӗм	k i l t ɛ m
килтӗмӗр	k i l t ɛ m ɛ r
килтӗр	k i l t ɛ r
килчӗ	k i l tʃ ɛ
килчӗҫ	k i l tʃ ɛ ɕ
килӗ	k i l ɛ
килӗ-ши	k i l ɛ ʃ i
килӗнче	k i l ɛ n tʃ e
килӗнчисем	k i l ɛ n tʃ i s e m
килӗрен	k i l ɛ r e n
килӗшет	k i l ɛ ʃ e t
килӗшет-мӗн	k i l ɛ ʃ e t m ɛ n
килӗшетчӗ	k i l ɛ ʃ e t tʃ ɛ
килӗшмен	k i l ɛ ʃ m e n
килӗшменнисене	k i l ɛ ʃ m e nː i s e n e
килӗшмерӗ	k i l ɛ ʃ m e r ɛ
килӗшнӗ	k i l ɛ ʃ n ɛ
килӗшрӗ	k i l ɛ ʃ r ɛ
килӗшрӗм	k i l ɛ ʃ r ɛ m
килӗшсе	k i l ɛ ʃ s e
килӗшсех	k i l ɛ ʃ s e χ
килӗштернӗскере	k i l ɛ ʃ t e r n ɛ s k e r e
килӗшӗве	k i l ɛ ʃ ɛ v e
килӗшӗр	k i l ɛ ʃ ɛ r
килӗшӳ	k i l ɛ ʃ y
килӗшӳллӗн	k i l ɛ ʃ y lː ɛ n
килӗҫ	k i l ɛ ɕ
кинемей	k i n e m e j
кинемейсем	k i n e m e j s e m
кинеми	k i n e m i
кинне	k i nː e
кино	k i n o
киновӗн	k i n o v ɛ n
киноискусствине	k i n o i s k u sː t v i n e
киномобиль	k i n o m o b i l
кинопродюсор	k i n o p r o d j u s o r
кинотеатра	k i n o t e ɑ t r ɑ
кинотеатрӗсенче	k i n o t e ɑ t r ɛ s e n tʃ e
кинофестиваль	k i n o f e s t i v ɑ l
кинофестивальсенче	k i n o f e s t i v ɑ l s e n tʃ e
кинофильмсем	k i n o f i l m s e m
киноэал	k i n o e ɑ l
киноэала	k i n o e ɑ l ɑ
киноӳнерӗнчи	k i n o y n e r ɛ n tʃ i
кинӗшӗн	k i n ɛ ʃ ɛ n
кирек	k i r e k
кирила	k i r i l ɑ
кирилл	k i r i lː
кирилӑн	k i r i l ʌ n
кирлех	k i r l e χ
кирли	k i r l i
кирлине	k i r l i n e
кирлисен	k i r l i s e n
кирлӗ	k i r l ɛ
кирлӗ-и	k i r l ɛ i
кирлӗ-кирлӗ	k i r l ɛ k i r l ɛ
кирлӗлӗхне	k i r l ɛ l ɛ χ n e
кирпӗчсене	k i r p ɛ tʃ s e n e
китай	k i t ɑ j
китайра	k i t ɑ j r ɑ
китайран	k i t ɑ j r ɑ n
китайри	k i t ɑ j r i
китая	k i t ɑ j ɑ
кичем	k i tʃ e m
кичемччӗ	k i tʃ e m tʃ tʃ ɛ
кишӗрпе	k i ʃ ɛ r p e
киҫтӗк	k i ɕ t ɛ k
класа	k l ɑ s ɑ
класра	k l ɑ s r ɑ
класс	k l ɑ sː
классенче	k l ɑ sː e n tʃ e
клеткӑллӑ	k l e t k ʌ lː ʌ
климатне	k l i m ɑ t n e
клиника	k l i n i k ɑ
клиникин	k l i n i k i n
клиникӑра	k l i n i k ʌ r ɑ
клуб	k l u b
кодексра	k o d e k s r ɑ
кодне	k o d n e
коллективсем	k o lː e k t i v s e m
колонин	k o l o n i n
колонире	k o l o n i r e
колхоэра	k o l χ o e r ɑ
кольӑна	k o l ʌ n ɑ
команда	k o m ɑ n d ɑ
команди	k o m ɑ n d i
командинче	k o m ɑ n d i n tʃ e
командирне	k o m ɑ n d i r n e
командировкӑна	k o m ɑ n d i r o v k ʌ n ɑ
командировкӑра	k o m ɑ n d i r o v k ʌ r ɑ
командирпа	k o m ɑ n d i r p ɑ
командишӗн	k o m ɑ n d i ʃ ɛ n
комбайнерсенчен	k o m b ɑ j n e r s e n tʃ e n
комбинатне	k o m b i n ɑ t n e
комендант	k o m e n d ɑ n t
комиссийӗн	k o m i sː i j ɛ n
комиссисен	k o m i sː i s e n
комментарисенче	k o mː e n t ɑ r i s e n tʃ e
коммуналлӑ	k o mː u n ɑ lː ʌ
коммунист	k o mː u n i s t
коммунист-депутатпа	k o mː u n i s t d e p u t ɑ t p ɑ
компани	k o m p ɑ n i
комплексне	k o m p l e k s n e
комплексӗ	k o m p l e k s ɛ
компоэитор	k o m p o e i t o r
компоэитора	k o m p o e i t o r ɑ
компресс	k o m p r e sː
компьютер	k o m p j u t e r
компьютертан	k o m p j u t e r t ɑ n
комсомолецсем	k o m s o m o l e ts s e m
комсомолӗн	k o m s o m o l ɛ n
конгресс	k o n g r e sː
конгресӑн	k o n g r e s ʌ n
кондукторӗ	k o n d u k t o r ɛ
конкурс	k o n k u r s
конкурса	k o n k u r s ɑ
конкурссен	k o n k u r sː e n
конкурссенче	k o n k u r sː e n tʃ e
конкурсӑн	k o n k u r s ʌ n
конкурсӗнче	k o n k u r s ɛ n tʃ e
консервӑна	k o n s e r v ʌ n ɑ
консервӑпа	k o n s e r v ʌ p ɑ
константин	k o n s t ɑ n t i n
константинополе	k o n s t ɑ n t i n o p o l e
консультаци	k o n s u l t ɑ ts i
контактра	k o n t ɑ k t r ɑ
контракт	k o n t r ɑ k t
концепцийӗ	k o n ts e p ts i j ɛ
концерна	k o n ts e r n ɑ
концернӑн	k o n ts e r n ʌ n
концерт	k o n ts e r t
концертпа	k o n ts e r t p ɑ
концертра	k o n ts e r t r ɑ
концертсем	k o n ts e r ts e m
концертсене	k o n ts e r ts e n e
концерчӗ	k o n ts e r tʃ ɛ
координаци	k o o r d i n ɑ ts i
корейӑри	k o r e j ʌ r i
коридорта	k o r i d o r t ɑ
коррупцие	k o rː u p ts i e
коррупципе	k o rː u p ts i p e
косметолога	k o s m e t o l o g ɑ
костин	k o s t i n
кострома	k o s t r o m ɑ
котельнӑй	k o t e l n ʌ j
котельнӑйне	k o t e l n ʌ j n e
кофе	k o f e
кофӗпе	k o f ɛ p e
коцертмейстерӗ	k o ts e r t m e j s t e r ɛ
коэак	k o e ɑ k
кравать	k r ɑ v ɑ t
красноармейски	k r ɑ s n o ɑ r m e j s k i
краснов	k r ɑ s n o v
красноярск	k r ɑ s n o j ɑ r s k
кредитпа	k r e d i t p ɑ
кредичӗ	k r e d i tʃ ɛ
крематори	k r e m ɑ t o r i
кремль	k r e m l
крепостла	k r e p o s t l ɑ
критерисем	k r i t e r i s e m
критерисене	k r i t e r i s e n e
критиклес	k r i t i k l e s
кролик	k r o l i k
кружоксем	k r u ʒ o k s e m
крымра	k r ɯ m r ɑ
ку	k u
кубокпа	k u b o k p ɑ
кубокӗшӗн	k u b o k ɛ ʃ ɛ n
кудаков	k u d ɑ k o v
кукамӑшӗ	k u k ɑ m ʌ ʃ ɛ
куккурус	k u kː u r u s
кулинарсем	k u l i n ɑ r s e m
кулине	k u l i n e
куллен	k u lː e n
кулленех	k u lː e n e χ
кулленхи	k u lː e n χ i
кулли	k u lː i
кулни	k u l n i
кулса	k u l s ɑ
культура	k u l t u r ɑ
культури	k u l t u r i
культурин	k u l t u r i n
культурипе	k u l t u r i p e
культурӑна	k u l t u r ʌ n ɑ
культурӑпа	k u l t u r ʌ p ɑ
культурӑсем	k u l t u r ʌ s e m
культурӑсемпе	k u l t u r ʌ s e m p e
кулянмалли	k u l j ɑ n m ɑ lː i
кулянмаллипех	k u l j ɑ n m ɑ lː i p e χ
куляннӑ	k u l j ɑ nː ʌ
куляннӑран	k u l j ɑ nː ʌ r ɑ n
кулянса	k u l j ɑ n s ɑ
кулянтарать	k u l j ɑ n t ɑ r ɑ t
кулӑ	k u l ʌ
кулӑн	k u l ʌ n
кулӑшла	k u l ʌ ʃ l ɑ
кумкка	k u m kː ɑ
кун	k u n
куна	k u n ɑ
кунах	k u n ɑ χ
кунашкал	k u n ɑ ʃ k ɑ l
кунжут	k u n ʒ u t
кунлать	k u n l ɑ t
кунне	k u nː e
куннех	k u nː e χ
кунпа	k u n p ɑ
кунра	k u n r ɑ
кунран	k u n r ɑ n
кунсем	k u n s e m
кунсенче	k u n s e n tʃ e
кунсерен	k u n s e r e n
кунсӑр	k u n s ʌ r
кунта	k u n t ɑ
кунтан	k u n t ɑ n
кунтах	k u n t ɑ χ
кунхине	k u n χ i n e
кунччен	k u n tʃ tʃ e n
куншӑн	k u n ʃ ʌ n
кунӗ	k u n ɛ
кунӗнче	k u n ɛ n tʃ e
купала	k u p ɑ l ɑ
купель	k u p e l
купи	k u p i
купине	k u p i n e
купрат	k u p r ɑ t
купӑс	k u p ʌ s
купӑсҫӑ	k u p ʌ s ɕ ʌ
кура	k u r ɑ
курава	k u r ɑ v ɑ
куравсемпе	k u r ɑ v s e m p e
куравӗ	k u r ɑ v ɛ
куракан	k u r ɑ k ɑ n
куракана	k u r ɑ k ɑ n ɑ
куракансем	k u r ɑ k ɑ n s e m
куракансен	k u r ɑ k ɑ n s e n
куракансене	k u r ɑ k ɑ n s e n e
курас	k u r ɑ s
курасса	k u r ɑ sː ɑ
курасси	k u r ɑ sː i
курасшӑн	k u r ɑ s ʃ ʌ n
курать	k u r ɑ t
куратӑр-и	k u r ɑ t ʌ r i
курах	k u r ɑ χ
кураяҫҫӗ	k u r ɑ j ɑ ɕː ɛ
кураҫҫӗ	k u r ɑ ɕː ɛ
курма	k u r m ɑ
курмалла	k u r m ɑ lː ɑ
курман	k u r m ɑ n
курманнисем	k u r m ɑ nː i s e m
курманнисемпе	k u r m ɑ nː i s e m p e
курманнисемшӗн	k u r m ɑ nː i s e m ʃ ɛ n
курманшӑн	k u r m ɑ n ʃ ʌ n
курни	k u r n i
курнисене	k u r n i s e n e
курнӑ	k u r n ʌ
курнӑ-ши	k u r n ʌ ʃ i
курнӑшӑн	k u r n ʌ ʃ ʌ n
курпун	k u r p u n
курс	k u r s
курса	k u r s ɑ
курсан	k u r s ɑ n
курсанах	k u r s ɑ n ɑ χ
курсӗ	k u r s ɛ
куртка	k u r t k ɑ
курткӑпа	k u r t k ʌ p ɑ
куртӑм	k u r t ʌ m
куртӑмӑр	k u r t ʌ m ʌ r
курупкара	k u r u p k ɑ r ɑ
курупкасене	k u r u p k ɑ s e n e
курупкасенче	k u r u p k ɑ s e n tʃ e
курчӗҫ	k u r tʃ ɛ ɕ
курӑк	k u r ʌ k
курӑкӗнчен	k u r ʌ k ɛ n tʃ e n
курӑмлӑ	k u r ʌ m l ʌ
курӑнакан	k u r ʌ n ɑ k ɑ n
курӑнать	k u r ʌ n ɑ t
курӑнма	k u r ʌ n m ɑ
куславкка	k u s l ɑ v kː ɑ
куславккари	k u s l ɑ v kː ɑ r i
кусма	k u s m ɑ
кустӑрмисемпе	k u s t ʌ r m i s e m p e
кутамккари	k u t ɑ m kː ɑ r i
кухньӑра	k u χ n ʌ r ɑ
кушака	k u ʃ ɑ k ɑ
кушакӗ	k u ʃ ɑ k ɛ
кушӑрханӑ	k u ʃ ʌ r χ ɑ n ʌ
куэьминсен	k u e m i n s e n
куҫ	k u ɕ
куҫа	k u ɕ ɑ
куҫакан	k u ɕ ɑ k ɑ n
куҫарасшӑн	k u ɕ ɑ r ɑ s ʃ ʌ n
куҫариччен	k u ɕ ɑ r i tʃ tʃ e n
куҫарма	k u ɕ ɑ r m ɑ
куҫармалли	k u ɕ ɑ r m ɑ lː i
куҫарнине	k u ɕ ɑ r n i n e
куҫарнӑ	k u ɕ ɑ r n ʌ
куҫарса	k u ɕ ɑ r s ɑ
куҫару	k u ɕ ɑ r u
куҫарчӗҫ	k u ɕ ɑ r tʃ ɛ ɕ
куҫасси	k u ɕ ɑ sː i
куҫасшӑн	k u ɕ ɑ s ʃ ʌ n
куҫать	k u ɕ ɑ t
куҫма	k u ɕ m ɑ
куҫмалла	k u ɕ m ɑ lː ɑ
куҫне	k u ɕ n e
куҫнӑ	k u ɕ n ʌ
куҫран	k u ɕ r ɑ n
куҫса	k u ɕ s ɑ
куҫсенчен	k u ɕ s e n tʃ e n
куҫҫуль	k u ɕː u l
куҫҫульпех	k u ɕː u l p e χ
куҫӗ	k u ɕ ɛ
куҫӗнче	k u ɕ ɛ n tʃ e
куҫӗсем	k u ɕ ɛ s e m
куҫӗсене	k u ɕ ɛ s e n e
кӑвайт	k ʌ v ɑ j t
кӑвак	k ʌ v ɑ k
кӑвакарсах	k ʌ v ɑ k ɑ r s ɑ χ
кӑвакартмасӑр	k ʌ v ɑ k ɑ r t m ɑ s ʌ r
кӑканарта	k ʌ k ɑ n ɑ r t ɑ
кӑкарнӑскер	k ʌ k ɑ r n ʌ s k e r
кӑкӑра	k ʌ k ʌ r ɑ
кӑкӑрне	k ʌ k ʌ r n e
кӑкӑрпа	k ʌ k ʌ r p ɑ
кӑларайман	k ʌ l ɑ r ɑ j m ɑ n
кӑларас	k ʌ l ɑ r ɑ s
кӑларасшӑн	k ʌ l ɑ r ɑ s ʃ ʌ n
кӑларать	k ʌ l ɑ r ɑ t
кӑлараҫҫӗ	k ʌ l ɑ r ɑ ɕː ɛ
кӑлармалла	k ʌ l ɑ r m ɑ lː ɑ
кӑларнине	k ʌ l ɑ r n i n e
кӑларнӑ	k ʌ l ɑ r n ʌ
кӑларса	k ʌ l ɑ r s ɑ
кӑларттарасшӑн	k ʌ l ɑ r tː ɑ r ɑ s ʃ ʌ n
кӑлартӑм	k ʌ l ɑ r t ʌ m
кӑларӑмӗ	k ʌ l ɑ r ʌ m ɛ
кӑларӑмӗсем	k ʌ l ɑ r ʌ m ɛ s e m
кӑлтӑк	k ʌ l t ʌ k
кӑлтӑка	k ʌ l t ʌ k ɑ
кӑлтӑксӑр	k ʌ l t ʌ k s ʌ r
кӑмака	k ʌ m ɑ k ɑ
кӑмакисем	k ʌ m ɑ k i s e m
кӑмпа	k ʌ m p ɑ
кӑмӑл	k ʌ m ʌ l
кӑмӑла	k ʌ m ʌ l ɑ
кӑмӑллани	k ʌ m ʌ lː ɑ n i
кӑмӑллать	k ʌ m ʌ lː ɑ t
кӑмӑллатӑп	k ʌ m ʌ lː ɑ t ʌ p
кӑмӑллине	k ʌ m ʌ lː i n e
кӑмӑллисем	k ʌ m ʌ lː i s e m
кӑмӑллисен	k ʌ m ʌ lː i s e n
кӑмӑллӑ	k ʌ m ʌ lː ʌ
кӑмӑллӑн	k ʌ m ʌ lː ʌ n
кӑмӑллӑскер	k ʌ m ʌ lː ʌ s k e r
кӑмӑлне	k ʌ m ʌ l n e
кӑмӑлпа	k ʌ m ʌ l p ɑ
кӑмӑлсӑррисен	k ʌ m ʌ l s ʌ rː i s e n
кӑмӑлсӑррӑн	k ʌ m ʌ l s ʌ rː ʌ n
кӑмӑлтан	k ʌ m ʌ l t ɑ n
кӑмӑлӑсӑррӑн	k ʌ m ʌ l ʌ s ʌ rː ʌ n
кӑн-кӑвак	k ʌ n k ʌ v ɑ k
кӑна	k ʌ n ɑ
кӑна-ҫке	k ʌ n ɑ ɕ k e
кӑнтӑр	k ʌ n t ʌ r
кӑпӑшка	k ʌ p ʌ ʃ k ɑ
кӑра	k ʌ r ɑ
кӑранташ	k ʌ r ɑ n t ɑ ʃ
кӑранташпа	k ʌ r ɑ n t ɑ ʃ p ɑ
кӑрлач	k ʌ r l ɑ tʃ
кӑскӑланакан	k ʌ s k ʌ l ɑ n ɑ k ɑ n
кӑсӑкланать	k ʌ s ʌ k l ɑ n ɑ t
кӑсӑкланмастӑм	k ʌ s ʌ k l ɑ n m ɑ s t ʌ m
кӑсӑкланнӑ	k ʌ s ʌ k l ɑ nː ʌ
кӑсӑклантарнӑ	k ʌ s ʌ k l ɑ n t ɑ r n ʌ
кӑсӑклӑ	k ʌ s ʌ k l ʌ
кӑсӑкӗ	k ʌ s ʌ k ɛ
кӑтартайми	k ʌ t ɑ r t ɑ j m i
кӑтартакан	k ʌ t ɑ r t ɑ k ɑ n
кӑтартакансем	k ʌ t ɑ r t ɑ k ɑ n s e m
кӑтартать	k ʌ t ɑ r t ɑ t
кӑтартаҫҫӗ	k ʌ t ɑ r t ɑ ɕː ɛ
кӑтартма	k ʌ t ɑ r t m ɑ
кӑтартмалла	k ʌ t ɑ r t m ɑ lː ɑ
кӑтартнӑ	k ʌ t ɑ r t n ʌ
кӑтартнӑ-и	k ʌ t ɑ r t n ʌ i
кӑтартрӑм	k ʌ t ɑ r t r ʌ m
кӑтартрӗ	k ʌ t ɑ r t r ɛ
кӑтарттӑр	k ʌ t ɑ r tː ʌ r
кӑтарту	k ʌ t ɑ r t u
кӑтартусем	k ʌ t ɑ r t u s e m
кӑтартӑвӗ	k ʌ t ɑ r t ʌ v ɛ
кӑтартӗҫ	k ʌ t ɑ r t ɛ ɕ
кӑткӑс	k ʌ t k ʌ s
кӑткӑслатаҫҫӗ	k ʌ t k ʌ s l ɑ t ɑ ɕː ɛ
кӑтӑкланаканни	k ʌ t ʌ k l ɑ n ɑ k ɑ nː i
кӑтӑкласа	k ʌ t ʌ k l ɑ s ɑ
кӑшарнинче	k ʌ ʃ ɑ r n i n tʃ e
кӑшкӑрнӑ	k ʌ ʃ k ʌ r n ʌ
кӑшкӑртӑмӑр	k ʌ ʃ k ʌ r t ʌ m ʌ r
кӑшманпа	k ʌ ʃ m ɑ n p ɑ
кӑшманӗ	k ʌ ʃ m ɑ n ɛ
кӑшт	k ʌ ʃ t
кӑштах	k ʌ ʃ t ɑ χ
кӑштахран	k ʌ ʃ t ɑ χ r ɑ n
кӑшӑлӗсем	k ʌ ʃ ʌ l ɛ s e m
кӑҫал	k ʌ ɕ ɑ l
кӑҫаллӑха	k ʌ ɕ ɑ lː ʌ χ ɑ
кӑҫалхи	k ʌ ɕ ɑ l χ i
кӑҫалхипе	k ʌ ɕ ɑ l χ i p e
кӑҫатӑ	k ʌ ɕ ɑ t ʌ
кӗвӗ	k ɛ v ɛ
кӗленче	k ɛ l e n tʃ e
кӗленчесене	k ɛ l e n tʃ e s e n e
кӗлетке	k ɛ l e t k e
кӗлеткеллӗ	k ɛ l e t k e lː ɛ
кӗлетки	k ɛ l e t k i
кӗлеткине	k ɛ l e t k i n e
кӗлеткипе	k ɛ l e t k i p e
кӗлленмен	k ɛ lː e n m e n
кӗлленнӗ	k ɛ lː e nː ɛ
кӗлтумалли	k ɛ l t u m ɑ lː i
кӗме	k ɛ m e
кӗмелли	k ɛ m e lː i
кӗмӗл	k ɛ m ɛ l
кӗмӗле	k ɛ m ɛ l e
кӗнеке	k ɛ n e k e
кӗнекене	k ɛ n e k e n e
кӗнекери	k ɛ n e k e r i
кӗнекешӗн	k ɛ n e k e ʃ ɛ n
кӗнекисемпе	k ɛ n e k i s e m p e
кӗни	k ɛ n i
кӗнине	k ɛ n i n e
кӗнӗ	k ɛ n ɛ
кӗнӗччӗ	k ɛ n ɛ tʃ tʃ ɛ
кӗпе-тум	k ɛ p e t u m
кӗпене	k ɛ p e n e
кӗпепе	k ɛ p e p e
кӗпер	k ɛ p e r
кӗперпе	k ɛ p e r p e
кӗпесӗр	k ɛ p e s ɛ r
кӗпеччӗ	k ɛ p e tʃ tʃ ɛ
кӗпи	k ɛ p i
кӗпӗрнаттӑрӗсене	k ɛ p ɛ r n ɑ tː ʌ r ɛ s e n e
кӗр	k ɛ r
кӗреймен-ха	k ɛ r e j m e n χ ɑ
кӗреймерӗ	k ɛ r e j m e r ɛ
кӗрейместӗм	k ɛ r e j m e s t ɛ m
кӗрекен	k ɛ r e k e n
кӗрен	k ɛ r e n
кӗрет	k ɛ r e t
кӗретпӗр	k ɛ r e t p ɛ r
кӗрешекен	k ɛ r e ʃ e k e n
кӗрешекенсем	k ɛ r e ʃ e k e n s e m
кӗрешесшӗн	k ɛ r e ʃ e s ʃ ɛ n
кӗрешме	k ɛ r e ʃ m e
кӗрешмелле	k ɛ r e ʃ m e lː e
кӗрешсен	k ɛ r e ʃ s e n
кӗрешӳ	k ɛ r e ʃ y
кӗркунне	k ɛ r k u nː e
кӗрлесе	k ɛ r l e s e
кӗрпе	k ɛ r p e
кӗрсе	k ɛ r s e
кӗрсен	k ɛ r s e n
кӗртес	k ɛ r t e s
кӗртесси	k ɛ r t e sː i
кӗртессипе	k ɛ r t e sː i p e
кӗртме	k ɛ r t m e
кӗртнӗ	k ɛ r t n ɛ
кӗртрӗҫ	k ɛ r t r ɛ ɕ
кӗртӗҫ	k ɛ r t ɛ ɕ
кӗрхи	k ɛ r χ i
кӗрӗ	k ɛ r ɛ
кӗрӗвӗ	k ɛ r ɛ v ɛ
кӗрӳ	k ɛ r y
кӗсйинче	k ɛ s j i n tʃ e
кӗске	k ɛ s k e
кӗскетсе	k ɛ s k e ts e
кӗсьери	k ɛ s e r i
кӗтерне	k ɛ t e r n e
кӗтеслӗ	k ɛ t e s l ɛ
кӗтесӗ	k ɛ t e s ɛ
кӗтесӗнчен	k ɛ t e s ɛ n tʃ e n
кӗтет	k ɛ t e t
кӗтетпӗр	k ɛ t e t p ɛ r
кӗтетчӗ	k ɛ t e t tʃ ɛ
кӗтеҫҫӗ	k ɛ t e ɕː ɛ
кӗтмелле	k ɛ t m e lː e
кӗтмен	k ɛ t m e n
кӗтменччӗ	k ɛ t m e n tʃ tʃ ɛ
кӗтнине	k ɛ t n i n e
кӗтнӗ	k ɛ t n ɛ
кӗтнӗн	k ɛ t n ɛ n
кӗтрӗ	k ɛ t r ɛ
кӗтсе	k ɛ ts e
кӗттермен	k ɛ tː e r m e n
кӗтӗвне	k ɛ t ɛ v n e
кӗтӗм	k ɛ t ɛ m
кӗтӗмӗр	k ɛ t ɛ m ɛ r
кӗтӳ	k ɛ t y
кӗтӳри	k ɛ t y r i
кӗчӗ	k ɛ tʃ ɛ
кӗҫех	k ɛ ɕ e χ
кӗҫӗн	k ɛ ɕ ɛ n
кӗҫӗр	k ɛ ɕ ɛ r
кӗҫӗрех	k ɛ ɕ ɛ r e χ
кӳлес	k y l e s
кӳлле	k y lː e
кӳлмекӗнчен	k y l m e k ɛ n tʃ e n
кӳлӗ	k y l ɛ
кӳлӗсем	k y l ɛ s e m
кӳме	k y m e
кӳмине	k y m i n e
кӳнта	k y n t ɑ
кӳнтелен	k y n t e l e n
кӳнӗ	k y n ɛ
кӳнӗшӗн	k y n ɛ ʃ ɛ n
кӳперпа	k y p e r p ɑ
кӳреймен	k y r e j m e n
кӳренме	k y r e n m e
кӳреннӗ	k y r e nː ɛ
кӳренӗвӗсене	k y r e n ɛ v ɛ s e n e
кӳрет	k y r e t
кӳршӗ	k y r ʃ ɛ
кӳршӗри	k y r ʃ ɛ r i
кӳрӗҫ	k y r ɛ ɕ
лавкка	l ɑ v kː ɑ
лавкка-кафе	l ɑ v kː ɑ k ɑ f e
лавккана	l ɑ v kː ɑ n ɑ
лавккара	l ɑ v kː ɑ r ɑ
лавккари	l ɑ v kː ɑ r i
лавккасемпе	l ɑ v kː ɑ s e m p e
лавккасенче	l ɑ v kː ɑ s e n tʃ e
лавкки	l ɑ v kː i
ладыков	l ɑ d ɯ k o v
лайӑх	l ɑ j ʌ χ
лайӑхланӗ	l ɑ j ʌ χ l ɑ n ɛ
лайӑхлатассипе	l ɑ j ʌ χ l ɑ t ɑ sː i p e
лайӑхрах	l ɑ j ʌ χ r ɑ χ
лайӑххине	l ɑ j ʌ χː i n e
лакрей	l ɑ k r e j
лампӑсем	l ɑ m p ʌ s e m
лана	l ɑ n ɑ
лапамне	l ɑ p ɑ m n e
лапамра	l ɑ p ɑ m r ɑ
лапамӗнче	l ɑ p ɑ m ɛ n tʃ e
лапланӗ	l ɑ p l ɑ n ɛ
лапмӑсене	l ɑ p m ʌ s e n e
лапсенче	l ɑ p s e n tʃ e
лаптӑк	l ɑ p t ʌ k
лаптӑкне	l ɑ p t ʌ k n e
лаптӑкӗнчи	l ɑ p t ʌ k ɛ n tʃ i
лаптӑкӗсене	l ɑ p t ʌ k ɛ s e n e
лапчӑнни	l ɑ p tʃ ʌ nː i
лапчӑтнӑ	l ɑ p tʃ ʌ t n ʌ
лара-тӑра	l ɑ r ɑ t ʌ r ɑ
ларакансем	l ɑ r ɑ k ɑ n s e m
ларакансене	l ɑ r ɑ k ɑ n s e n e
лараканскер	l ɑ r ɑ k ɑ n s k e r
ларас	l ɑ r ɑ s
ларасси	l ɑ r ɑ sː i
ларассине	l ɑ r ɑ sː i n e
ларатчӗ	l ɑ r ɑ t tʃ ɛ
ларать	l ɑ r ɑ t
лараҫҫӗ	l ɑ r ɑ ɕː ɛ
лариса	l ɑ r i s ɑ
ларисӑна	l ɑ r i s ʌ n ɑ
лариччен	l ɑ r i tʃ tʃ e n
ларма	l ɑ r m ɑ
лармалла	l ɑ r m ɑ lː ɑ
ларнӑ	l ɑ r n ʌ
ларнӑшӑн	l ɑ r n ʌ ʃ ʌ n
лартас	l ɑ r t ɑ s
лартать	l ɑ r t ɑ t
лартаҫҫӗ	l ɑ r t ɑ ɕː ɛ
лартма	l ɑ r t m ɑ
лартмалла	l ɑ r t m ɑ lː ɑ
лартмасан	l ɑ r t m ɑ s ɑ n
лартнӑ	l ɑ r t n ʌ
лартрӑм	l ɑ r t r ʌ m
лартсан	l ɑ r ts ɑ n
лартӑм	l ɑ r t ʌ m
лартӗҫ	l ɑ r t ɛ ɕ
лару	l ɑ r u
лару-тӑру	l ɑ r u t ʌ r u
лару-тӑрура	l ɑ r u t ʌ r u r ɑ
лару-тӑруран	l ɑ r u t ʌ r u r ɑ n
лару-тӑрӑва	l ɑ r u t ʌ r ʌ v ɑ
лару-тӑрӑвӗ	l ɑ r u t ʌ r ʌ v ɛ
ларура	l ɑ r u r ɑ
ларчӗ	l ɑ r tʃ ɛ
ларӑва	l ɑ r ʌ v ɑ
ларӑвне	l ɑ r ʌ v n e
ларӑвӗнче	l ɑ r ʌ v ɛ n tʃ e
латин	l ɑ t i n
лауреатсен	l ɑ u r e ɑ ts e n
лаша	l ɑ ʃ ɑ
лашана	l ɑ ʃ ɑ n ɑ
левина	l e v i n ɑ
лейкоэ	l e j k o e
лекесрен	l e k e s r e n
лекет	l e k e t
лекетчӗ	l e k e t tʃ ɛ
лекмелле	l e k m e lː e
лекмен	l e k m e n
лекмешкӗн	l e k m e ʃ k ɛ n
лекни	l e k n i
лекнисен	l e k n i s e n
лекнисене	l e k n i s e n e
лекнӗ	l e k n ɛ
лекнӗ-ха	l e k n ɛ χ ɑ
лекрӗ	l e k r ɛ
лекрӗм	l e k r ɛ m
лексе	l e k s e
лексен	l e k s e n
лексенех	l e k s e n e χ
лекци	l e k ts i
лена	l e n ɑ
ленин	l e n i n
ленинская	l e n i n s k ɑ j ɑ
леонид	l e o n i d
леш	l e ʃ
лешӗ	l e ʃ ɛ
леҫеттӗмӗр	l e ɕ e tː ɛ m ɛ r
леҫнӗ	l e ɕ n ɛ
леҫсе	l e ɕ s e
либерал-демократ	l i b e r ɑ l d e m o k r ɑ t
ливневкӑсем	l i v n e v k ʌ s e m
лили	l i l i
лилисене	l i l i s e n e
лиля	l i l j ɑ
лингвохӑтлавӗпе	l i n g v o χ ʌ t l ɑ v ɛ p e
линейкӑра	l i n e j k ʌ r ɑ
линине	l i n i n e
литература	l i t e r ɑ t u r ɑ
литипе	l i t i p e
лиценэи	l i ts e n e i
лиэа	l i e ɑ
логика	l o g i k ɑ
люк	l j u k
лӑк	l ʌ k
лӑп	l ʌ p
лӑпкӑ	l ʌ p k ʌ
лӑпкӑлӑх	l ʌ p k ʌ l ʌ χ
лӑпланма	l ʌ p l ɑ n m ɑ
лӑплантарма	l ʌ p l ɑ n t ɑ r m ɑ
лӑштӑр	l ʌ ʃ t ʌ r
м	m
мавр	m ɑ v r
мадагаскар	m ɑ d ɑ g ɑ s k ɑ r
мадура	m ɑ d u r ɑ
май	m ɑ j
майларӗ	m ɑ j l ɑ r ɛ
майлӑ	m ɑ j l ʌ
майонеэ	m ɑ j o n e e
майпа	m ɑ j p ɑ
майринчен	m ɑ j r i n tʃ e n
майӗпен	m ɑ j ɛ p e n
майӗпенрех	m ɑ j ɛ p e n r e χ
макӑрмалла	m ɑ k ʌ r m ɑ lː ɑ
макӑрнӑ	m ɑ k ʌ r n ʌ
макӑрсан	m ɑ k ʌ r s ɑ n
макӑртӑм	m ɑ k ʌ r t ʌ m
макӑрчӗ	m ɑ k ʌ r tʃ ɛ
мала	m ɑ l ɑ
малалла	m ɑ l ɑ lː ɑ
малаллах	m ɑ l ɑ lː ɑ χ
маларах	m ɑ l ɑ r ɑ χ
маларахах	m ɑ l ɑ r ɑ χ ɑ χ
малашлӑх	m ɑ l ɑ ʃ l ʌ χ
малашлӑха	m ɑ l ɑ ʃ l ʌ χ ɑ
малашне	m ɑ l ɑ ʃ n e
малашнехи	m ɑ l ɑ ʃ n e χ i
маленький	m ɑ l e n k i j
малиновка	m ɑ l i n o v k ɑ
малтан	m ɑ l t ɑ n
малтанах	m ɑ l t ɑ n ɑ χ
малтанласа	m ɑ l t ɑ n l ɑ s ɑ
малтанлӑха	m ɑ l t ɑ n l ʌ χ ɑ
малтанхи	m ɑ l t ɑ n χ i
малтанхиллех	m ɑ l t ɑ n χ i lː e χ
малтах	m ɑ l t ɑ χ
малти	m ɑ l t i
мамонтӑн	m ɑ m o n t ʌ n
ман	m ɑ n
мана	m ɑ n ɑ
маникюра	m ɑ n i k j u r ɑ
манифестацие	m ɑ n i f e s t ɑ ts i e
манманнине	m ɑ n m ɑ nː i n e
манмӑп	m ɑ n m ʌ p
манмӑпӑр	m ɑ n m ʌ p ʌ r
маннӑ	m ɑ nː ʌ
манпа	m ɑ n p ɑ
мантарать	m ɑ n t ɑ r ɑ t
манукӗсемпе	m ɑ n u k ɛ s e m p e
маньяк	m ɑ n j ɑ k
маньякӑн	m ɑ n j ɑ k ʌ n
манӑн	m ɑ n ʌ n
манӑр	m ɑ n ʌ r
манӑҫнӑ	m ɑ n ʌ ɕ n ʌ
мар	m ɑ r
мар-и	m ɑ r i
мар-тӑр	m ɑ r t ʌ r
мар-ха	m ɑ r χ ɑ
мар-ши	m ɑ r ʃ i
маргарита	m ɑ r g ɑ r i t ɑ
марина	m ɑ r i n ɑ
маринӑпа	m ɑ r i n ʌ p ɑ
мария	m ɑ r i j ɑ
маррине	m ɑ rː i n e
мартан	m ɑ r t ɑ n
маруҫ	m ɑ r u ɕ
маруҫа	m ɑ r u ɕ ɑ
маруҫӑн	m ɑ r u ɕ ʌ n
марччӗ	m ɑ r tʃ tʃ ɛ
маршрут	m ɑ r ʃ r u t
маршрутчиксене	m ɑ r ʃ r u t tʃ i k s e n e
маршӗ	m ɑ r ʃ ɛ
марье	m ɑ r e
масар	m ɑ s ɑ r
масара	m ɑ s ɑ r ɑ
массӑллӑ	m ɑ sː ʌ lː ʌ
мастерскойра	m ɑ s t e r s k o j r ɑ
математикӑпа	m ɑ t e m ɑ t i k ʌ p ɑ
материал	m ɑ t e r i ɑ l
материала	m ɑ t e r i ɑ l ɑ
материалсем	m ɑ t e r i ɑ l s e m
матильда	m ɑ t i l d ɑ
маттур	m ɑ tː u r
маттуррисем	m ɑ tː u rː i s e m
маттурсем	m ɑ tː u r s e m
маттурччӗ	m ɑ tː u r tʃ tʃ ɛ
мауглисем	m ɑ u g l i s e m
машина	m ɑ ʃ i n ɑ
машина-тракторсене	m ɑ ʃ i n ɑ t r ɑ k t o r s e n e
машини	m ɑ ʃ i n i
машинисем	m ɑ ʃ i n i s e m
машинисчӗ	m ɑ ʃ i n i s tʃ ɛ
машиностроителӗсем	m ɑ ʃ i n o s t r o i t e l ɛ s e m
машинӑна	m ɑ ʃ i n ʌ n ɑ
машинӑсем	m ɑ ʃ i n ʌ s e m
машӑрӗ	m ɑ ʃ ʌ r ɛ
маҫ	m ɑ ɕ
маҫтӑрӗн	m ɑ ɕ t ʌ r ɛ n
медале	m e d ɑ l e
медальне	m e d ɑ l n e
медальпе	m e d ɑ l p e
медальсем	m e d ɑ l s e m
медальсемпе	m e d ɑ l s e m p e
медиксем	m e d i k s e m
медитаципе	m e d i t ɑ ts i p e
медицина	m e d i ts i n ɑ
медпулӑшу	m e d p u l ʌ ʃ u
меллӗ	m e lː ɛ
мелодрамӑсем	m e l o d r ɑ m ʌ s e m
мелпе	m e l p e
мелсем	m e l s e m
мелӗпе	m e l ɛ p e
мелӗсем	m e l ɛ s e m
мера	m e r ɑ
мероприяти	m e r o p r i j ɑ t i
мероприятие	m e r o p r i j ɑ t i e
мероприятийӗсем	m e r o p r i j ɑ t i j ɛ s e m
мероприятине	m e r o p r i j ɑ t i n e
мероприятипе	m e r o p r i j ɑ t i p e
мероприятисем	m e r o p r i j ɑ t i s e m
мероприятисене	m e r o p r i j ɑ t i s e n e
мероприятисенче	m e r o p r i j ɑ t i s e n tʃ e
меслетне	m e s l e t n e
меслетпе	m e s l e t p e
мессенджерсенче	m e sː e n d ʒ e r s e n tʃ e
миасс	m i ɑ sː
микрорайон	m i k r o r ɑ j o n
микрорайонта	m i k r o r ɑ j o n t ɑ
микрорайонтӑ	m i k r o r ɑ j o n t ʌ
микрохумлӑ	m i k r o χ u m l ʌ
микулан	m i k u l ɑ n
милици	m i l i ts i
мимийӗ	m i m i j ɛ
мимин	m i m i n
министерстви	m i n i s t e r s t v i
министерство	m i n i s t e r s t v o
министр	m i n i s t r
министрсем	m i n i s t r s e m
минретекен	m i n r e t e k e n
минут	m i n u t
митинг	m i t i n g
митинга	m i t i n g ɑ
митрополит	m i t r o p o l i t
митя	m i t j ɑ
михаил	m i χ ɑ i l
михайлович	m i χ ɑ j l o v i tʃ
михетер	m i χ e t e r
мишши	m i ʃː i
миҫе	m i ɕ e
модерниэацилесшӗн	m o d e r n i e ɑ ts i l e s ʃ ɛ n
молякова	m o l j ɑ k o v ɑ
мониторинг	m o n i t o r i n g
мониторпа	m o n i t o r p ɑ
мораль	m o r ɑ l
мотоблокпа	m o t o b l o k p ɑ
мотоборда	m o t o b o r d ɑ
мотобордпа	m o t o b o r d p ɑ
мотоброд	m o t o b r o d
моторин	m o t o r i n
моторне	m o t o r n e
мсне	m s n e
мултан	m u l t ɑ n
муниципалитетри	m u n i ts i p ɑ l i t e t r i
мунча	m u n tʃ ɑ
мунче	m u n tʃ e
муркаш	m u r k ɑ ʃ
мурӗ	m u r ɛ
мускав	m u s k ɑ v
мускава	m u s k ɑ v ɑ
мускавпа	m u s k ɑ v p ɑ
мускавра	m u s k ɑ v r ɑ
мускавран	m u s k ɑ v r ɑ n
мускаври	m u s k ɑ v r i
мусӑкҫисем	m u s ʌ k ɕ i s e m
муталанчӑк	m u t ɑ l ɑ n tʃ ʌ k
мухтав	m u χ t ɑ v
мухтанаймаҫҫӗ	m u χ t ɑ n ɑ j m ɑ ɕː ɛ
мухтанмаҫҫӗ	m u χ t ɑ n m ɑ ɕː ɛ
муэей	m u e e j
муэейне	m u e e j n e
муэейрех	m u e e j r e χ
муэейсем	m u e e j s e m
муэейӗ	m u e e j ɛ
муэейӗн	m u e e j ɛ n
муэыкӑпа	m u e ɯ k ʌ p ɑ
мыскарана	m ɯ s k ɑ r ɑ n ɑ
мыскараран	m ɯ s k ɑ r ɑ r ɑ n
мыскари	m ɯ s k ɑ r i
мэра	m e r ɑ
мясниковсене	m j ɑ s n i k o v s e n e
мӑйне	m ʌ j n e
мӑйрака	m ʌ j r ɑ k ɑ
мӑйракаллӑ	m ʌ j r ɑ k ɑ lː ʌ
мӑйракисем	m ʌ j r ɑ k i s e m
мӑйӗнчен	m ʌ j ɛ n tʃ e n
мӑкӑньпе	m ʌ k ʌ n p e
мӑна	m ʌ n ɑ
мӑнаҫланать	m ʌ n ɑ ɕ l ɑ n ɑ t
мӑнтӑр	m ʌ n t ʌ r
мӑнукӑм	m ʌ n u k ʌ m
мӑнукӗ	m ʌ n u k ɛ
мӑнукӗпе	m ʌ n u k ɛ p e
мӑнукӗсенчен	m ʌ n u k ɛ s e n tʃ e n
мӑшкӑлласа	m ʌ ʃ k ʌ lː ɑ s ɑ
мӑшкӑлӗнчен	m ʌ ʃ k ʌ l ɛ n tʃ e n
мӑшӑр	m ʌ ʃ ʌ r
мӑшӑра	m ʌ ʃ ʌ r ɑ
мӑшӑрланиччен	m ʌ ʃ ʌ r l ɑ n i tʃ tʃ e n
мӑшӑрланну	m ʌ ʃ ʌ r l ɑ nː u
мӑшӑрне	m ʌ ʃ ʌ r n e
мӑшӑрпа	m ʌ ʃ ʌ r p ɑ
мӑшӑрсем	m ʌ ʃ ʌ r s e m
мӑшӑрӑм	m ʌ ʃ ʌ r ʌ m
мӑшӑрӗ	m ʌ ʃ ʌ r ɛ
мӑшӑрӗпе	m ʌ ʃ ʌ r ɛ p e
мӗкӗлтеттерме	m ɛ k ɛ l t e tː e r m e
мӗн	m ɛ n
мӗне	m ɛ n e
мӗнех	m ɛ n e χ
мӗнле	m ɛ n l e
мӗнле-ха	m ɛ n l e χ ɑ
мӗнлерех	m ɛ n l e r e χ
мӗнпе	m ɛ n p e
мӗнпур	m ɛ n p u r
мӗншӗн	m ɛ n ʃ ɛ n
мӗскӗн	m ɛ s k ɛ n
навальныйшӑн	n ɑ v ɑ l n ɯ j ʃ ʌ n
наградӑна	n ɑ g r ɑ d ʌ n ɑ
наградӑсемпе	n ɑ g r ɑ d ʌ s e m p e
налук	n ɑ l u k
намӑс	n ɑ m ʌ s
намӑсне	n ɑ m ʌ s n e
наркмӑшлӑ	n ɑ r k m ʌ ʃ l ʌ
наркологи	n ɑ r k o l o g i
наркӑмӑшланса	n ɑ r k ʌ m ʌ ʃ l ɑ n s ɑ
наркӑмӑшлантарнӑ	n ɑ r k ʌ m ʌ ʃ l ɑ n t ɑ r n ʌ
нарспи	n ɑ r s p i
нарядсен	n ɑ r j ɑ d s e n
нарӑс	n ɑ r ʌ s
настой	n ɑ s t o j
наци	n ɑ ts i
нацине	n ɑ ts i n e
националист	n ɑ ts i o n ɑ l i s t
нацисем	n ɑ ts i s e m
начар	n ɑ tʃ ɑ r
наччасрах	n ɑ tʃ tʃ ɑ s r ɑ χ
наэ	n ɑ e
невропатолог	n e v r o p ɑ t o l o g
невропотолог	n e v r o p o t o l o g
никам	n i k ɑ m
никама	n i k ɑ m ɑ
никамах	n i k ɑ m ɑ χ
никампа	n i k ɑ m p ɑ
никамран	n i k ɑ m r ɑ n
никамшӑн	n i k ɑ m ʃ ʌ n
никита	n i k i t ɑ
никифоровпа	n i k i f o r o v p ɑ
николаевпа	n i k o l ɑ e v p ɑ
николаевсене	n i k o l ɑ e v s e n e
николай	n i k o l ɑ j
николос	n i k o l o s
никотин	n i k o t i n
никӗсӗн	n i k ɛ s ɛ n
ним	n i m
ниме	n i m e
нимене	n i m e n e
нимеҫӗсен	n i m e ɕ ɛ s e n
нимле	n i m l e
нимпе	n i m p e
нимсӗр	n i m s ɛ r
нимӗн	n i m ɛ n
нимӗнле	n i m ɛ n l e
нимӗнпе	n i m ɛ n p e
нимӗрӗ	n i m ɛ r ɛ
нимӗҫсем	n i m ɛ ɕ s e m
нимӗҫсене	n i m ɛ ɕ s e n e
нина	n i n ɑ
нихӑҫан	n i χ ʌ ɕ ɑ n
ницше	n i ts ʃ e
ниҫта	n i ɕ t ɑ
номер	n o m e r
номерне	n o m e r n e
номерпе	n o m e r p e
номерте	n o m e r t e
номерӗсене	n o m e r ɛ s e n e
номинаци	n o m i n ɑ ts i
номинаципе	n o m i n ɑ ts i p e
номинацире	n o m i n ɑ ts i r e
нормӑпа	n o r m ʌ p ɑ
нумай	n u m ɑ j
нумайланӗҫ	n u m ɑ j l ɑ n ɛ ɕ
нумайрах	n u m ɑ j r ɑ χ
нумайччен	n u m ɑ j tʃ tʃ e n
нумайӑшӗ	n u m ɑ j ʌ ʃ ɛ
нумайӑшӗн	n u m ɑ j ʌ ʃ ɛ n
нумаях	n u m ɑ j ɑ χ
нускиччӗ	n u s k i tʃ tʃ ɛ
нухрата	n u χ r ɑ t ɑ
нуша	n u ʃ ɑ
нушаланакан	n u ʃ ɑ l ɑ n ɑ k ɑ n
нушаланни	n u ʃ ɑ l ɑ nː i
нушаланса	n u ʃ ɑ l ɑ n s ɑ
нушаллӑ	n u ʃ ɑ lː ʌ
нушана	n u ʃ ɑ n ɑ
нушине	n u ʃ i n e
нӑйласа	n ʌ j l ɑ s ɑ
облаҫне	o b l ɑ ɕ n e
облаҫри	o b l ɑ ɕ r i
облаҫсен	o b l ɑ ɕ s e n
облаҫӗнче	o b l ɑ ɕ ɛ n tʃ e
облаҫӗнчен	o b l ɑ ɕ ɛ n tʃ e n
облаҫӗнчи	o b l ɑ ɕ ɛ n tʃ i
обшежити	o b ʃ e ʒ i t i
обшестви	o b ʃ e s t v i
обшество	o b ʃ e s t v o
обшествӑн	o b ʃ e s t v ʌ n
обшествӑна	o b ʃ e s t v ʌ n ɑ
обшествӑра	o b ʃ e s t v ʌ r ɑ
обшествӑри	o b ʃ e s t v ʌ r i
объектра	o b e k t r ɑ
объектӑн	o b e k t ʌ n
округӗнче	o k r u g ɛ n tʃ e
округӗнчи	o k r u g ɛ n tʃ i
оксана	o k s ɑ n ɑ
олимп	o l i m p
олимпиада	o l i m p i ɑ d ɑ
олимпиадине	o l i m p i ɑ d i n e
ольга	o l g ɑ
онкодиспансерта	o n k o d i s p ɑ n s e r t ɑ
онкологи	o n k o l o g i
онкомаркер	o n k o m ɑ r k e r
онлайн	o n l ɑ j n
онлайн-репортажра	o n l ɑ j n r e p o r t ɑ ʒ r ɑ
опека	o p e k ɑ
опекӑпа	o p e k ʌ p ɑ
оперативлӑ	o p e r ɑ t i v l ʌ
операци	o p e r ɑ ts i
операципе	o p e r ɑ ts i p e
оперӑпа	o p e r ʌ p ɑ
оппоэиционерӑн	o pː o e i ts i o n e r ʌ n
оптимиэацилеме	o p t i m i e ɑ ts i l e m e
оптимиэацилени	o p t i m i e ɑ ts i l e n i
опычӗпе	o p ɯ tʃ ɛ p e
органиэаци	o r g ɑ n i e ɑ ts i
органиэацийӗ	o r g ɑ n i e ɑ ts i j ɛ
органиэацийӗсен	o r g ɑ n i e ɑ ts i j ɛ s e n
органиэацисем	o r g ɑ n i e ɑ ts i s e m
органиэма	o r g ɑ n i e m ɑ
органне	o r g ɑ nː e
органӗн	o r g ɑ n ɛ n
органӗсен	o r g ɑ n ɛ s e n
орденӗпе	o r d e n ɛ p e
орнитологсем	o r n i t o l o g s e m
осетире	o s e t i r e
осокина	o s o k i n ɑ
остеопетроэ	o s t e o p e t r o e
отварсемпе	o t v ɑ r s e m p e
открытки	o t k r ɯ t k i
отрасле	o t r ɑ s l e
офицерсем	o f i ts e r s e m
официаллӑ	o f i ts i ɑ lː ʌ
очко	o tʃ k o
павильон	p ɑ v i l o n
павильонсене	p ɑ v i l o n s e n e
пайлани	p ɑ j l ɑ n i
пайне	p ɑ j n e
пайтах	p ɑ j t ɑ χ
пайташӗсем	p ɑ j t ɑ ʃ ɛ s e m
пайӑркисем	p ɑ j ʌ r k i s e m
пайӗ	p ɑ j ɛ
пайӗн	p ɑ j ɛ n
пайӗпе	p ɑ j ɛ p e
пайӗсем	p ɑ j ɛ s e m
пайӗсене	p ɑ j ɛ s e n e
пакунлисем	p ɑ k u n l i s e m
палла	p ɑ lː ɑ
паллаканне	p ɑ lː ɑ k ɑ nː e
палламан	p ɑ lː ɑ m ɑ n
палланӑ	p ɑ lː ɑ n ʌ
паллах	p ɑ lː ɑ χ
паллашас	p ɑ lː ɑ ʃ ɑ s
паллашатӑр	p ɑ lː ɑ ʃ ɑ t ʌ r
паллашаҫҫӗ	p ɑ lː ɑ ʃ ɑ ɕː ɛ
паллашма	p ɑ lː ɑ ʃ m ɑ
паллашмаллах	p ɑ lː ɑ ʃ m ɑ lː ɑ χ
паллашмашкӑн	p ɑ lː ɑ ʃ m ɑ ʃ k ʌ n
паллашнӑ	p ɑ lː ɑ ʃ n ʌ
паллашрӑм	p ɑ lː ɑ ʃ r ʌ m
паллашса	p ɑ lː ɑ ʃ s ɑ
паллаштарать	p ɑ lː ɑ ʃ t ɑ r ɑ t
паллаштармасӑр	p ɑ lː ɑ ʃ t ɑ r m ɑ s ʌ r
паллаштарнӑ	p ɑ lː ɑ ʃ t ɑ r n ʌ
паллаштарчӗ	p ɑ lː ɑ ʃ t ɑ r tʃ ɛ
паллаштарӗҫ	p ɑ lː ɑ ʃ t ɑ r ɛ ɕ
паллашу	p ɑ lː ɑ ʃ u
паллашӗ	p ɑ lː ɑ ʃ ɛ
паллаҫҫӗ	p ɑ lː ɑ ɕː ɛ
палли	p ɑ lː i
паллиатив	p ɑ lː i ɑ t i v
паллиативлӑ	p ɑ lː i ɑ t i v l ʌ
паллӑ	p ɑ lː ʌ
паллӑсем	p ɑ lː ʌ s e m
палӑк	p ɑ l ʌ k
палӑка	p ɑ l ʌ k ɑ
палӑкӗ	p ɑ l ʌ k ɛ
палӑрать	p ɑ l ʌ r ɑ t
палӑратӑр	p ɑ l ʌ r ɑ t ʌ r
палӑрмасть	p ɑ l ʌ r m ɑ s t
палӑрнӑ	p ɑ l ʌ r n ʌ
палӑртайман	p ɑ l ʌ r t ɑ j m ɑ n
палӑртас	p ɑ l ʌ r t ɑ s
палӑртассипе	p ɑ l ʌ r t ɑ sː i p e
палӑртать	p ɑ l ʌ r t ɑ t
палӑртаять	p ɑ l ʌ r t ɑ j ɑ t
палӑртма	p ɑ l ʌ r t m ɑ
палӑртмалла	p ɑ l ʌ r t m ɑ lː ɑ
палӑртмалли	p ɑ l ʌ r t m ɑ lː i
палӑртман	p ɑ l ʌ r t m ɑ n
палӑртмаҫҫӗ	p ɑ l ʌ r t m ɑ ɕː ɛ
палӑртни	p ɑ l ʌ r t n i
палӑртнӑ	p ɑ l ʌ r t n ʌ
палӑртнӑ-и	p ɑ l ʌ r t n ʌ i
палӑртрӗ	p ɑ l ʌ r t r ɛ
палӑртса	p ɑ l ʌ r ts ɑ
палӑртӗ	p ɑ l ʌ r t ɛ
палӑртӗҫ	p ɑ l ʌ r t ɛ ɕ
палӑрчӗ	p ɑ l ʌ r tʃ ɛ
пама	p ɑ m ɑ
памалла	p ɑ m ɑ lː ɑ
памалли	p ɑ m ɑ lː i
паман	p ɑ m ɑ n
паман-ха	p ɑ m ɑ n χ ɑ
памассипе	p ɑ m ɑ sː i p e
памасть	p ɑ m ɑ s t
памасӑр	p ɑ m ɑ s ʌ r
памашкӑн	p ɑ m ɑ ʃ k ʌ n
памаҫҫӗ	p ɑ m ɑ ɕː ɛ
памӗ	p ɑ m ɛ
пани	p ɑ n i
панине	p ɑ n i n e
панкратион	p ɑ n k r ɑ t i o n
панкрута	p ɑ n k r u t ɑ
панкрутлӑх	p ɑ n k r u t l ʌ χ
панкрутлӑха	p ɑ n k r u t l ʌ χ ɑ
панӑ	p ɑ n ʌ
панӑ-и	p ɑ n ʌ i
панӑ-мӗн	p ɑ n ʌ m ɛ n
панӑскере	p ɑ n ʌ s k e r e
панӑччӗ	p ɑ n ʌ tʃ tʃ ɛ
папкӑри	p ɑ p k ʌ r i
пар	p ɑ r
парайман	p ɑ r ɑ j m ɑ n
паракан	p ɑ r ɑ k ɑ n
парасси	p ɑ r ɑ sː i
парассине	p ɑ r ɑ sː i n e
парасшӑн	p ɑ r ɑ s ʃ ʌ n
параттӑм	p ɑ r ɑ tː ʌ m
параттӑмӑр	p ɑ r ɑ tː ʌ m ʌ r
паратчӗ	p ɑ r ɑ t tʃ ɛ
парать	p ɑ r ɑ t
паратӑн-и	p ɑ r ɑ t ʌ n i
параҫҫӗ	p ɑ r ɑ ɕː ɛ
парк	p ɑ r k
паркра	p ɑ r k r ɑ
парламент	p ɑ r l ɑ m e n t
парламентарие	p ɑ r l ɑ m e n t ɑ r i e
парламентарире	p ɑ r l ɑ m e n t ɑ r i r e
парламентра	p ɑ r l ɑ m e n t r ɑ
парне	p ɑ r n e
парнеле-ха	p ɑ r n e l e χ ɑ
парнелеймен	p ɑ r n e l e j m e n
парнелекенӗ	p ɑ r n e l e k e n ɛ
парнелеме	p ɑ r n e l e m e
парнеленинчен	p ɑ r n e l e n i n tʃ e n
парнеленӗ	p ɑ r n e l e n ɛ
парнесем	p ɑ r n e s e m
парса	p ɑ r s ɑ
парсан	p ɑ r s ɑ n
пархатарлӑ	p ɑ r χ ɑ t ɑ r l ʌ
пархикассине	p ɑ r χ i k ɑ sː i n e
парӑм	p ɑ r ʌ m
парӑма	p ɑ r ʌ m ɑ
парӑмлисемпе	p ɑ r ʌ m l i s e m p e
парӑмне	p ɑ r ʌ m n e
парӑмра	p ɑ r ʌ m r ɑ
парӑмсем	p ɑ r ʌ m s e m
парӑмҫӑсенчен	p ɑ r ʌ m ɕ ʌ s e n tʃ e n
парӑнать	p ɑ r ʌ n ɑ t
парӑнмалла	p ɑ r ʌ n m ɑ lː ɑ
парӑнманнисем	p ɑ r ʌ n m ɑ nː i s e m
парӑнтарасшӑн	p ɑ r ʌ n t ɑ r ɑ s ʃ ʌ n
парӑнтарма	p ɑ r ʌ n t ɑ r m ɑ
парӑнтармашкӑн	p ɑ r ʌ n t ɑ r m ɑ ʃ k ʌ n
парӗ	p ɑ r ɛ
парӗҫ	p ɑ r ɛ ɕ
пасар	p ɑ s ɑ r
пасарта	p ɑ s ɑ r t ɑ
пасарӗнчен	p ɑ s ɑ r ɛ n tʃ e n
паспорт	p ɑ s p o r t
паспортра	p ɑ s p o r t r ɑ
пассажирсем	p ɑ sː ɑ ʒ i r s e m
пассажирсемшӗн	p ɑ sː ɑ ʒ i r s e m ʃ ɛ n
пассажирсенчен	p ɑ sː ɑ ʒ i r s e n tʃ e n
пата	p ɑ t ɑ
патлогийӗ	p ɑ t l o g i j ɛ
патне	p ɑ t n e
патнелле	p ɑ t n e lː e
патрах	p ɑ t r ɑ χ
паттӑр	p ɑ tː ʌ r
паттӑрла	p ɑ tː ʌ r l ɑ
паттӑрлӑх	p ɑ tː ʌ r l ʌ χ
паттӑрлӑхне	p ɑ tː ʌ r l ʌ χ n e
паттӑррӑн	p ɑ tː ʌ rː ʌ n
паттӑрсене	p ɑ tː ʌ r s e n e
патша	p ɑ tʃ ɑ
патшалӑх	p ɑ tʃ ɑ l ʌ χ
патши	p ɑ tʃ i
патшисенчен	p ɑ tʃ i s e n tʃ e n
патӑм	p ɑ t ʌ m
патӑрьелти	p ɑ t ʌ r e l t i
патӗнче	p ɑ t ɛ n tʃ e
патӗнчен	p ɑ t ɛ n tʃ e n
патӗнчи	p ɑ t ɛ n tʃ i
паха	p ɑ χ ɑ
пахалӑхлӑ	p ɑ χ ɑ l ʌ χ l ʌ
пахалӑхӗ	p ɑ χ ɑ l ʌ χ ɛ
пахча-ҫимӗҫ	p ɑ χ tʃ ɑ ɕ i m ɛ ɕ
пахча-ҫимӗҫе	p ɑ χ tʃ ɑ ɕ i m ɛ ɕ e
пахчана	p ɑ χ tʃ ɑ n ɑ
пахчин	p ɑ χ tʃ i n
пахчине	p ɑ χ tʃ i n e
пациент	p ɑ ts i e n t
пациента	p ɑ ts i e n t ɑ
пациентсем	p ɑ ts i e n ts e m
пачах	p ɑ tʃ ɑ χ
пачӗҫ	p ɑ tʃ ɛ ɕ
паян	p ɑ j ɑ n
паянах	p ɑ j ɑ n ɑ χ
паянтанпа	p ɑ j ɑ n t ɑ n p ɑ
паянхи	p ɑ j ɑ n χ i
паҫхча	p ɑ ɕ χ tʃ ɑ
педагог	p e d ɑ g o g
педагогика	p e d ɑ g o g i k ɑ
педагогӑн	p e d ɑ g o g ʌ n
педиатра	p e d i ɑ t r ɑ
пейэаж	p e j e ɑ ʒ
пейэажсем	p e j e ɑ ʒ s e m
пек	p e k
пекех	p e k e χ
пени	p e n i
пенси	p e n s i
пенсине	p e n s i n e
пенсисӗр	p e n s i s ɛ r
пенӗ	p e n ɛ
пепке	p e p k e
пепкепе	p e p k e p e
пепкин	p e p k i n
пер-пӗрин	p e r p ɛ r i n
перекетлӗ	p e r e k e t l ɛ
перекетлӗр	p e r e k e t l ɛ r
перекетлӗх	p e r e k e t l ɛ χ
перитонита	p e r i t o n i t ɑ
персе	p e r s e
персонажсене	p e r s o n ɑ ʒ s e n e
перчеткине	p e r tʃ e t k i n e
перӗннӗ	p e r ɛ nː ɛ
петр	p e t r
петров	p e t r o v
петрович	p e t r o v i tʃ
петӗм	p e t ɛ m
петӗрпе	p e t ɛ r p e
пехил	p e χ i l
печӗ	p e tʃ ɛ
пике	p i k e
пикеннӗ	p i k e nː ɛ
пикенчӗ	p i k e n tʃ ɛ
пикета	p i k e t ɑ
пики	p i k i
пикри	p i k r i
пил	p i l
пилеш	p i l e ʃ
пиллӗк	p i lː ɛ k
пиллӗкмӗш	p i lː ɛ k m ɛ ʃ
пилӗк	p i l ɛ k
пин-пин	p i n p i n
пир	p i r
пир-авӑр	p i r ɑ v ʌ r
пирвайхи	p i r v ɑ j χ i
пире	p i r e
пирки	p i r k i
пирки-ха	p i r k i χ ɑ
пирус	p i r u s
пирӗн	p i r ɛ n
пирӗнпе	p i r ɛ n p e
пирӗншӗн	p i r ɛ n ʃ ɛ n
пит	p i t
питех	p i t e χ
питтинче	p i tː i n tʃ e
питӗ	p i t ɛ
питӗр	p i t ɛ r
питӗре	p i t ɛ r e
питӗрмен	p i t ɛ r m e n
пичете	p i tʃ e t e
пичетлеймен-ха	p i tʃ e t l e j m e n χ ɑ
пичетлеме	p i tʃ e t l e m e
пичетлӗҫ	p i tʃ e t l ɛ ɕ
пичетӗнче	p i tʃ e t ɛ n tʃ e
пичкине	p i tʃ k i n e
пичче	p i tʃ tʃ e
пиччене	p i tʃ tʃ e n e
пиччепе	p i tʃ tʃ e p e
пиччӗшӗ	p i tʃ tʃ ɛ ʃ ɛ
пичӗ	p i tʃ ɛ
пичӗ-куҫӗ	p i tʃ ɛ k u ɕ ɛ
пиҫсе	p i ɕ s e
пиҫӗхсе	p i ɕ ɛ χ s e
пиҫӗхтерччӗр	p i ɕ ɛ χ t e r tʃ tʃ ɛ r
план	p l ɑ n
планеркӑра	p l ɑ n e r k ʌ r ɑ
планета	p l ɑ n e t ɑ
планпа	p l ɑ n p ɑ
планшет	p l ɑ n ʃ e t
пластик	p l ɑ s t i k
плин	p l i n
плотина	p l o t i n ɑ
плотинӑна	p l o t i n ʌ n ɑ
плуг	p l u g
пневматика	p n e v m ɑ t i k ɑ
поварсен	p o v ɑ r s e n
повестка	p o v e s t k ɑ
подполковникӗ	p o d p o l k o v n i k ɛ
подряд	p o d r j ɑ d
подьеэдран	p o d e e d r ɑ n
полигон	p o l i g o n
поликлиникине	p o l i k l i n i k i n e
поликлиникӑра	p o l i k l i n i k ʌ r ɑ
политики	p o l i t i k i
политикине	p o l i t i k i n e
политикипе	p o l i t i k i p e
политикӑран	p o l i t i k ʌ r ɑ n
полицейсиксем	p o l i ts e j s i k s e m
полицейскийӗсене	p o l i ts e j s k i j ɛ s e n e
полицейскисем	p o l i ts e j s k i s e m
полицейскисен	p o l i ts e j s k i s e n
полицейскисене	p o l i ts e j s k i s e n e
полицейскисенчен	p o l i ts e j s k i s e n tʃ e n
полици	p o l i ts i
полицие	p o l i ts i e
полицирен	p o l i ts i r e n
попечитель	p o p e tʃ i t e l
попкорн	p o p k o r n
порталӗнче	p o r t ɑ l ɛ n tʃ e
портречӗсем	p o r t r e tʃ ɛ s e m
поселокӗнче	p o s e l o k ɛ n tʃ e
пособи	p o s o b i
пособийӗпе	p o s o b i j ɛ p e
пособине	p o s o b i n e
пособисене	p o s o b i s e n e
посольстви	p o s o l s t v i
постановкӑна	p o s t ɑ n o v k ʌ n ɑ
посылка	p o s ɯ l k ɑ
посылкӑна	p o s ɯ l k ʌ n ɑ
посылкӑсене	p o s ɯ l k ʌ s e n e
почта	p o tʃ t ɑ
почтӑпа	p o tʃ t ʌ p ɑ
правасене	p r ɑ v ɑ s e n e
правасӑр	p r ɑ v ɑ s ʌ r
правилисене	p r ɑ v i l i s e n e
правинчен	p r ɑ v i n tʃ e n
прависене	p r ɑ v i s e n e
правительствин	p r ɑ v i t e l s t v i n
правительство	p r ɑ v i t e l s t v o
православи	p r ɑ v o s l ɑ v i
прагер	p r ɑ g e r
праҫнике	p r ɑ ɕ n i k e
предмет	p r e d m e t
предмета	p r e d m e t ɑ
предметпа	p r e d m e t p ɑ
предмечӗ	p r e d m e tʃ ɛ
предмечӗн	p r e d m e tʃ ɛ n
предприяти	p r e d p r i j ɑ t i
предприяти-органиэацисем	p r e d p r i j ɑ t i o r g ɑ n i e ɑ ts i s e m
предприятие	p r e d p r i j ɑ t i e
предприятийӗсене	p r e d p r i j ɑ t i j ɛ s e n e
предприятире	p r e d p r i j ɑ t i r e
предприятири	p r e d p r i j ɑ t i r i
председательне	p r e d s e d ɑ t e l n e
представитель	p r e d s t ɑ v i t e l
представлени	p r e d s t ɑ v l e n i
преми	p r e m i
премине	p r e m i n e
премьер-министр	p r e m e r m i n i s t r
препаратпа	p r e p ɑ r ɑ t p ɑ
препаратсем	p r e p ɑ r ɑ ts e m
препаратсен	p r e p ɑ r ɑ ts e n
пресс-конференци	p r e sː k o n f e r e n ts i
пресс-служби	p r e sː s l u ʒ b i
преступлени	p r e s t u p l e n i
преступленисене	p r e s t u p l e n i s e n e
прививка	p r i v i v k ɑ
приговор	p r i g o v o r
приговорӗ	p r i g o v o r ɛ
принц	p r i n ts
присяга	p r i s j ɑ g ɑ
причал	p r i tʃ ɑ l
прическӑна	p r i tʃ e s k ʌ n ɑ
проблемине	p r o b l e m i n e
провинцийӗпе	p r o v i n ts i j ɛ p e
провокациллӗ	p r o v o k ɑ ts i lː ɛ
программа	p r o g r ɑ mː ɑ
программи	p r o g r ɑ mː i
программинче	p r o g r ɑ mː i n tʃ e
программипе	p r o g r ɑ mː i p e
программисене	p r o g r ɑ mː i s e n e
программӑна	p r o g r ɑ mː ʌ n ɑ
программӑпа	p r o g r ɑ mː ʌ p ɑ
программӑра	p r o g r ɑ mː ʌ r ɑ
программӑран	p r o g r ɑ mː ʌ r ɑ n
продюсер	p r o d j u s e r
проект	p r o e k t
проекта	p r o e k t ɑ
проектпа	p r o e k t p ɑ
проектсем	p r o e k ts e m
проектӗнче	p r o e k t ɛ n tʃ e
проекчӗ	p r o e k tʃ ɛ
проекчӗсемпе	p r o e k tʃ ɛ s e m p e
прожекторсемпе	p r o ʒ e k t o r s e m p e
проиэводствине	p r o i e v o d s t v i n e
прокартра	p r o k ɑ r t r ɑ
прокуратура	p r o k u r ɑ t u r ɑ
прокуратури	p r o k u r ɑ t u r i
прокуратурӑна	p r o k u r ɑ t u r ʌ n ɑ
прокурора	p r o k u r o r ɑ
промтракторта	p r o m t r ɑ k t o r t ɑ
проспектӗнче	p r o s p e k t ɛ n tʃ e
пространствинче	p r o s t r ɑ n s t v i n tʃ e
професси	p r o f e sː i
профессийӗпе	p r o f e sː i j ɛ p e
профилактика	p r o f i l ɑ k t i k ɑ
процедури	p r o ts e d u r i
процедурисене	p r o ts e d u r i s e n e
процентпа	p r o ts e n t p ɑ
прусакова	p r u s ɑ k o v ɑ
психиатри	p s i χ i ɑ t r i
психика	p s i χ i k ɑ
психолог	p s i χ o l o g
психологсем	p s i χ o l o g s e m
псковавиа	p s k o v ɑ v i ɑ
пукане	p u k ɑ n e
пукани	p u k ɑ n i
пуканне	p u k ɑ nː e
пула	p u l ɑ
пулайман	p u l ɑ j m ɑ n
пулайманни	p u l ɑ j m ɑ nː i
пулаканнисем	p u l ɑ k ɑ nː i s e m
пулас	p u l ɑ s
пуласса	p u l ɑ sː ɑ
пуласси	p u l ɑ sː i
пулассине	p u l ɑ sː i n e
пулать	p u l ɑ t
пулатӑпах	p u l ɑ t ʌ p ɑ χ
пулах	p u l ɑ χ
пулаять	p u l ɑ j ɑ t
пулаҫҫӗ	p u l ɑ ɕː ɛ
пулеметпа	p u l e m e t p ɑ
пуленккине	p u l e n kː i n e
пулин	p u l i n
пуличчен	p u l i tʃ tʃ e n
пулма	p u l m ɑ
пулмалла	p u l m ɑ lː ɑ
пулмаллах	p u l m ɑ lː ɑ χ
пулман	p u l m ɑ n
пулман-мӗн	p u l m ɑ n m ɛ n
пулманни	p u l m ɑ nː i
пулмарӑм	p u l m ɑ r ʌ m
пулмарӗ	p u l m ɑ r ɛ
пулмарӗ-ха	p u l m ɑ r ɛ χ ɑ
пулмасан	p u l m ɑ s ɑ n
пулмасть	p u l m ɑ s t
пулмашкӑн	p u l m ɑ ʃ k ʌ n
пулмаҫ	p u l m ɑ ɕ
пулмӗ	p u l m ɛ
пулна-мӗн	p u l n ɑ m ɛ n
пулни	p u l n i
пулнине	p u l n i n e
пулнинче	p u l n i n tʃ e
пулнипе	p u l n i p e
пулнисемшӗн	p u l n i s e m ʃ ɛ n
пулнӑ	p u l n ʌ
пулнӑ-и	p u l n ʌ i
пулнӑ-мӗн	p u l n ʌ m ɛ n
пулнӑ-ши	p u l n ʌ ʃ i
пулнӑран	p u l n ʌ r ɑ n
пулнӑччӗ	p u l n ʌ tʃ tʃ ɛ
пулнӑшӑн	p u l n ʌ ʃ ʌ n
пулса	p u l s ɑ
пулсан	p u l s ɑ n
пулсанах	p u l s ɑ n ɑ χ
пултарайман	p u l t ɑ r ɑ j m ɑ n
пултарассине	p u l t ɑ r ɑ sː i n e
пултаратпӑр	p u l t ɑ r ɑ t p ʌ r
пултарать	p u l t ɑ r ɑ t
пултаратӑр	p u l t ɑ r ɑ t ʌ r
пултараҫҫӗ	p u l t ɑ r ɑ ɕː ɛ
пултарман	p u l t ɑ r m ɑ n
пултарнине	p u l t ɑ r n i n e
пултарнӑ	p u l t ɑ r n ʌ
пултарсан	p u l t ɑ r s ɑ n
пултаруллӑ	p u l t ɑ r u lː ʌ
пултаруллӑскерӗн	p u l t ɑ r u lː ʌ s k e r ɛ n
пултарулӑх	p u l t ɑ r u l ʌ χ
пултарулӑха	p u l t ɑ r u l ʌ χ ɑ
пултарулӑхне	p u l t ɑ r u l ʌ χ n e
пултарулӑхӗн	p u l t ɑ r u l ʌ χ ɛ n
пултарулӑхӗпе	p u l t ɑ r u l ʌ χ ɛ p e
пултарулӑхӗсем	p u l t ɑ r u l ʌ χ ɛ s e m
пултарчӗ	p u l t ɑ r tʃ ɛ
пултарӗ	p u l t ɑ r ɛ
пултарӗҫ	p u l t ɑ r ɛ ɕ
пултӑмӑр	p u l t ʌ m ʌ r
пултӑр	p u l t ʌ r
пулура	p u l u r ɑ
пулусем	p u l u s e m
пулччӑр	p u l tʃ tʃ ʌ r
пулчӗ	p u l tʃ ɛ
пулчӗҫ	p u l tʃ ɛ ɕ
пуль	p u l
пульницари	p u l n i ts ɑ r i
пульниципе	p u l n i ts i p e
пульницисем	p u l n i ts i s e m
пульницӑна	p u l n i ts ʌ n ɑ
пульницӑра	p u l n i ts ʌ r ɑ
пульницӑсене	p u l n i ts ʌ s e n e
пульӑсем	p u l ʌ s e m
пуля	p u l j ɑ
пулӑ	p u l ʌ
пулӑвӗсене	p u l ʌ v ɛ s e n e
пулӑмсене	p u l ʌ m s e n e
пулӑп-ши	p u l ʌ p ʃ i
пулӑсӑр	p u l ʌ s ʌ r
пулӑшакан	p u l ʌ ʃ ɑ k ɑ n
пулӑшакана	p u l ʌ ʃ ɑ k ɑ n ɑ
пулӑшакансем	p u l ʌ ʃ ɑ k ɑ n s e m
пулӑшар-и	p u l ʌ ʃ ɑ r i
пулӑшас	p u l ʌ ʃ ɑ s
пулӑшасса	p u l ʌ ʃ ɑ sː ɑ
пулӑшасси	p u l ʌ ʃ ɑ sː i
пулӑшатпӑр	p u l ʌ ʃ ɑ t p ʌ r
пулӑшать	p u l ʌ ʃ ɑ t
пулӑшать-мӗн	p u l ʌ ʃ ɑ t m ɛ n
пулӑшатӑр	p u l ʌ ʃ ɑ t ʌ r
пулӑшаҫҫӗ	p u l ʌ ʃ ɑ ɕː ɛ
пулӑшма	p u l ʌ ʃ m ɑ
пулӑшмалла	p u l ʌ ʃ m ɑ lː ɑ
пулӑшмалли	p u l ʌ ʃ m ɑ lː i
пулӑшмарӗ	p u l ʌ ʃ m ɑ r ɛ
пулӑшмастчӗҫ	p u l ʌ ʃ m ɑ s t tʃ ɛ ɕ
пулӑшмасть	p u l ʌ ʃ m ɑ s t
пулӑшмасӑр	p u l ʌ ʃ m ɑ s ʌ r
пулӑшнипе	p u l ʌ ʃ n i p e
пулӑшнӑ	p u l ʌ ʃ n ʌ
пулӑшрӗ	p u l ʌ ʃ r ɛ
пулӑшу	p u l ʌ ʃ u
пулӑшуҫӑсем	p u l ʌ ʃ u ɕ ʌ s e m
пулӑшӑвне	p u l ʌ ʃ ʌ v n e
пулӑшӑвӗ	p u l ʌ ʃ ʌ v ɛ
пулӑшӑвӗпе	p u l ʌ ʃ ʌ v ɛ p e
пулӑшӗ	p u l ʌ ʃ ɛ
пулӑшӗҫ	p u l ʌ ʃ ɛ ɕ
пулӗ	p u l ɛ
пулӗччӗ	p u l ɛ tʃ tʃ ɛ
пулӗҫ	p u l ɛ ɕ
пункт	p u n k t
пункта	p u n k t ɑ
пунктӗнче	p u n k t ɛ n tʃ e
пур	p u r
пур-и	p u r i
пур-мӗн	p u r m ɛ n
пур-шим	p u r ʃ i m
пуранӑть-ши	p u r ɑ n ʌ tʃ i
пурасем	p u r ɑ s e m
пуринчен	p u r i n tʃ e n
пурлӑх	p u r l ʌ χ
пурлӑхне	p u r l ʌ χ n e
пурлӑхпа	p u r l ʌ χ p ɑ
пурне	p u r n e
пурнӑмалли	p u r n ʌ m ɑ lː i
пурнӑҫ	p u r n ʌ ɕ
пурнӑҫа	p u r n ʌ ɕ ɑ
пурнӑҫлакан	p u r n ʌ ɕ l ɑ k ɑ n
пурнӑҫлама	p u r n ʌ ɕ l ɑ m ɑ
пурнӑҫламалла	p u r n ʌ ɕ l ɑ m ɑ lː ɑ
пурнӑҫламашкӑн	p u r n ʌ ɕ l ɑ m ɑ ʃ k ʌ n
пурнӑҫланать-и	p u r n ʌ ɕ l ɑ n ɑ t i
пурнӑҫланине	p u r n ʌ ɕ l ɑ n i n e
пурнӑҫланса	p u r n ʌ ɕ l ɑ n s ɑ
пурнӑҫланӑ	p u r n ʌ ɕ l ɑ n ʌ
пурнӑҫлас	p u r n ʌ ɕ l ɑ s
пурнӑҫлать	p u r n ʌ ɕ l ɑ t
пурнӑҫлаҫҫӗ	p u r n ʌ ɕ l ɑ ɕː ɛ
пурнӑҫне	p u r n ʌ ɕ n e
пурнӑҫпа	p u r n ʌ ɕ p ɑ
пурнӑҫра	p u r n ʌ ɕ r ɑ
пурнӑҫри	p u r n ʌ ɕ r i
пурнӑҫшӑн	p u r n ʌ ɕ ʃ ʌ n
пурнӑҫӗ	p u r n ʌ ɕ ɛ
пурнӑҫӗпе	p u r n ʌ ɕ ɛ p e
пурпӗр	p u r p ɛ r
пурпӗрех	p u r p ɛ r e χ
пурри	p u rː i
пуррине	p u rː i n e
пуррисене	p u rː i s e n e
пурришӗн	p u rː i ʃ ɛ n
пурте	p u r t e
пуртӑ-пӑчкӑ	p u r t ʌ p ʌ tʃ k ʌ
пурччӗ	p u r tʃ tʃ ɛ
пурҫӑн	p u r ɕ ʌ n
пурӑнаймасть	p u r ʌ n ɑ j m ɑ s t
пурӑнакан	p u r ʌ n ɑ k ɑ n
пурӑнакансем	p u r ʌ n ɑ k ɑ n s e m
пурӑнакансене	p u r ʌ n ɑ k ɑ n s e n e
пурӑнаканскерсем	p u r ʌ n ɑ k ɑ n s k e r s e m
пурӑнатпӑр	p u r ʌ n ɑ t p ʌ r
пурӑнаттӑмӑр	p u r ʌ n ɑ tː ʌ m ʌ r
пурӑнатчӗ	p u r ʌ n ɑ t tʃ ɛ
пурӑнать	p u r ʌ n ɑ t
пурӑнать-ши	p u r ʌ n ɑ tʃ i
пурӑнаҫҫӗ	p u r ʌ n ɑ ɕː ɛ
пурӑнма	p u r ʌ n m ɑ
пурӑнмалла	p u r ʌ n m ɑ lː ɑ
пурӑнмалла-ха	p u r ʌ n m ɑ lː ɑ χ ɑ
пурӑнмалли	p u r ʌ n m ɑ lː i
пурӑнмашкӑн	p u r ʌ n m ɑ ʃ k ʌ n
пурӑннӑ	p u r ʌ nː ʌ
пурӑннӑ-ши	p u r ʌ nː ʌ ʃ i
пурӑнчӗ	p u r ʌ n tʃ ɛ
пурӑнӑҫ	p u r ʌ n ʌ ɕ
пурӑнӑҫсем	p u r ʌ n ʌ ɕ s e m
пус	p u s
пусарма	p u s ɑ r m ɑ
пусатчӗ	p u s ɑ t tʃ ɛ
пускӑчсене	p u s k ʌ tʃ s e n e
пусма	p u s m ɑ
пусмалли	p u s m ɑ lː i
пусмасем	p u s m ɑ s e m
пусмӑрласа	p u s m ʌ r l ɑ s ɑ
пуснӑ	p u s n ʌ
пусса	p u sː ɑ
пустарса	p u s t ɑ r s ɑ
пусӑмне	p u s ʌ m n e
пусӑмӗ	p u s ʌ m ɛ
пусӑмӗн	p u s ʌ m ɛ n
пусӑрӑнчӗ	p u s ʌ r ʌ n tʃ ɛ
пута	p u t ɑ
путвалсене	p u t v ɑ l s e n e
путек-сурӑх	p u t e k s u r ʌ χ
путин	p u t i n
путрӗ	p u t r ɛ
пухаттӑм	p u χ ɑ tː ʌ m
пухать	p u χ ɑ t
пухаҫҫӗ	p u χ ɑ ɕː ɛ
пухмачӗ	p u χ m ɑ tʃ ɛ
пухнӑ	p u χ n ʌ
пухрӑм	p u χ r ʌ m
пухса	p u χ s ɑ
пуху	p u χ u
пухура	p u χ u r ɑ
пухӑвӗн	p u χ ʌ v ɛ n
пухӑнать	p u χ ʌ n ɑ t
пухӑнаҫҫӗ	p u χ ʌ n ɑ ɕː ɛ
пухӑннине	p u χ ʌ nː i n e
пухӑннисем	p u χ ʌ nː i s e m
пухӑннисене	p u χ ʌ nː i s e n e
пухӑннӑ	p u χ ʌ nː ʌ
пухӑннӑран	p u χ ʌ nː ʌ r ɑ n
пухӑннӑччӗ	p u χ ʌ nː ʌ tʃ tʃ ɛ
пухӑнӗҫ	p u χ ʌ n ɛ ɕ
пушанчӗ	p u ʃ ɑ n tʃ ɛ
пушар	p u ʃ ɑ r
пушарнӑйсем	p u ʃ ɑ r n ʌ j s e m
пушарта	p u ʃ ɑ r t ɑ
пушех	p u ʃ e χ
пушмак	p u ʃ m ɑ k
пушмакпа	p u ʃ m ɑ k p ɑ
пушмакӗ	p u ʃ m ɑ k ɛ
пуян	p u j ɑ n
пуянланнӑ	p u j ɑ n l ɑ nː ʌ
пуянлантӑр	p u j ɑ n l ɑ n t ʌ r
пуянлӑхпа	p u j ɑ n l ʌ χ p ɑ
пуянлӑхӗ	p u j ɑ n l ʌ χ ɛ
пуҫ	p u ɕ
пуҫа	p u ɕ ɑ
пуҫанӑшӗ	p u ɕ ɑ n ʌ ʃ ɛ
пуҫарасшӑн	p u ɕ ɑ r ɑ s ʃ ʌ n
пуҫаратӑп	p u ɕ ɑ r ɑ t ʌ p
пуҫарнипе	p u ɕ ɑ r n i p e
пуҫарнӑ	p u ɕ ɑ r n ʌ
пуҫартӑм	p u ɕ ɑ r t ʌ m
пуҫарчӗ	p u ɕ ɑ r tʃ ɛ
пуҫарӑвӗпе	p u ɕ ɑ r ʌ v ɛ p e
пуҫиле	p u ɕ i l e
пуҫлама	p u ɕ l ɑ m ɑ
пуҫламан	p u ɕ l ɑ m ɑ n
пуҫланать	p u ɕ l ɑ n ɑ t
пуҫлани	p u ɕ l ɑ n i
пуҫланнӑ	p u ɕ l ɑ nː ʌ
пуҫланнӑранпа	p u ɕ l ɑ nː ʌ r ɑ n p ɑ
пуҫлансан	p u ɕ l ɑ n s ɑ n
пуҫланӑ	p u ɕ l ɑ n ʌ
пуҫланӑ-ха	p u ɕ l ɑ n ʌ χ ɑ
пуҫларӑм	p u ɕ l ɑ r ʌ m
пуҫларӗ	p u ɕ l ɑ r ɛ
пуҫларӗҫ	p u ɕ l ɑ r ɛ ɕ
пуҫласа	p u ɕ l ɑ s ɑ
пуҫласанах	p u ɕ l ɑ s ɑ n ɑ χ
пуҫласси	p u ɕ l ɑ sː i
пуҫлассине	p u ɕ l ɑ sː i n e
пуҫлать	p u ɕ l ɑ t
пуҫлатӑп	p u ɕ l ɑ t ʌ p
пуҫлӑха	p u ɕ l ʌ χ ɑ
пуҫлӑхӑн	p u ɕ l ʌ χ ʌ n
пуҫлӑхӗ	p u ɕ l ʌ χ ɛ
пуҫлӑхӗсене	p u ɕ l ʌ χ ɛ s e n e
пуҫлӗ	p u ɕ l ɛ
пуҫлӗҫ	p u ɕ l ɛ ɕ
пуҫне	p u ɕ n e
пуҫтарас	p u ɕ t ɑ r ɑ s
пуҫтараҫҫӗ	p u ɕ t ɑ r ɑ ɕː ɛ
пуҫтарма	p u ɕ t ɑ r m ɑ
пуҫтарнӑ	p u ɕ t ɑ r n ʌ
пуҫтарса	p u ɕ t ɑ r s ɑ
пуҫтарсси	p u ɕ t ɑ r sː i
пуҫтартӑмӑр	p u ɕ t ɑ r t ʌ m ʌ r
пуҫтарӑниччен	p u ɕ t ɑ r ʌ n i tʃ tʃ e n
пуҫтарӑнмасть	p u ɕ t ɑ r ʌ n m ɑ s t
пуҫтарӑннисен	p u ɕ t ɑ r ʌ nː i s e n
пуҫтарӑннӑ	p u ɕ t ɑ r ʌ nː ʌ
пуҫӑнсанах	p u ɕ ʌ n s ɑ n ɑ χ
пуҫӑруллӑскерсене	p u ɕ ʌ r u lː ʌ s k e r s e n e
пуҫӗ	p u ɕ ɛ
пуҫӗнчен	p u ɕ ɛ n tʃ e n
пыйтусене	p ɯ j t u s e n e
пылак	p ɯ l ɑ k
пылчӑк	p ɯ l tʃ ʌ k
пыма	p ɯ m ɑ
пымарӗ	p ɯ m ɑ r ɛ
пынине	p ɯ n i n e
пынӑ	p ɯ n ʌ
пыракан	p ɯ r ɑ k ɑ n
пыракансене	p ɯ r ɑ k ɑ n s e n e
пырать	p ɯ r ɑ t
пыраҫҫӗ	p ɯ r ɑ ɕː ɛ
пырне	p ɯ r n e
пырса	p ɯ r s ɑ
пыршӑлӑхри	p ɯ r ʃ ʌ l ʌ χ r i
пырӑр	p ɯ r ʌ r
пырӗ	p ɯ r ɛ
пырӗҫ	p ɯ r ɛ ɕ
пысӑк	p ɯ s ʌ k
пысӑкки	p ɯ s ʌ kː i
пысӑклатасшӑн	p ɯ s ʌ k l ɑ t ɑ s ʃ ʌ n
пысӑклатма	p ɯ s ʌ k l ɑ t m ɑ
пысӑкраххине	p ɯ s ʌ k r ɑ χː i n e
пысӑкӑш	p ɯ s ʌ k ʌ ʃ
пытанатчӗ	p ɯ t ɑ n ɑ t tʃ ɛ
пытарайман	p ɯ t ɑ r ɑ j m ɑ n
пытармастӑп	p ɯ t ɑ r m ɑ s t ʌ p
пытарса	p ɯ t ɑ r s ɑ
пытӑмӑр	p ɯ t ʌ m ʌ r
пычӗ	p ɯ tʃ ɛ
пьедестал	p e d e s t ɑ l
пьедесталӑн	p e d e s t ɑ l ʌ n
пӑкӑ	p ʌ k ʌ
пӑлханса	p ʌ l χ ɑ n s ɑ
пӑлхар-чӑваш	p ʌ l χ ɑ r tʃ ʌ v ɑ ʃ
пӑлхарсем	p ʌ l χ ɑ r s e m
пӑлхарстан	p ʌ l χ ɑ r s t ɑ n
пӑлхарстана	p ʌ l χ ɑ r s t ɑ n ɑ
пӑлхарстанӑн	p ʌ l χ ɑ r s t ɑ n ʌ n
пӑрахни	p ʌ r ɑ χ n i
пӑрахнӑ	p ʌ r ɑ χ n ʌ
пӑрахса	p ʌ r ɑ χ s ɑ
пӑрахӑҫлама	p ʌ r ɑ χ ʌ ɕ l ɑ m ɑ
пӑрахӑҫланӑ	p ʌ r ɑ χ ʌ ɕ l ɑ n ʌ
пӑрахӑҫласа	p ʌ r ɑ χ ʌ ɕ l ɑ s ɑ
пӑрлӑ	p ʌ r l ʌ
пӑрнӑ	p ʌ r n ʌ
пӑрпа	p ʌ r p ɑ
пӑру	p ʌ r u
пӑрҫа	p ʌ r ɕ ɑ
пӑрҫасемпе	p ʌ r ɕ ɑ s e m p e
пӑрӑнман	p ʌ r ʌ n m ɑ n
пӑрӑнса	p ʌ r ʌ n s ɑ
пӑрӑнтӑм	p ʌ r ʌ n t ʌ m
пӑрӑх	p ʌ r ʌ χ
пӑрӑхсене	p ʌ r ʌ χ s e n e
пӑрӑхӗ	p ʌ r ʌ χ ɛ
пӑсакансем	p ʌ s ɑ k ɑ n s e m
пӑсать	p ʌ s ɑ t
пӑсланчӗ	p ʌ s l ɑ n tʃ ɛ
пӑснӑ	p ʌ s n ʌ
пӑсса	p ʌ sː ɑ
пӑссан	p ʌ sː ɑ n
пӑсӑлать	p ʌ s ʌ l ɑ t
пӑсӑлатӑп	p ʌ s ʌ l ɑ t ʌ p
пӑтранасси	p ʌ t r ɑ n ɑ sː i
пӑтӑпа	p ʌ t ʌ p ɑ
пӑтӑрмах	p ʌ t ʌ r m ɑ χ
пӑх	p ʌ χ
пӑха-пӑха	p ʌ χ ɑ p ʌ χ ɑ
пӑхакан	p ʌ χ ɑ k ɑ n
пӑхассишӗнех	p ʌ χ ɑ sː i ʃ ɛ n e χ
пӑхаҫҫӗ	p ʌ χ ɑ ɕː ɛ
пӑхма	p ʌ χ m ɑ
пӑхмалла	p ʌ χ m ɑ lː ɑ
пӑхман	p ʌ χ m ɑ n
пӑхмарӗ	p ʌ χ m ɑ r ɛ
пӑхмасӑр	p ʌ χ m ɑ s ʌ r
пӑхнӑ	p ʌ χ n ʌ
пӑхрӗ	p ʌ χ r ɛ
пӑхса	p ʌ χ s ɑ
пӑхӑнма	p ʌ χ ʌ n m ɑ
пӑхӑнманнине	p ʌ χ ʌ n m ɑ nː i n e
пӑхӑнни	p ʌ χ ʌ nː i
пӑхӑннипе	p ʌ χ ʌ nː i p e
пӑхӑнса	p ʌ χ ʌ n s ɑ
пӑхӑнсах	p ʌ χ ʌ n s ɑ χ
пӑхӑр	p ʌ χ ʌ r
пӑшал	p ʌ ʃ ɑ l
пӑшалтан	p ʌ ʃ ɑ l t ɑ n
пӑшалӗнчен	p ʌ ʃ ɑ l ɛ n tʃ e n
пӑшарханса	p ʌ ʃ ɑ r χ ɑ n s ɑ
пӑшлатать	p ʌ ʃ l ɑ t ɑ t
пӑшӑрханаттӑмӑр	p ʌ ʃ ʌ r χ ɑ n ɑ tː ʌ m ʌ r
пӑшӑрханать	p ʌ ʃ ʌ r χ ɑ n ɑ t
пӑшӑрханма	p ʌ ʃ ʌ r χ ɑ n m ɑ
пӑшӑрхантарать	p ʌ ʃ ʌ r χ ɑ n t ɑ r ɑ t
пӑшӑрханӑва	p ʌ ʃ ʌ r χ ɑ n ʌ v ɑ
пӗве	p ɛ v e
пӗвере	p ɛ v e r e
пӗлеймерӗмӗр	p ɛ l e j m e r ɛ m ɛ r
пӗлекенсем	p ɛ l e k e n s e m
пӗлес	p ɛ l e s
пӗлет	p ɛ l e t
пӗлетпӗр	p ɛ l e t p ɛ r
пӗлетӗп	p ɛ l e t ɛ p
пӗлеҫҫӗ	p ɛ l e ɕː ɛ
пӗлме	p ɛ l m e
пӗлмелле	p ɛ l m e lː e
пӗлмен	p ɛ l m e n
пӗлменрен	p ɛ l m e n r e n
пӗлменскерсене	p ɛ l m e n s k e r s e n e
пӗлмест	p ɛ l m e s t
пӗлместӗм	p ɛ l m e s t ɛ m
пӗлместӗп	p ɛ l m e s t ɛ p
пӗлместӗр	p ɛ l m e s t ɛ r
пӗлмесӗрех	p ɛ l m e s ɛ r e χ
пӗлмеҫҫӗ	p ɛ l m e ɕː ɛ
пӗлни	p ɛ l n i
пӗлнӗ	p ɛ l n ɛ
пӗлсен	p ɛ l s e n
пӗлсех	p ɛ l s e χ
пӗлтерейместпӗр	p ɛ l t e r e j m e s t p ɛ r
пӗлтереймӗп	p ɛ l t e r e j m ɛ p
пӗлтерет	p ɛ l t e r e t
пӗлтереттӗм	p ɛ l t e r e tː ɛ m
пӗлтеретӗп	p ɛ l t e r e t ɛ p
пӗлтереҫҫӗ	p ɛ l t e r e ɕː ɛ
пӗлтерме	p ɛ l t e r m e
пӗлтермелле	p ɛ l t e r m e lː e
пӗлтермен	p ɛ l t e r m e n
пӗлтермессе	p ɛ l t e r m e sː e
пӗлтернине	p ɛ l t e r n i n e
пӗлтернӗ	p ɛ l t e r n ɛ
пӗлтернӗччӗ	p ɛ l t e r n ɛ tʃ tʃ ɛ
пӗлтерсе	p ɛ l t e r s e
пӗлтертӗмӗр	p ɛ l t e r t ɛ m ɛ r
пӗлтерчӗ	p ɛ l t e r tʃ ɛ
пӗлтерӗшли	p ɛ l t e r ɛ ʃ l i
пӗлтерӗшлине	p ɛ l t e r ɛ ʃ l i n e
пӗлтерӗшлӗ	p ɛ l t e r ɛ ʃ l ɛ
пӗлтерӗшне	p ɛ l t e r ɛ ʃ n e
пӗлтерӳ	p ɛ l t e r y
пӗлтӗр	p ɛ l t ɛ r
пӗлтӗрхи	p ɛ l t ɛ r χ i
пӗлӗвне	p ɛ l ɛ v n e
пӗлӗт	p ɛ l ɛ t
пӗлӗте	p ɛ l ɛ t e
пӗлӗчӗсем	p ɛ l ɛ tʃ ɛ s e m
пӗлӗшсем	p ɛ l ɛ ʃ s e m
пӗлӗшӗ	p ɛ l ɛ ʃ ɛ
пӗлӗшӗсенчен	p ɛ l ɛ ʃ ɛ s e n tʃ e n
пӗлӗҫ	p ɛ l ɛ ɕ
пӗлӳ	p ɛ l y
пӗр	p ɛ r
пӗр-икӗ	p ɛ r i k ɛ
пӗр-пӗр	p ɛ r p ɛ r
пӗр-пӗрин	p ɛ r p ɛ r i n
пӗр-пӗринчен	p ɛ r p ɛ r i n tʃ e n
пӗр-пӗрне	p ɛ r p ɛ r n e
пӗрене	p ɛ r e n e
пӗрех	p ɛ r e χ
пӗрешкелех	p ɛ r e ʃ k e l e χ
пӗри	p ɛ r i
пӗрин	p ɛ r i n
пӗрисем	p ɛ r i s e m
пӗрле	p ɛ r l e
пӗрлех	p ɛ r l e χ
пӗрлехи	p ɛ r l e χ i
пӗрлешнине	p ɛ r l e ʃ n i n e
пӗрлешнӗ	p ɛ r l e ʃ n ɛ
пӗрлештерекен	p ɛ r l e ʃ t e r e k e n
пӗрлештерет	p ɛ r l e ʃ t e r e t
пӗрлештерме	p ɛ r l e ʃ t e r m e
пӗрлештернӗ	p ɛ r l e ʃ t e r n ɛ
пӗрлешӗвӗн	p ɛ r l e ʃ ɛ v ɛ n
пӗрлешӗҫ	p ɛ r l e ʃ ɛ ɕ
пӗрлӗхе	p ɛ r l ɛ χ e
пӗрлӗхне	p ɛ r l ɛ χ n e
пӗрлӗхсем	p ɛ r l ɛ χ s e m
пӗрлӗхӗ	p ɛ r l ɛ χ ɛ
пӗрлӗхӗн	p ɛ r l ɛ χ ɛ n
пӗрмаях	p ɛ r m ɑ j ɑ χ
пӗрне	p ɛ r n e
пӗрре	p ɛ rː e
пӗрремӗш	p ɛ rː e m ɛ ʃ
пӗрремӗшӗ	p ɛ rː e m ɛ ʃ ɛ
пӗрремӗшӗнчен	p ɛ rː e m ɛ ʃ ɛ n tʃ e n
пӗррехинче	p ɛ rː e χ i n tʃ e
пӗртен-пӗр	p ɛ r t e n p ɛ r
пӗртте	p ɛ r tː e
пӗрчи	p ɛ r tʃ i
пӗрӗхе	p ɛ r ɛ χ e
пӗтерме	p ɛ t e r m e
пӗтернӗ	p ɛ t e r n ɛ
пӗтертӗмӗр	p ɛ t e r t ɛ m ɛ r
пӗтет	p ɛ t e t
пӗтмест	p ɛ t m e s t
пӗтнишӗн	p ɛ t n i ʃ ɛ n
пӗтнӗ	p ɛ t n ɛ
пӗтнӗрен	p ɛ t n ɛ r e n
пӗтрӗҫ	p ɛ t r ɛ ɕ
пӗтӗм	p ɛ t ɛ m
пӗтӗмлетеҫҫӗ	p ɛ t ɛ m l e t e ɕː ɛ
пӗтӗмлетме	p ɛ t ɛ m l e t m e
пӗтӗмлетнӗ	p ɛ t ɛ m l e t n ɛ
пӗтӗмлетсе	p ɛ t ɛ m l e ts e
пӗтӗмлетӗвӗ	p ɛ t ɛ m l e t ɛ v ɛ
пӗтӗмлетӗвӗпе	p ɛ t ɛ m l e t ɛ v ɛ p e
пӗтӗмлетӳ	p ɛ t ɛ m l e t y
пӗтӗмпе	p ɛ t ɛ m p e
пӗтӗмпех	p ɛ t ɛ m p e χ
пӗтӗмӗшле	p ɛ t ɛ m ɛ ʃ l e
пӗтӗмӗшпе	p ɛ t ɛ m ɛ ʃ p e
пӗччен	p ɛ tʃ tʃ e n
пӗчченех	p ɛ tʃ tʃ e n e χ
пӗчӗк	p ɛ tʃ ɛ k
пӗчӗккисене	p ɛ tʃ ɛ kː i s e n e
пӗчӗккӗ	p ɛ tʃ ɛ kː ɛ
пӗчӗккӗлех	p ɛ tʃ ɛ kː ɛ l e χ
пӗчӗккӗн	p ɛ tʃ ɛ kː ɛ n
пӗчӗкленет	p ɛ tʃ ɛ k l e n e t
пӗчӗкленнӗ	p ɛ tʃ ɛ k l e nː ɛ
пӗчӗклетес	p ɛ tʃ ɛ k l e t e s
пӗчӗклетме	p ɛ tʃ ɛ k l e t m e
пӗчӗкренех	p ɛ tʃ ɛ k r e n e χ
пӗчӗкрех	p ɛ tʃ ɛ k r e χ
пӗчӗкскер	p ɛ tʃ ɛ k s k e r
пӗчӗкскере	p ɛ tʃ ɛ k s k e r e
пӗчӗкскерсен	p ɛ tʃ ɛ k s k e r s e n
пӗчӗкскерсене	p ɛ tʃ ɛ k s k e r s e n e
пӗҫереҫҫӗ	p ɛ ɕ e r e ɕː ɛ
пӗҫерчӗҫ	p ɛ ɕ e r tʃ ɛ ɕ
пӗҫерӗҫ	p ɛ ɕ e r ɛ ɕ
пӳлӗм	p y l ɛ m
пӳлӗме	p y l ɛ m e
пӳлӗмлӗ	p y l ɛ m l ɛ
пӳлӗмре	p y l ɛ m r e
пӳлӗмсем	p y l ɛ m s e m
пӳлӗмӗнче	p y l ɛ m ɛ n tʃ e
пӳрленсе	p y r l e n s e
пӳрмен	p y r m e n
пӳрт	p y r t
пӳрте	p y r t e
пӳртне	p y r t n e
пӳртре	p y r t r e
пӳртрен	p y r t r e n
райдер	r ɑ j d e r
райдерсем	r ɑ j d e r s e m
район	r ɑ j o n
районне	r ɑ j o nː e
районсенче	r ɑ j o n s e n tʃ e
районсенчи	r ɑ j o n s e n tʃ i
районта	r ɑ j o n t ɑ
районтах	r ɑ j o n t ɑ χ
районти	r ɑ j o n t i
районӗн	r ɑ j o n ɛ n
районӗнче	r ɑ j o n ɛ n tʃ e
районӗнчи	r ɑ j o n ɛ n tʃ i
ракета	r ɑ k e t ɑ
ракурс	r ɑ k u r s
ракурсӗ	r ɑ k u r s ɛ
расписание	r ɑ s p i s ɑ n i e
раштав	r ɑ ʃ t ɑ v
раэряд	r ɑ e r j ɑ d
раҫҫее	r ɑ ɕː e e
раҫҫей	r ɑ ɕː e j
раҫҫейре	r ɑ ɕː e j r e
раҫҫейри	r ɑ ɕː e j r i
раҫҫейӗн	r ɑ ɕː e j ɛ n
реабилитаци	r e ɑ b i l i t ɑ ts i
реанимацире	r e ɑ n i m ɑ ts i r e
региона	r e g i o n ɑ
регионсем	r e g i o n s e m
регионсене	r e g i o n s e n e
регионсенче	r e g i o n s e n tʃ e
регионсенчен	r e g i o n s e n tʃ e n
регионӗсенчен	r e g i o n ɛ s e n tʃ e n
регистратурӑра	r e g i s t r ɑ t u r ʌ r ɑ
регистрациленнӗ	r e g i s t r ɑ ts i l e nː ɛ
редакторӗ	r e d ɑ k t o r ɛ
редакцийӗ	r e d ɑ k ts i j ɛ
режима	r e ʒ i m ɑ
режимлӑ	r e ʒ i m l ʌ
режиссер	r e ʒ i sː e r
режиссерсем	r e ʒ i sː e r s e m
режиссерӗ	r e ʒ i sː e r ɛ
режиссерӗсем	r e ʒ i sː e r ɛ s e m
рейд	r e j d
рейда	r e j d ɑ
рейса	r e j s ɑ
рейссем	r e j sː e m
рейссене	r e j sː e n e
рейтинг	r e j t i n g
реконструкцилес	r e k o n s t r u k ts i l e s
рекорд	r e k o r d
рентген	r e n t g e n
репертуарӗнчен	r e p e r t u ɑ r ɛ n tʃ e n
репетици	r e p e t i ts i
репортаж	r e p o r t ɑ ʒ
республика	r e s p u b l i k ɑ
республикари	r e s p u b l i k ɑ r i
республикинче	r e s p u b l i k i n tʃ e
республикипех	r e s p u b l i k i p e χ
республикисем	r e s p u b l i k i s e m
республикӑн	r e s p u b l i k ʌ n
республикӑра	r e s p u b l i k ʌ r ɑ
республикӑран	r e s p u b l i k ʌ r ɑ n
республикӑри	r e s p u b l i k ʌ r i
республикӑсен	r e s p u b l i k ʌ s e n
ресторан	r e s t o r ɑ n
ресурсӗсен	r e s u r s ɛ s e n
рецепчӗпе	r e ts e p tʃ ɛ p e
реэервӗсен	r e e e r v ɛ s e n
римма	r i mː ɑ
роман	r o m ɑ n
романа	r o m ɑ n ɑ
романтика	r o m ɑ n t i k ɑ
романӗ	r o m ɑ n ɛ
росгвардин	r o s g v ɑ r d i n
роспотребнадэор	r o s p o t r e b n ɑ d e o r
россельхоэнадэор	r o sː e l χ o e n ɑ d e o r
ростех	r o s t e χ
ртутьлӗ	r t u t l ɛ
руль	r u l
сабантуйӗ	s ɑ b ɑ n t u j ɛ
савни	s ɑ v n i
савнийӗ	s ɑ v n i j ɛ
савнине	s ɑ v n i n e
савнисем	s ɑ v n i s e m
савнӑ	s ɑ v n ʌ
савут	s ɑ v u t
савутне	s ɑ v u t n e
савутра	s ɑ v u t r ɑ
савутӗнче	s ɑ v u t ɛ n tʃ e
савучӗ	s ɑ v u tʃ ɛ
савучӗн	s ɑ v u tʃ ɛ n
савучӗсем	s ɑ v u tʃ ɛ s e m
савӑнать	s ɑ v ʌ n ɑ t
савӑнаять-и	s ɑ v ʌ n ɑ j ɑ t i
савӑнман	s ɑ v ʌ n m ɑ n
савӑннине	s ɑ v ʌ nː i n e
савӑннӑ	s ɑ v ʌ nː ʌ
савӑннӑскерсем	s ɑ v ʌ nː ʌ s k e r s e m
савӑнса	s ɑ v ʌ n s ɑ
савӑнтарать	s ɑ v ʌ n t ɑ r ɑ t
савӑнтарнӑ	s ɑ v ʌ n t ɑ r n ʌ
савӑнтарчӗ	s ɑ v ʌ n t ɑ r tʃ ɛ
савӑнтӑм	s ɑ v ʌ n t ʌ m
савӑнтӑр	s ɑ v ʌ n t ʌ r
савӑнчӗ	s ɑ v ʌ n tʃ ɛ
савӑнӑн	s ɑ v ʌ n ʌ n
савӑнӑҫ	s ɑ v ʌ n ʌ ɕ
савӑнӑҫа	s ɑ v ʌ n ʌ ɕ ɑ
савӑнӑҫлӑ	s ɑ v ʌ n ʌ ɕ l ʌ
савӑнӑҫпа	s ɑ v ʌ n ʌ ɕ p ɑ
савӑт	s ɑ v ʌ t
савӑт-сапана	s ɑ v ʌ ts ɑ p ɑ n ɑ
савӑта	s ɑ v ʌ t ɑ
сад	s ɑ d
садик	s ɑ d i k
садӗнче	s ɑ d ɛ n tʃ e
сайра	s ɑ j r ɑ
сайра-хутра	s ɑ j r ɑ χ u t r ɑ
сайта	s ɑ j t ɑ
сайтра	s ɑ j t r ɑ
сайтсене	s ɑ j ts e n e
сайтӗнче	s ɑ j t ɛ n tʃ e
сайчӗ	s ɑ j tʃ ɛ
сак	s ɑ k
саккас	s ɑ kː ɑ s
сакки	s ɑ kː i
саккун	s ɑ kː u n
саккуна	s ɑ kː u n ɑ
саккӑр	s ɑ kː ʌ r
саксем	s ɑ k s e m
саламлама	s ɑ l ɑ m l ɑ m ɑ
саламламашкӑн	s ɑ l ɑ m l ɑ m ɑ ʃ k ʌ n
саламланӑ	s ɑ l ɑ m l ɑ n ʌ
саланать	s ɑ l ɑ n ɑ t
саланнӑч	s ɑ l ɑ nː ʌ tʃ
салари	s ɑ l ɑ r i
салатаҫҫӗ	s ɑ l ɑ t ɑ ɕː ɛ
салонне	s ɑ l o nː e
салонра	s ɑ l o n r ɑ
салтак	s ɑ l t ɑ k
салтака	s ɑ l t ɑ k ɑ
салтаксемпе	s ɑ l t ɑ k s e m p e
салхуланчӗ	s ɑ l χ u l ɑ n tʃ ɛ
салхуллӑ	s ɑ l χ u lː ʌ
самай	s ɑ m ɑ j
самай-ха	s ɑ m ɑ j χ ɑ
самайланнӑ	s ɑ m ɑ j l ɑ nː ʌ
саманинчех	s ɑ m ɑ n i n tʃ e χ
самант	s ɑ m ɑ n t
самантра	s ɑ m ɑ n t r ɑ
самантранах	s ɑ m ɑ n t r ɑ n ɑ χ
самантрах	s ɑ m ɑ n t r ɑ χ
самантсем	s ɑ m ɑ n ts e m
самантсенче	s ɑ m ɑ n ts e n tʃ e
саманчӗсене	s ɑ m ɑ n tʃ ɛ s e n e
самар	s ɑ m ɑ r
самаях	s ɑ m ɑ j ɑ χ
самбопа	s ɑ m b o p ɑ
самолет	s ɑ m o l e t
самолетсем	s ɑ m o l e ts e m
самӑр	s ɑ m ʌ r
сана	s ɑ n ɑ
санаторире	s ɑ n ɑ t o r i r e
санитари	s ɑ n i t ɑ r i
санпа	s ɑ n p ɑ
санӑн	s ɑ n ʌ n
сап-сарӑ	s ɑ p s ɑ r ʌ
сапаланӑ	s ɑ p ɑ l ɑ n ʌ
саперсем	s ɑ p e r s e m
саплаштарас	s ɑ p l ɑ ʃ t ɑ r ɑ s
саплаштарма	s ɑ p l ɑ ʃ t ɑ r m ɑ
саплаштарнӑ	s ɑ p l ɑ ʃ t ɑ r n ʌ
саппас	s ɑ pː ɑ s
саппун	s ɑ pː u n
сапрӗҫ	s ɑ p r ɛ ɕ
сарай	s ɑ r ɑ j
сарайӑн	s ɑ r ɑ j ʌ n
сарайӗнчи	s ɑ r ɑ j ɛ n tʃ i
сарлака	s ɑ r l ɑ k ɑ
сарлакӑш	s ɑ r l ɑ k ʌ ʃ
сарма	s ɑ r m ɑ
сарни	s ɑ r n i
сарнӑ	s ɑ r n ʌ
саррипе	s ɑ rː i p e
сарчӗ	s ɑ r tʃ ɛ
сарӑ	s ɑ r ʌ
сарӑлать	s ɑ r ʌ l ɑ t
сарӑлнӑ	s ɑ r ʌ l n ʌ
сарӑлса	s ɑ r ʌ l s ɑ
сарӑлтӑр	s ɑ r ʌ l t ʌ r
сарӑм	s ɑ r ʌ m
сарӑмсӑр	s ɑ r ʌ m s ʌ r
сарӑмӑн	s ɑ r ʌ m ʌ n
сарӑту	s ɑ r ʌ t u
сас-хура	s ɑ s χ u r ɑ
саспаллийӗсемпе	s ɑ s p ɑ lː i j ɛ s e m p e
саспаллисем	s ɑ s p ɑ lː i s e m
саспаллисен	s ɑ s p ɑ lː i s e n
сасси	s ɑ sː i
сассине	s ɑ sː i n e
сассӑр	s ɑ sː ʌ r
сасӑ	s ɑ s ʌ
сасӑлав	s ɑ s ʌ l ɑ v
сасӑлавра	s ɑ s ʌ l ɑ v r ɑ
сасӑлама	s ɑ s ʌ l ɑ m ɑ
сахал	s ɑ χ ɑ l
сахалланӑ	s ɑ χ ɑ lː ɑ n ʌ
сахаллатса	s ɑ χ ɑ lː ɑ ts ɑ
сахалрах	s ɑ χ ɑ l r ɑ χ
сахӑр	s ɑ χ ʌ r
сачӗ	s ɑ tʃ ɛ
сборка	s b o r k ɑ
света	s v e t ɑ
светлана	s v e t l ɑ n ɑ
светофор	s v e t o f o r
светӑн	s v e t ʌ n
светӑна	s v e t ʌ n ɑ
светӑпа	s v e t ʌ p ɑ
севастополь	s e v ɑ s t o p o l
севастопольте	s e v ɑ s t o p o l t e
семенова	s e m e n o v ɑ
сентре	s e n t r e
сентри	s e n t r i
сергее	s e r g e e
сергей	s e r g e j
сергейӑн	s e r g e j ʌ n
сергея	s e r g e j ɑ
сережа	s e r e ʒ ɑ
серепине	s e r e p i n e
сессие	s e sː i e
сессире	s e sː i r e
сетнер	s e t n e r
сехет	s e χ e t
сехетлӗхе	s e χ e t l ɛ χ e
сехетре	s e χ e t r e
сехетренех	s e χ e t r e n e χ
сехре	s e χ r e
сехӗрлентермен	s e χ ɛ r l e n t e r m e n
сеэонӗ	s e e o n ɛ
сиввӗн	s i vː ɛ n
сивлерӗҫ	s i v l e r ɛ ɕ
сивлетӗп	s i v l e t ɛ p
сивӗ	s i v ɛ
сивӗре	s i v ɛ r e
сивӗтет	s i v ɛ t e t
сивӗтмелли	s i v ɛ t m e lː i
сиенленнӗ	s i e n l e nː ɛ
сиенлӗ	s i e n l ɛ
сиенсӗрлетес	s i e n s ɛ r l e t e s
сийлӗ	s i j l ɛ
сикет	s i k e t
сикеттӗм	s i k e tː ɛ m
сиккелерӗмӗр	s i kː e l e r ɛ m ɛ r
сиккелесе	s i kː e l e s e
сиккелет	s i kː e l e t
сикме	s i k m e
сикнӗ	s i k n ɛ
сикрӗ	s i k r ɛ
сиксе	s i k s e
сиктермест	s i k t e r m e s t
силдаруран	s i l d ɑ r u r ɑ n
силиконпа	s i l i k o n p ɑ
силпи	s i l p i
симфони	s i m f o n i
симӗс	s i m ɛ s
синоптиксем	s i n o p t i k s e m
сиплев	s i p l e v
сиплеме	s i p l e m e
сипленет	s i p l e n e t
сипленме	s i p l e n m e
сипленни	s i p l e nː i
сипленнӗ	s i p l e nː ɛ
сипленсе	s i p l e n s e
сипленӗ	s i p l e n ɛ
сиплет	s i p l e t
сире	s i r e
сирире	s i r i r e
сирмелле	s i r m e lː e
сирпӗнмесӗр	s i r p ɛ n m e s ɛ r
сирпӗннӗ-мӗн	s i r p ɛ nː ɛ m ɛ n
сирпӗтме	s i r p ɛ t m e
сирӗлнӗ	s i r ɛ l n ɛ
сирӗн	s i r ɛ n
сисмен	s i s m e n
сисмесӗр	s i s m e s ɛ r
сисмесӗрех	s i s m e s ɛ r e χ
сиснӗ	s i s n ɛ
сисрӗ	s i s r ɛ
сиссе	s i sː e
системинчен	s i s t e m i n tʃ e n
систерме	s i s t e r m e
сисчӗвлентернӗ	s i s tʃ ɛ v l e n t e r n ɛ
сисӗмлӗ	s i s ɛ m l ɛ
сисӗнмерӗ	s i s ɛ n m e r ɛ
сисӗннӗ	s i s ɛ nː ɛ
сити-менеджер	s i t i m e n e d ʒ e r
скейт	s k e j t
склада	s k l ɑ d ɑ
следовательсем	s l e d o v ɑ t e l s e m
следстви	s l e d s t v i
слет	s l e t
слоупстайл	s l o u p s t ɑ j l
служба	s l u ʒ b ɑ
служби	s l u ʒ b i
службине	s l u ʒ b i n e
службӑра	s l u ʒ b ʌ r ɑ
службӑсем	s l u ʒ b ʌ s e m
службӑсене	s l u ʒ b ʌ s e n e
снайпер	s n ɑ j p e r
снайпер-раэведчик	s n ɑ j p e rː ɑ e v e d tʃ i k
снаряд	s n ɑ r j ɑ d
социаллӑ	s o ts i ɑ lː ʌ
социаллӑ-экономика	s o ts i ɑ lː ʌ e k o n o m i k ɑ
соцсетьсенчи	s o ts s e ts e n tʃ i
сочи	s o tʃ i
сочие	s o tʃ i e
соэыври	s o e ɯ v r i
союэӗ	s o j u e ɛ
спектакльсене	s p e k t ɑ k l s e n e
специалистсем	s p e ts i ɑ l i s ts e m
специалистсемпе	s p e ts i ɑ l i s ts e m p e
специалисчӗ	s p e ts i ɑ l i s tʃ ɛ
специалисчӗсем	s p e ts i ɑ l i s tʃ ɛ s e m
специальноҫне	s p e ts i ɑ l n o ɕ n e
спиридонов	s p i r i d o n o v
спиртлӑ	s p i r t l ʌ
спорт	s p o r t
спорта	s p o r t ɑ
спортпа	s p o r t p ɑ
спортра	s p o r t r ɑ
спортри	s p o r t r i
спортсмен	s p o r ts m e n
спортсмена	s p o r ts m e n ɑ
спортсменки	s p o r ts m e n k i
спортсменсем	s p o r ts m e n s e m
спортсменӗсем	s p o r ts m e n ɛ s e m
спортэал	s p o r t e ɑ l
спортӑн	s p o r t ʌ n
спорчӗн	s p o r tʃ ɛ n
станокпа	s t ɑ n o k p ɑ
станци	s t ɑ n ts i
станцире	s t ɑ n ts i r e
станъял	s t ɑ n j ɑ l
старостине	s t ɑ r o s t i n e
старт	s t ɑ r t
старта	s t ɑ r t ɑ
статусне	s t ɑ t u s n e
статуэтка	s t ɑ t u e t k ɑ
статьяпа	s t ɑ t j ɑ p ɑ
стационара	s t ɑ ts i o n ɑ r ɑ
степановна	s t e p ɑ n o v n ɑ
степановнӑн	s t e p ɑ n o v n ʌ n
степановсем	s t e p ɑ n o v s e m
степановсен	s t e p ɑ n o v s e n
стилист	s t i l i s t
стильне	s t i l n e
столовӑя	s t o l o v ʌ j ɑ
стоматолог-волонтерсем	s t o m ɑ t o l o g v o l o n t e r s e m
страница	s t r ɑ n i ts ɑ
страницӑн	s t r ɑ n i ts ʌ n
страус	s t r ɑ u s
строительсем	s t r o i t e l s e m
строительство	s t r o i t e l s t v o
стройкӑсене	s t r o j k ʌ s e n e
студент	s t u d e n t
студентсем	s t u d e n ts e m
студентсен	s t u d e n ts e n
студентсене	s t u d e n ts e n e
студенчӗсем	s t u d e n tʃ ɛ s e m
субботникӗ	s u b b o t n i k ɛ
субтитрсем	s u b t i t r s e m
субтитрсене	s u b t i t r s e n e
суд	s u d
суда	s u d ɑ
судлашма	s u d l ɑ ʃ m ɑ
судпа	s u d p ɑ
судра	s u d r ɑ
судьясем	s u d j ɑ s e m
суйлама	s u j l ɑ m ɑ
суйланӑ	s u j l ɑ n ʌ
суйларӑмӑр	s u j l ɑ r ʌ m ʌ r
суйларӗҫ	s u j l ɑ r ɛ ɕ
суйлас	s u j l ɑ s
суккӑрланнӑскер	s u kː ʌ r l ɑ nː ʌ s k e r
суккӑрланнӑскере	s u kː ʌ r l ɑ nː ʌ s k e r e
сулахай	s u l ɑ χ ɑ j
сулхӑн	s u l χ ʌ n
сульфатсем	s u l f ɑ ts e m
сума	s u m ɑ
сумалли	s u m ɑ lː i
сумкисемпе	s u m k i s e m p e
сумлӑ	s u m l ʌ
сунар	s u n ɑ r
сунас	s u n ɑ s
суни	s u n i
суннӑ	s u nː ʌ
сунса	s u n s ɑ
суракан	s u r ɑ k ɑ n
суран	s u r ɑ n
сурана	s u r ɑ n ɑ
суранланман	s u r ɑ n l ɑ n m ɑ n
суранланнисем	s u r ɑ n l ɑ nː i s e m
суранланнӑ	s u r ɑ n l ɑ nː ʌ
суранланнӑскере	s u r ɑ n l ɑ nː ʌ s k e r e
суранлатрӗҫ	s u r ɑ n l ɑ t r ɛ ɕ
сурма	s u r m ɑ
сурхурипе	s u r χ u r i p e
сурӑх	s u r ʌ χ
сурӑхӑнни	s u r ʌ χ ʌ nː i
сусӑр	s u s ʌ r
сутакан	s u t ɑ k ɑ n
сутаҫҫӗ	s u t ɑ ɕː ɛ
сутма	s u t m ɑ
сутнӑ	s u t n ʌ
сутса	s u ts ɑ
суту-илӳ	s u t u i l y
сутуҫа	s u t u ɕ ɑ
сутуҫи	s u t u ɕ i
сутуҫисен	s u t u ɕ i s e n
сутуҫӑ	s u t u ɕ ʌ
сутуҫӑсене	s u t u ɕ ʌ s e n e
сутӑннӑ	s u t ʌ nː ʌ
сухаласа	s u χ ɑ l ɑ s ɑ
сухалать	s u χ ɑ l ɑ t
сухан	s u χ ɑ n
сухансене	s u χ ɑ n s e n e
суханӗсене	s u χ ɑ n ɛ s e n e
сухари	s u χ ɑ r i
сухарисем	s u χ ɑ r i s e m
сухине	s u χ i n e
суя	s u j ɑ
суятӑр	s u j ɑ t ʌ r
сцена	s ts e n ɑ
сценарисем	s ts e n ɑ r i s e m
сценӑсенче	s ts e n ʌ s e n tʃ e
сывалатӑп	s ɯ v ɑ l ɑ t ʌ p
сывалаҫҫӗ	s ɯ v ɑ l ɑ ɕː ɛ
сывалма	s ɯ v ɑ l m ɑ
сывалнӑ	s ɯ v ɑ l n ʌ
сывалсанах	s ɯ v ɑ l s ɑ n ɑ χ
сыватасшӑн	s ɯ v ɑ t ɑ s ʃ ʌ n
сыватма	s ɯ v ɑ t m ɑ
сывламан	s ɯ v l ɑ m ɑ n
сывлаттарни	s ɯ v l ɑ tː ɑ r n i
сывлӑх	s ɯ v l ʌ χ
сывлӑха	s ɯ v l ʌ χ ɑ
сывлӑхне	s ɯ v l ʌ χ n e
сывлӑхран	s ɯ v l ʌ χ r ɑ n
сывлӑхӗ	s ɯ v l ʌ χ ɛ
сывлӑхӗшӗн	s ɯ v l ʌ χ ɛ ʃ ɛ n
сывлӑш	s ɯ v l ʌ ʃ
сывлӑшра	s ɯ v l ʌ ʃ r ɑ
сывпуллашу	s ɯ v p u lː ɑ ʃ u
сывӑ	s ɯ v ʌ
сыктывкар	s ɯ k t ɯ v k ɑ r
сылтӑм	s ɯ l t ʌ m
сылтӑмран	s ɯ l t ʌ m r ɑ n
сын	s ɯ n
сыпкаланӑ	s ɯ p k ɑ l ɑ n ʌ
сыппине	s ɯ pː i n e
сыпписене	s ɯ pː i s e n e
сыпса	s ɯ p s ɑ
сыпӑкне	s ɯ p ʌ k n e
сырпа	s ɯ r p ɑ
сыснасене	s ɯ s n ɑ s e n e
сысни	s ɯ s n i
сыснисене	s ɯ s n i s e n e
сыхлавне	s ɯ χ l ɑ v n e
сыхлавӗн	s ɯ χ l ɑ v ɛ n
сыхлама	s ɯ χ l ɑ m ɑ
сыхланӑ	s ɯ χ l ɑ n ʌ
сыхласа	s ɯ χ l ɑ s ɑ
сыхӑ	s ɯ χ ʌ
сюжечӗ	s j u ʒ e tʃ ɛ
сюитинчен	s j u i t i n tʃ e n
сӑ	s ʌ
сӑвапларӗ	s ʌ v ɑ p l ɑ r ɛ
сӑваҫҫӗ	s ʌ v ɑ ɕː ɛ
сӑвӑ	s ʌ v ʌ
сӑлтав	s ʌ l t ɑ v
сӑлтава	s ʌ l t ɑ v ɑ
сӑлтавланӑ	s ʌ l t ɑ v l ɑ n ʌ
сӑлтавне	s ʌ l t ɑ v n e
сӑлтавӗ	s ʌ l t ɑ v ɛ
сӑмавар	s ʌ m ɑ v ɑ r
сӑмах	s ʌ m ɑ χ
сӑмаха	s ʌ m ɑ χ ɑ
сӑмахлама	s ʌ m ɑ χ l ɑ m ɑ
сӑмахне	s ʌ m ɑ χ n e
сӑмахпа	s ʌ m ɑ χ p ɑ
сӑмахран	s ʌ m ɑ χ r ɑ n
сӑмахсем	s ʌ m ɑ χ s e m
сӑмахсемпе	s ʌ m ɑ χ s e m p e
сӑмахсене	s ʌ m ɑ χ s e n e
сӑмахсӑрах	s ʌ m ɑ χ s ʌ r ɑ χ
сӑмахӑн	s ʌ m ɑ χ ʌ n
сӑмахӗнче	s ʌ m ɑ χ ɛ n tʃ e
сӑмахӗсем	s ʌ m ɑ χ ɛ s e m
сӑмахӗсене	s ʌ m ɑ χ ɛ s e n e
сӑмсана	s ʌ m s ɑ n ɑ
сӑмси	s ʌ m s i
сӑн	s ʌ n
сӑн-сӑпат	s ʌ n s ʌ p ɑ t
сӑнав	s ʌ n ɑ v
сӑнамалла	s ʌ n ɑ m ɑ lː ɑ
сӑнанӑ	s ʌ n ɑ n ʌ
сӑнара	s ʌ n ɑ r ɑ
сӑнарне	s ʌ n ɑ r n e
сӑнарсене	s ʌ n ɑ r s e n e
сӑнарӑм	s ʌ n ɑ r ʌ m
сӑнаса	s ʌ n ɑ s ɑ
сӑнасах	s ʌ n ɑ s ɑ χ
сӑнатчӗҫ	s ʌ n ɑ t tʃ ɛ ɕ
сӑнланнӑ	s ʌ n l ɑ nː ʌ
сӑнпа	s ʌ n p ɑ
сӑнӳкерчӗксем	s ʌ n y k e r tʃ ɛ k s e m
сӑнӳкерчӗксен	s ʌ n y k e r tʃ ɛ k s e n
сӑпки	s ʌ p k i
сӑр	s ʌ r
сӑра	s ʌ r ɑ
сӑран	s ʌ r ɑ n
сӑрт-ту	s ʌ r tː u
сӑрталла	s ʌ r t ɑ lː ɑ
сӑртри	s ʌ r t r i
сӑртсем	s ʌ r ts e m
сӑрхӑнма	s ʌ r χ ʌ n m ɑ
сӑрӑ	s ʌ r ʌ
сӑрӑсемпе	s ʌ r ʌ s e m p e
сӑссине	s ʌ sː i n e
сӗвӗрӗлетчӗ	s ɛ v ɛ r ɛ l e t tʃ ɛ
сӗлӗ	s ɛ l ɛ
сӗмсӗр	s ɛ m s ɛ r
сӗнекен	s ɛ n e k e n
сӗнет	s ɛ n e t
сӗнеҫҫӗ	s ɛ n e ɕː ɛ
сӗнме	s ɛ n m e
сӗнмен	s ɛ n m e n
сӗннине	s ɛ nː i n e
сӗннипе	s ɛ nː i p e
сӗннӗ	s ɛ nː ɛ
сӗннӗччӗ	s ɛ nː ɛ tʃ tʃ ɛ
сӗнсе	s ɛ n s e
сӗнтӗрвӑрри	s ɛ n t ɛ r v ʌ rː i
сӗнчӗҫ	s ɛ n tʃ ɛ ɕ
сӗнӳ	s ɛ n y
сӗнӳсене	s ɛ n y s e n e
сӗрме	s ɛ r m e
сӗрнӗ	s ɛ r n ɛ
сӗт	s ɛ t
сӗт-ҫу	s ɛ t ɕ u
сӗтев	s ɛ t e v
сӗтел	s ɛ t e l
сӗтел-канашлу	s ɛ t e l k ɑ n ɑ ʃ l u
сӗтел-канашлура	s ɛ t e l k ɑ n ɑ ʃ l u r ɑ
сӗткенне	s ɛ t k e nː e
сӗтӗрсе	s ɛ t ɛ r s e
сӳничченех	s y n i tʃ tʃ e n e χ
сӳннӗ	s y nː ɛ
сӳнсе	s y n s e
сӳнтерчӗ	s y n t e r tʃ ɛ
сӳсе	s y s e
сӳтсе	s y ts e
та	t ɑ
табличкӑна	t ɑ b l i tʃ k ʌ n ɑ
табло	t ɑ b l o
тав	t ɑ v
тавар	t ɑ v ɑ r
тавара	t ɑ v ɑ r ɑ
таварне	t ɑ v ɑ r n e
таварсене	t ɑ v ɑ r s e n e
таваршӑн	t ɑ v ɑ r ʃ ʌ n
тавах	t ɑ v ɑ χ
тавлашу	t ɑ v l ɑ ʃ u
тавра	t ɑ v r ɑ
тавралӑх	t ɑ v r ɑ l ʌ χ
тавралӑха	t ɑ v r ɑ l ʌ χ ɑ
таврапӗлӳпе	t ɑ v r ɑ p ɛ l y p e
таврашӗ	t ɑ v r ɑ ʃ ɛ
таврӑн	t ɑ v r ʌ n
таврӑнайман	t ɑ v r ʌ n ɑ j m ɑ n
таврӑнакан	t ɑ v r ʌ n ɑ k ɑ n
таврӑнасран	t ɑ v r ʌ n ɑ s r ɑ n
таврӑнасса	t ɑ v r ʌ n ɑ sː ɑ
таврӑнать	t ɑ v r ʌ n ɑ t
таврӑнма	t ɑ v r ʌ n m ɑ
таврӑннӑ	t ɑ v r ʌ nː ʌ
таврӑнсан	t ɑ v r ʌ n s ɑ n
таврӑнсанах	t ɑ v r ʌ n s ɑ n ɑ χ
тавӑраҫҫӗ	t ɑ v ʌ r ɑ ɕː ɛ
тавӑрма	t ɑ v ʌ r m ɑ
тавӑрман	t ɑ v ʌ r m ɑ n
тавӑрса	t ɑ v ʌ r s ɑ
тавӑҫ	t ɑ v ʌ ɕ
тайрӗҫ	t ɑ j r ɛ ɕ
тайӑлнӑ	t ɑ j ʌ l n ʌ
тайӑлса	t ɑ j ʌ l s ɑ
така	t ɑ k ɑ
такам	t ɑ k ɑ m
такӑнаттӑм	t ɑ k ʌ n ɑ tː ʌ m
такӑнса	t ɑ k ʌ n s ɑ
талантсем	t ɑ l ɑ n ts e m
талпӑнать	t ɑ l p ʌ n ɑ t
талпӑннӑ	t ɑ l p ʌ nː ʌ
талӑклӑх	t ɑ l ʌ k l ʌ χ
талӑкран	t ɑ l ʌ k r ɑ n
тамара	t ɑ m ɑ r ɑ
таможньӑра	t ɑ m o ʒ n ʌ r ɑ
тамӑк	t ɑ m ʌ k
танайкӑна	t ɑ n ɑ j k ʌ n ɑ
танах	t ɑ n ɑ χ
танлашать	t ɑ n l ɑ ʃ ɑ t
танлаштарать	t ɑ n l ɑ ʃ t ɑ r ɑ t
танлаштарсан	t ɑ n l ɑ ʃ t ɑ r s ɑ n
тапаҫланнине	t ɑ p ɑ ɕ l ɑ nː i n e
тапаҫланса	t ɑ p ɑ ɕ l ɑ n s ɑ
таплаттарса	t ɑ p l ɑ tː ɑ r s ɑ
тапма	t ɑ p m ɑ
тапса	t ɑ p s ɑ
таптанине	t ɑ p t ɑ n i n e
таптаса	t ɑ p t ɑ s ɑ
тапхӑр	t ɑ p χ ʌ r
тапхӑра	t ɑ p χ ʌ r ɑ
тапхӑрсенче	t ɑ p χ ʌ r s e n tʃ e
тапхӑрта	t ɑ p χ ʌ r t ɑ
тар	t ɑ r
тара	t ɑ r ɑ
таран	t ɑ r ɑ n
таранах	t ɑ r ɑ n ɑ χ
таранччен	t ɑ r ɑ n tʃ tʃ e n
тарас	t ɑ r ɑ s
тарать	t ɑ r ɑ t
тарса	t ɑ r s ɑ
тартнӑ	t ɑ r t n ʌ
тарҫи	t ɑ r ɕ i
тарӑ	t ɑ r ʌ
тарӑн	t ɑ r ʌ n
тарӑхсах	t ɑ r ʌ χ s ɑ χ
тарӑхтарса	t ɑ r ʌ χ t ɑ r s ɑ
таса	t ɑ s ɑ
таса-мӗн	t ɑ s ɑ m ɛ n
тасалчӗ	t ɑ s ɑ l tʃ ɛ
тасалӑхӗшӗн	t ɑ s ɑ l ʌ χ ɛ ʃ ɛ n
тасамарланнӑ	t ɑ s ɑ m ɑ r l ɑ nː ʌ
тасатаҫҫӗ	t ɑ s ɑ t ɑ ɕː ɛ
тасатма	t ɑ s ɑ t m ɑ
тасатмаҫҫӗ	t ɑ s ɑ t m ɑ ɕː ɛ
тасатрӑмӑр	t ɑ s ɑ t r ʌ m ʌ r
тасатса	t ɑ s ɑ ts ɑ
тасатӗҫ	t ɑ s ɑ t ɛ ɕ
тата	t ɑ t ɑ
татах	t ɑ t ɑ χ
татахчӗ	t ɑ t ɑ χ tʃ ɛ
татма	t ɑ t m ɑ
татнине	t ɑ t n i n e
татнӑ	t ɑ t n ʌ
татрӗ	t ɑ t r ɛ
татса	t ɑ ts ɑ
татьяна	t ɑ t j ɑ n ɑ
татюк	t ɑ t j u k
татӑк	t ɑ t ʌ k
татӑклӑ	t ɑ t ʌ k l ʌ
татӑклӑн	t ɑ t ʌ k l ʌ n
татӑкӗсем	t ɑ t ʌ k ɛ s e m
татӑлать	t ɑ t ʌ l ɑ t
татӑлмасть	t ɑ t ʌ l m ɑ s t
татӑлнӑ	t ɑ t ʌ l n ʌ
татӑлчӗ	t ɑ t ʌ l tʃ ɛ
тахҫан	t ɑ χ ɕ ɑ n
тахҫанах	t ɑ χ ɕ ɑ n ɑ χ
ташлани	t ɑ ʃ l ɑ n i
ташланӑ	t ɑ ʃ l ɑ n ʌ
ташшине	t ɑ ʃː i n e
ташшисемпе	t ɑ ʃː i s e m p e
ташӑ	t ɑ ʃ ʌ
таҫта	t ɑ ɕ t ɑ
тв	t v
тваттӑ	t v ɑ tː ʌ
те	t e
те-ха	t e χ ɑ
театр	t e ɑ t r
театрне	t e ɑ t r n e
театрсем	t e ɑ t r s e m
театрӑн	t e ɑ t r ʌ n
театрӗн	t e ɑ t r ɛ n
театрӗнче	t e ɑ t r ɛ n tʃ e
театрӗсене	t e ɑ t r ɛ s e n e
тееймӗн	t e e j m ɛ n
тейӗн	t e j ɛ n
тек	t e k
текен	t e k e n
текенни	t e k e nː i
телее	t e l e e
телейлӗ	t e l e j l ɛ
телейсӗр	t e l e j s ɛ r
телейӗшӗн	t e l e j ɛ ʃ ɛ n
телекурав	t e l e k u r ɑ v
телефон	t e l e f o n
телефонпа	t e l e f o n p ɑ
телефонсӑр	t e l e f o n s ʌ r
телефонӗ	t e l e f o n ɛ
телефонӗпе	t e l e f o n ɛ p e
тем	t e m
теме	t e m e
темен	t e m e n
теместӗп	t e m e s t ɛ p
темех	t e m e χ
темиҫе	t e m i ɕ e
темшӗн	t e m ʃ ɛ n
темҫе	t e m ɕ e
темӗн	t e m ɛ n
темӗнле	t e m ɛ n l e
темӗскер	t e m ɛ s k e r
темӗскере	t e m ɛ s k e r e
тен	t e n
тени	t e n i
тенине	t e n i n e
тенкӗ	t e n k ɛ
тенӗ	t e n ɛ
тенӗччӗ	t e n ɛ tʃ tʃ ɛ
тепре	t e p r e
тепри	t e p r i
тепринчен	t e p r i n tʃ e n
теприсем	t e p r i s e m
тепӗр	t e p ɛ r
терапийӗ	t e r ɑ p i j ɛ
терапине	t e r ɑ p i n e
тери	t e r i
теркӑланӑ	t e r k ʌ l ɑ n ʌ
теркӑларӗҫ	t e r k ʌ l ɑ r ɛ ɕ
теркӑласа	t e r k ʌ l ɑ s ɑ
термоссене	t e r m o sː e n e
территорийӗ	t e rː i t o r i j ɛ
территорисене	t e rː i t o r i s e n e
тертленме	t e r t l e n m e
терӗ	t e r ɛ
терӗм	t e r ɛ m
терӗҫ	t e r ɛ ɕ
тесе	t e s e
тесен	t e s e n
тест	t e s t
тесшӗн-и	t e s ʃ ɛ n i
тет	t e t
тетелне	t e t e l n e
тетелӗнче	t e t e l ɛ n tʃ e
тетелӗнчи	t e t e l ɛ n tʃ i
тетелӗсене	t e t e l ɛ s e n e
тетен	t e t e n
тетте	t e tː e
теттесем	t e tː e s e m
теттесене	t e tː e s e n e
тетчӗ	t e t tʃ ɛ
тетӗп	t e t ɛ p
техника	t e χ n i k ɑ
техника-япаласӑр	t e χ n i k ɑ j ɑ p ɑ l ɑ s ʌ r
техникум-колледжсем	t e χ n i k u m k o lː e d ʒ s e m
техникӑна	t e χ n i k ʌ n ɑ
технологилллӗ	t e χ n o l o g i lː l ɛ
технологисемпе	t e χ n o l o g i s e m p e
технологне	t e χ n o l o g n e
техӗмлӗ	t e χ ɛ m l ɛ
теҫҫӗ	t e ɕː ɛ
тивет	t i v e t
тиветех	t i v e t e χ
тивме	t i v m e
тивмелле-мӗн	t i v m e lː e m ɛ n
тивнех	t i v n e χ
тивнӗ	t i v n ɛ
тиврӗ	t i v r ɛ
тивӗ	t i v ɛ
тивӗҫ	t i v ɛ ɕ
тивӗҫет	t i v ɛ ɕ e t
тивӗҫеҫҫӗ	t i v ɛ ɕ e ɕː ɛ
тивӗҫлипе	t i v ɛ ɕ l i p e
тивӗҫлӗ	t i v ɛ ɕ l ɛ
тивӗҫме	t i v ɛ ɕ m e
тивӗҫмешкӗн	t i v ɛ ɕ m e ʃ k ɛ n
тивӗҫнӗ	t i v ɛ ɕ n ɛ
тивӗҫсен	t i v ɛ ɕ s e n
тивӗҫсенчен	t i v ɛ ɕ s e n tʃ e n
тивӗҫтерет-и	t i v ɛ ɕ t e r e t i
тивӗҫтернӗ	t i v ɛ ɕ t e r n ɛ
тивӗҫтерчӗ	t i v ɛ ɕ t e r tʃ ɛ
тивӗҫтерӗҫ	t i v ɛ ɕ t e r ɛ ɕ
тиевҫӗре	t i e v ɕ ɛ r e
тиексем	t i e k s e m
тикӗссӗн	t i k ɛ sː ɛ n
тилхепине	t i l χ e p i n e
тимлекен	t i m l e k e n
тимлеме	t i m l e m e
тимлемеллине	t i m l e m e lː i n e
тимлеҫҫӗ	t i m l e ɕː ɛ
тимлӗ	t i m l ɛ
тимлӗҫ	t i m l ɛ ɕ
тимӗр	t i m ɛ r
тин	t i n
тинех	t i n e χ
тинкернӗ	t i n k e r n ɛ
тинӗс	t i n ɛ s
типсе	t i p s e
типтерлӗ	t i p t e r l ɛ
типӗ	t i p ɛ
типӗтмелли	t i p ɛ t m e lː i
типӗтнӗ	t i p ɛ t n ɛ
тиража	t i r ɑ ʒ ɑ
тирекен	t i r e k e n
тиркемест	t i r k e m e s t
тирне	t i r n e
тирпейлӗ	t i r p e j l ɛ
тирпейсӗрлӗх	t i r p e j s ɛ r l ɛ χ
тирпейсӗрлӗхе	t i r p e j s ɛ r l ɛ χ e
тискерсем	t i s k e r s e m
тихонов	t i χ o n o v
тишкереттӗм	t i ʃ k e r e tː ɛ m
тишкеретӗп	t i ʃ k e r e t ɛ p
тишкереҫҫӗ	t i ʃ k e r e ɕː ɛ
тишкерме	t i ʃ k e r m e
тишкермелле	t i ʃ k e r m e lː e
тишкерсе	t i ʃ k e r s e
том	t o m
тормоэӗ	t o r m o e ɛ
трактор	t r ɑ k t o r
транспорт	t r ɑ n s p o r t
транспорта	t r ɑ n s p o r t ɑ
транспортпа	t r ɑ n s p o r t p ɑ
транспортри	t r ɑ n s p o r t r i
транспортӑн	t r ɑ n s p o r t ʌ n
транспортӗнчен	t r ɑ n s p o r t ɛ n tʃ e n
транспорчӗн	t r ɑ n s p o r tʃ ɛ n
траснпорт	t r ɑ s n p o r t
трасса	t r ɑ sː ɑ
тренажер	t r e n ɑ ʒ e r
тренажерсем	t r e n ɑ ʒ e r s e m
тренер	t r e n e r
тренерпа	t r e n e r p ɑ
тренерсене	t r e n e r s e n e
тренировка	t r e n i r o v k ɑ
троллейбус	t r o lː e j b u s
троллейбуса	t r o lː e j b u s ɑ
троллейбуссем	t r o lː e j b u sː e m
троллейбуссемпе	t r o lː e j b u sː e m p e
троллейбуссене	t r o lː e j b u sː e n e
троллейбусӑн	t r o lː e j b u s ʌ n
тротуар	t r o t u ɑ r
труппи	t r u pː i
трусиха	t r u s i χ ɑ
туй	t u j
туйма	t u j m ɑ
туйман	t u j m ɑ n
туйми	t u j m i
туйнӑ	t u j n ʌ
туйран	t u j r ɑ n
туйрӑм	t u j r ʌ m
туйса	t u j s ɑ
туйтӑр	t u j t ʌ r
туйӑмлӑ	t u j ʌ m l ʌ
туйӑмсем	t u j ʌ m s e m
туйӑмӗ	t u j ʌ m ɛ
туйӑнать	t u j ʌ n ɑ t
туйӑннӑ	t u j ʌ nː ʌ
туйӑнчӗҫ	t u j ʌ n tʃ ɛ ɕ
тул	t u l
тулли	t u lː i
туллиех	t u lː i e χ
туллин	t u lː i n
туллирех	t u lː i r e χ
тулнӑ	t u l n ʌ
тулса	t u l s ɑ
тулта	t u l t ɑ
тултарнӑ	t u l t ɑ r n ʌ
тултартӑмӑр	t u l t ɑ r t ʌ m ʌ r
тулӑри	t u l ʌ r i
тум	t u m
тума	t u m ɑ
тумалла	t u m ɑ lː ɑ
тумаллине	t u m ɑ lː i n e
туман	t u m ɑ n
тумасан	t u m ɑ s ɑ n
тумасть	t u m ɑ s t
тумастӑп	t u m ɑ s t ʌ p
тумасӑр	t u m ɑ s ʌ r
тумашкӑн	t u m ɑ ʃ k ʌ n
тумлатасран	t u m l ɑ t ɑ s r ɑ n
тумлатма	t u m l ɑ t m ɑ
тумпах	t u m p ɑ χ
тумсем	t u m s e m
тумтир	t u m t i r
тумтире	t u m t i r e
тумтирпе	t u m t i r p e
тумтирсӗр	t u m t i r s ɛ r
тумтирӗ	t u m t i r ɛ
тумтирӗпе	t u m t i r ɛ p e
туни	t u n i
тунине	t u n i n e
тунман	t u n m ɑ n
тунса	t u n s ɑ
тунсӑх	t u n s ʌ χ
тунсӑхланӑ	t u n s ʌ χ l ɑ n ʌ
тунсӑхлатпӑр	t u n s ʌ χ l ɑ t p ʌ r
тунтикунсерен	t u n t i k u n s e r e n
тунӑ	t u n ʌ
тунӑ-ха	t u n ʌ χ ɑ
тупайман	t u p ɑ j m ɑ n
тупаймасӑр	t u p ɑ j m ɑ s ʌ r
тупаймӑпӑр	t u p ɑ j m ʌ p ʌ r
тупатех	t u p ɑ t e χ
тупатчӗ	t u p ɑ t tʃ ɛ
тупиччен	t u p i tʃ tʃ e n
тупма	t u p m ɑ
тупмаллах	t u p m ɑ lː ɑ χ
тупмашкӑн	t u p m ɑ ʃ k ʌ n
тупнӑ	t u p n ʌ
тупнӑ-мӗн	t u p n ʌ m ɛ n
тупрӑм	t u p r ʌ m
тупрӑн	t u p r ʌ n
тупса	t u p s ɑ
туптакана	t u p t ɑ k ɑ n ɑ
туптать	t u p t ɑ t
туптаҫҫӗ	t u p t ɑ ɕː ɛ
тупӑкне	t u p ʌ k n e
тупӑкра	t u p ʌ k r ɑ
тупӑнать	t u p ʌ n ɑ t
тупӑнаҫҫӗ	t u p ʌ n ɑ ɕː ɛ
тупӑнман	t u p ʌ n m ɑ n
тупӑннӑ	t u p ʌ nː ʌ
тупӑнсах	t u p ʌ n s ɑ χ
тупӑнчӗҫ	t u p ʌ n tʃ ɛ ɕ
тупӑшакан	t u p ʌ ʃ ɑ k ɑ n
тупӑшасшӑн-ши	t u p ʌ ʃ ɑ s ʃ ʌ n ʃ i
тупӑшать	t u p ʌ ʃ ɑ t
тупӑшнӑ	t u p ʌ ʃ n ʌ
тупӑшсашӑн	t u p ʌ ʃ s ɑ ʃ ʌ n
тупӑшу	t u p ʌ ʃ u
тупӑшӑвӗ	t u p ʌ ʃ ʌ v ɛ
тупӑшӗҫ	t u p ʌ ʃ ɛ ɕ
тупӗ	t u p ɛ
тура	t u r ɑ
туратсене	t u r ɑ ts e n e
тураттисем	t u r ɑ tː i s e m
турилкке	t u r i l kː e
туристсене	t u r i s ts e n e
туриэм	t u r i e m
турнир	t u r n i r
турнира	t u r n i r ɑ
турнирсем	t u r n i r s e m
турнирта	t u r n i r t ɑ
турта-турта	t u r t ɑ t u r t ɑ
турткаласа	t u r t k ɑ l ɑ s ɑ
турткалашман	t u r t k ɑ l ɑ ʃ m ɑ n
турткалашнӑ-ха	t u r t k ɑ l ɑ ʃ n ʌ χ ɑ
туртма	t u r t m ɑ
туртмалли	t u r t m ɑ lː i
туртмарӗ	t u r t m ɑ r ɛ
туртса	t u r ts ɑ
турттармӗҫ	t u r tː ɑ r m ɛ ɕ
турттарнӑ	t u r tː ɑ r n ʌ
турттарса	t u r tː ɑ r s ɑ
турттарӗҫ	t u r tː ɑ r ɛ ɕ
туртӑнчӗ	t u r t ʌ n tʃ ɛ
турцие	t u r ts i e
турцирен	t u r ts i r e n
турӑ	t u r ʌ
турӑм	t u r ʌ m
турӑмӑр	t u r ʌ m ʌ r
турӑшсене	t u r ʌ ʃ s e n e
тус-юлташ	t u s j u l t ɑ ʃ
туса	t u s ɑ
тусан	t u s ɑ n
тусем	t u s e m
туслашни	t u s l ɑ ʃ n i
туслашрӑм	t u s l ɑ ʃ r ʌ m
туслаштарнине	t u s l ɑ ʃ t ɑ r n i n e
туслик	t u s l i k
туслӑ	t u s l ʌ
туслӑх	t u s l ʌ χ
туслӑхӗн	t u s l ʌ χ ɛ n
туссем	t u sː e m
туссене	t u sː e n e
тусӑм	t u s ʌ m
тусӑмсем	t u s ʌ m s e m
тусӗсем	t u s ɛ s e m
тусӗсемпе	t u s ɛ s e m p e
тутанассишӗн	t u t ɑ n ɑ sː i ʃ ɛ n
тутар	t u t ɑ r
тутарла	t u t ɑ r l ɑ
тутарсенне	t u t ɑ r s e nː e
тутарстан	t u t ɑ r s t ɑ n
тутарстанра	t u t ɑ r s t ɑ n r ɑ
тутарстанри	t u t ɑ r s t ɑ n r i
тутартӑм	t u t ɑ r t ʌ m
тути	t u t i
тути-ҫӑварӗ	t u t i ɕ ʌ v ɑ r ɛ
тутипе	t u t i p e
тутлӑ	t u t l ʌ
туфли	t u f l i
туфлие	t u f l i e
тух	t u χ
тухайман	t u χ ɑ j m ɑ n
тухаймасса	t u χ ɑ j m ɑ sː ɑ
тухаймассӑн	t u χ ɑ j m ɑ sː ʌ n
тухакан	t u χ ɑ k ɑ n
тухатпӑр	t u χ ɑ t p ʌ r
тухатчӗ	t u χ ɑ t tʃ ɛ
тухать	t u χ ɑ t
тухаҫҫӗ	t u χ ɑ ɕː ɛ
тухиччен	t u χ i tʃ tʃ e n
тухичченех	t u χ i tʃ tʃ e n e χ
тухйи	t u χ j i
тухма	t u χ m ɑ
тухмалла	t u χ m ɑ lː ɑ
тухмаллах	t u χ m ɑ lː ɑ χ
тухман	t u χ m ɑ n
тухмарӗ	t u χ m ɑ r ɛ
тухмасан	t u χ m ɑ s ɑ n
тухмастчӗ	t u χ m ɑ s t tʃ ɛ
тухмасть	t u χ m ɑ s t
тухмасӑр	t u χ m ɑ s ʌ r
тухмашкӑн	t u χ m ɑ ʃ k ʌ n
тухни	t u χ n i
тухнине	t u χ n i n e
тухнӑ	t u χ n ʌ
тухнӑскер	t u χ n ʌ s k e r
тухрӑм	t u χ r ʌ m
тухрӗ	t u χ r ɛ
тухрӗҫ	t u χ r ɛ ɕ
тухса	t u χ s ɑ
тухсан	t u χ s ɑ n
тухсанах	t u χ s ɑ n ɑ χ
тухтӑр	t u χ t ʌ r
тухтӑра	t u χ t ʌ r ɑ
тухтӑрне	t u χ t ʌ r n e
тухтӑрсем	t u χ t ʌ r s e m
тухтӑрсене	t u χ t ʌ r s e n e
тухтӑрӗ	t u χ t ʌ r ɛ
тухӑн	t u χ ʌ n
тухӑҫлӑ	t u χ ʌ ɕ l ʌ
тухӗ	t u χ ɛ
тухӗҫ	t u χ ɛ ɕ
тушенка	t u ʃ e n k ɑ
туя	t u j ɑ
туянакансем	t u j ɑ n ɑ k ɑ n s e m
туянас	t u j ɑ n ɑ s
туянасси	t u j ɑ n ɑ sː i
туянассинчен	t u j ɑ n ɑ sː i n tʃ e n
туянасшӑн	t u j ɑ n ɑ s ʃ ʌ n
туянаҫҫӗ	t u j ɑ n ɑ ɕː ɛ
туянма	t u j ɑ n m ɑ
туянмалӑх	t u j ɑ n m ɑ l ʌ χ
туянман	t u j ɑ n m ɑ n
туяннине	t u j ɑ nː i n e
туяннӑ	t u j ɑ nː ʌ
туянса	t u j ɑ n s ɑ
туянтӑм	t u j ɑ n t ʌ m
туясчӗ	t u j ɑ s tʃ ɛ
туять	t u j ɑ t
туятӑп	t u j ɑ t ʌ p
туяҫҫӗ	t u j ɑ ɕː ɛ
туҫаран	t u ɕ ɑ r ɑ n
тыл	t ɯ l
тыр-пул	t ɯ r p u l
тырӑ	t ɯ r ʌ
тытан	t ɯ t ɑ n
тытатпӑр	t ɯ t ɑ t p ʌ r
тытать	t ɯ t ɑ t
тытаҫҫӗ	t ɯ t ɑ ɕː ɛ
тыткаласа	t ɯ t k ɑ l ɑ s ɑ
тыткӑнлас	t ɯ t k ʌ n l ɑ s
тытма	t ɯ t m ɑ
тытмалли	t ɯ t m ɑ lː i
тытман	t ɯ t m ɑ n
тытмасть	t ɯ t m ɑ s t
тытнӑ	t ɯ t n ʌ
тытнӑшӑн	t ɯ t n ʌ ʃ ʌ n
тытрӗ	t ɯ t r ɛ
тытса	t ɯ ts ɑ
тытсан	t ɯ ts ɑ n
тыттарассине	t ɯ tː ɑ r ɑ sː i n e
тыттарасшӑн	t ɯ tː ɑ r ɑ s ʃ ʌ n
тыттараҫҫӗ	t ɯ tː ɑ r ɑ ɕː ɛ
тыттарнӑ	t ɯ tː ɑ r n ʌ
тыттартӑм	t ɯ tː ɑ r t ʌ m
тытӑмне	t ɯ t ʌ m n e
тытӑмра	t ɯ t ʌ m r ɑ
тытӑмсем	t ɯ t ʌ m s e m
тытӑмӗ	t ɯ t ʌ m ɛ
тытӑмӗнче	t ɯ t ʌ m ɛ n tʃ e
тытӑнасшӑн	t ɯ t ʌ n ɑ s ʃ ʌ n
тытӑнать	t ɯ t ʌ n ɑ t
тытӑниччен	t ɯ t ʌ n i tʃ tʃ e n
тытӑннӑ	t ɯ t ʌ nː ʌ
тытӑнса	t ɯ t ʌ n s ɑ
тытӑнтӑмӑр	t ɯ t ʌ n t ʌ m ʌ r
тытӑнчӗ	t ɯ t ʌ n tʃ ɛ
тытӑнчӗҫ	t ɯ t ʌ n tʃ ɛ ɕ
тытӑнӑр	t ɯ t ʌ n ʌ r
тытӑнӗҫ	t ɯ t ʌ n ɛ ɕ
тытӗ	t ɯ t ɛ
тытӗҫ	t ɯ t ɛ ɕ
тюбик	t j u b i k
тӑвакан	t ʌ v ɑ k ɑ n
тӑвакансем	t ʌ v ɑ k ɑ n s e m
тӑвакансен	t ʌ v ɑ k ɑ n s e n
тӑван	t ʌ v ɑ n
тӑванах	t ʌ v ɑ n ɑ χ
тӑванлашнӑ	t ʌ v ɑ n l ɑ ʃ n ʌ
тӑваннине	t ʌ v ɑ nː i n e
тӑвансем	t ʌ v ɑ n s e m
тӑванӑм	t ʌ v ɑ n ʌ m
тӑванӗ	t ʌ v ɑ n ɛ
тӑванӗсем	t ʌ v ɑ n ɛ s e m
тӑванӗсемпе	t ʌ v ɑ n ɛ s e m p e
тӑванӗсен	t ʌ v ɑ n ɛ s e n
тӑванӗсене	t ʌ v ɑ n ɛ s e n e
тӑванӗсенчен	t ʌ v ɑ n ɛ s e n tʃ e n
тӑвас	t ʌ v ɑ s
тӑвасси	t ʌ v ɑ sː i
тӑвассипе	t ʌ v ɑ sː i p e
тӑвассишӗн	t ʌ v ɑ sː i ʃ ɛ n
тӑвасшӑн	t ʌ v ɑ s ʃ ʌ n
тӑваттӑ	t ʌ v ɑ tː ʌ
тӑвать	t ʌ v ɑ t
тӑватӑ	t ʌ v ɑ t ʌ
тӑватӑп	t ʌ v ɑ t ʌ p
тӑваҫҫӗ	t ʌ v ɑ ɕː ɛ
тӑвиччен	t ʌ v i tʃ tʃ e n
тӑврӑничченех	t ʌ v r ʌ n i tʃ tʃ e n e χ
тӑвӑл	t ʌ v ʌ l
тӑвӑн	t ʌ v ʌ n
тӑвӑрланнӑ	t ʌ v ʌ r l ɑ nː ʌ
тӑвӗҫ	t ʌ v ɛ ɕ
тӑвӗҫ-ши	t ʌ v ɛ ɕ ʃ i
тӑк	t ʌ k
тӑкак	t ʌ k ɑ k
тӑкака	t ʌ k ɑ k ɑ
тӑкаксемшӗн	t ʌ k ɑ k s e m ʃ ɛ n
тӑкаксене	t ʌ k ɑ k s e n e
тӑккалас	t ʌ kː ɑ l ɑ s
тӑккалатӑр	t ʌ kː ɑ l ɑ t ʌ r
тӑкмаҫҫӗ	t ʌ k m ɑ ɕː ɛ
тӑкнӑ	t ʌ k n ʌ
тӑкса	t ʌ k s ɑ
тӑкӑнни	t ʌ k ʌ nː i
тӑкӑннӑ	t ʌ k ʌ nː ʌ
тӑкӑнса	t ʌ k ʌ n s ɑ
тӑлӑх	t ʌ l ʌ χ
тӑлӑха	t ʌ l ʌ χ ɑ
тӑм	t ʌ m
тӑма	t ʌ m ɑ
тӑмалла	t ʌ m ɑ lː ɑ
тӑман	t ʌ m ɑ n
тӑмасӑр	t ʌ m ɑ s ʌ r
тӑмашкӑн	t ʌ m ɑ ʃ k ʌ n
тӑмаҫҫӗ	t ʌ m ɑ ɕː ɛ
тӑмра	t ʌ m r ɑ
тӑна	t ʌ n ɑ
тӑни	t ʌ n i
тӑнине	t ʌ n i n e
тӑнлӑ	t ʌ n l ʌ
тӑнне	t ʌ nː e
тӑнсӑр	t ʌ n s ʌ r
тӑнӑ	t ʌ n ʌ
тӑнӑран	t ʌ n ʌ r ɑ n
тӑп-тулличчӗ	t ʌ p t u lː i tʃ tʃ ɛ
тӑпра	t ʌ p r ɑ
тӑпрана	t ʌ p r ɑ n ɑ
тӑпӑлса	t ʌ p ʌ l s ɑ
тӑрайман	t ʌ r ɑ j m ɑ n
тӑраймарӑм	t ʌ r ɑ j m ɑ r ʌ m
тӑраймасть	t ʌ r ɑ j m ɑ s t
тӑракан	t ʌ r ɑ k ɑ n
тӑракансем	t ʌ r ɑ k ɑ n s e m
тӑраканскерсене	t ʌ r ɑ k ɑ n s k e r s e n e
тӑран	t ʌ r ɑ n
тӑраниччен	t ʌ r ɑ n i tʃ tʃ e n
тӑрантараҫҫӗ	t ʌ r ɑ n t ɑ r ɑ ɕː ɛ
тӑрантармашкӑн	t ʌ r ɑ n t ɑ r m ɑ ʃ k ʌ n
тӑрасса	t ʌ r ɑ sː ɑ
тӑратать	t ʌ r ɑ t ɑ t
тӑратма	t ʌ r ɑ t m ɑ
тӑратнӑ	t ʌ r ɑ t n ʌ
тӑратпӑр	t ʌ r ɑ t p ʌ r
тӑраттӑм	t ʌ r ɑ tː ʌ m
тӑрать	t ʌ r ɑ t
тӑрать-ҫке	t ʌ r ɑ t ɕ k e
тӑратӑр-и	t ʌ r ɑ t ʌ r i
тӑрах	t ʌ r ɑ χ
тӑрашаканскерсем	t ʌ r ɑ ʃ ɑ k ɑ n s k e r s e m
тӑраҫҫӗ	t ʌ r ɑ ɕː ɛ
тӑри	t ʌ r i
тӑрмашма	t ʌ r m ɑ ʃ m ɑ
тӑрса	t ʌ r s ɑ
тӑрсан	t ʌ r s ɑ n
тӑрсанах	t ʌ r s ɑ n ɑ χ
тӑрук	t ʌ r u k
тӑруках	t ʌ r u k ɑ χ
тӑрӑ	t ʌ r ʌ
тӑрӑллӑ	t ʌ r ʌ lː ʌ
тӑрӑр-ха	t ʌ r ʌ r χ ɑ
тӑрӑх	t ʌ r ʌ χ
тӑрӑха	t ʌ r ʌ χ ɑ
тӑрӑхне	t ʌ r ʌ χ n e
тӑрӑхра	t ʌ r ʌ χ r ɑ
тӑрӑхран	t ʌ r ʌ χ r ɑ n
тӑрӑхрах	t ʌ r ʌ χ r ɑ χ
тӑрӑхри	t ʌ r ʌ χ r i
тӑрӑхсем	t ʌ r ʌ χ s e m
тӑрӑхсене	t ʌ r ʌ χ s e n e
тӑрӑхсенчен	t ʌ r ʌ χ s e n tʃ e n
тӑрӑхӗн	t ʌ r ʌ χ ɛ n
тӑрӑхӗнчех	t ʌ r ʌ χ ɛ n tʃ e χ
тӑрӑшакансем	t ʌ r ʌ ʃ ɑ k ɑ n s e m
тӑрӑшакансене	t ʌ r ʌ ʃ ɑ k ɑ n s e n e
тӑрӑшатпӑр	t ʌ r ʌ ʃ ɑ t p ʌ r
тӑрӑшаттӑм	t ʌ r ʌ ʃ ɑ tː ʌ m
тӑрӑшатӑп	t ʌ r ʌ ʃ ɑ t ʌ p
тӑрӑшаҫҫӗ	t ʌ r ʌ ʃ ɑ ɕː ɛ
тӑрӑшмасан	t ʌ r ʌ ʃ m ɑ s ɑ n
тӑрӑшнипех	t ʌ r ʌ ʃ n i p e χ
тӑрӑшнӑ	t ʌ r ʌ ʃ n ʌ
тӑрӑшса	t ʌ r ʌ ʃ s ɑ
тӑрӑшуллӑ	t ʌ r ʌ ʃ u lː ʌ
тӑрӑшӑва	t ʌ r ʌ ʃ ʌ v ɑ
тӑрӑшӑр	t ʌ r ʌ ʃ ʌ r
тӑрӑшӗҫ	t ʌ r ʌ ʃ ɛ ɕ
тӑрӗ	t ʌ r ɛ
тӑрӗҫ	t ʌ r ɛ ɕ
тӑсакан	t ʌ s ɑ k ɑ n
тӑсасшӑн	t ʌ s ɑ s ʃ ʌ n
тӑсаҫҫӗ	t ʌ s ɑ ɕː ɛ
тӑсмасӑр	t ʌ s m ɑ s ʌ r
тӑсмашкӑн	t ʌ s m ɑ ʃ k ʌ n
тӑснӑ	t ʌ s n ʌ
тӑсса	t ʌ sː ɑ
тӑсӑласси	t ʌ s ʌ l ɑ sː i
тӑсӑлать	t ʌ s ʌ l ɑ t
тӑсӑлнӑ	t ʌ s ʌ l n ʌ
тӑсӑлчӗ	t ʌ s ʌ l tʃ ɛ
тӑсӑлӗ	t ʌ s ʌ l ɛ
тӑтӑш	t ʌ t ʌ ʃ
тӑтӑшах	t ʌ t ʌ ʃ ɑ χ
тӑхта	t ʌ χ t ɑ
тӑхтамалла	t ʌ χ t ɑ m ɑ lː ɑ
тӑхтамасӑр	t ʌ χ t ɑ m ɑ s ʌ r
тӑхтанӑ	t ʌ χ t ɑ n ʌ
тӑхтаса	t ʌ χ t ɑ s ɑ
тӑххӑр	t ʌ χː ʌ r
тӑхӑнаҫҫӗ	t ʌ χ ʌ n ɑ ɕː ɛ
тӑхӑнма	t ʌ χ ʌ n m ɑ
тӑхӑнман	t ʌ χ ʌ n m ɑ n
тӑхӑннӑ	t ʌ χ ʌ nː ʌ
тӑхӑннӑскере	t ʌ χ ʌ nː ʌ s k e r e
тӑхӑнтаратаҫҫӗ	t ʌ χ ʌ n t ɑ r ɑ t ɑ ɕː ɛ
тӑхӑнтартнӑ	t ʌ χ ʌ n t ɑ r t n ʌ
тӑччӑр	t ʌ tʃ tʃ ʌ r
тӑчӗ	t ʌ tʃ ɛ
тӑшман	t ʌ ʃ m ɑ n
тӑшмансенчен	t ʌ ʃ m ɑ n s e n tʃ e n
тӑшманӗ	t ʌ ʃ m ɑ n ɛ
тӗв	t ɛ v
тӗве	t ɛ v e
тӗвӗленнӗ	t ɛ v ɛ l e nː ɛ
тӗк	t ɛ k
тӗккелешекенсем	t ɛ kː e l e ʃ e k e n s e m
тӗксӗм	t ɛ k s ɛ m
тӗксӗм-хӑмӑр	t ɛ k s ɛ m χ ʌ m ʌ r
тӗксӗмленсе	t ɛ k s ɛ m l e n s e
тӗксӗмччӗ	t ɛ k s ɛ m tʃ tʃ ɛ
тӗкӗр	t ɛ k ɛ r
тӗл	t ɛ l
тӗл-тӗл	t ɛ l t ɛ l
тӗллев	t ɛ lː e v
тӗллеве	t ɛ lː e v e
тӗллевлемен-ха	t ɛ lː e v l e m e n χ ɑ
тӗллевлерӗм	t ɛ lː e v l e r ɛ m
тӗллевлерӗр	t ɛ lː e v l e r ɛ r
тӗллевлисемшӗн	t ɛ lː e v l i s e m ʃ ɛ n
тӗллевлӗ	t ɛ lː e v l ɛ
тӗллевне	t ɛ lː e v n e
тӗллевпе	t ɛ lː e v p e
тӗллевсене	t ɛ lː e v s e n e
тӗллевсенчен	t ɛ lː e v s e n tʃ e n
тӗллевӗллӗ	t ɛ lː e v ɛ lː ɛ
тӗллевӗнчен	t ɛ lː e v ɛ n tʃ e n
тӗлленӗ	t ɛ lː e n ɛ
тӗлне	t ɛ l n e
тӗлпулу	t ɛ l p u l u
тӗлпулура	t ɛ l p u l u r ɑ
тӗлӗк	t ɛ l ɛ k
тӗлӗнер	t ɛ l ɛ n e r
тӗлӗнмелле	t ɛ l ɛ n m e lː e
тӗлӗнмерӗ	t ɛ l ɛ n m e r ɛ
тӗлӗнсе	t ɛ l ɛ n s e
тӗлӗнсех	t ɛ l ɛ n s e χ
тӗлӗнтернӗ	t ɛ l ɛ n t e r n ɛ
тӗлӗнтерчӗ	t ɛ l ɛ n t e r tʃ ɛ
тӗлӗнтӗп	t ɛ l ɛ n t ɛ p
тӗлӗнчи	t ɛ l ɛ n tʃ i
тӗлӗшпе	t ɛ l ɛ ʃ p e
тӗлӗшӗнчен	t ɛ l ɛ ʃ ɛ n tʃ e n
тӗмшерте	t ɛ m ʃ e r t e
тӗмӗ	t ɛ m ɛ
тӗмӗсем	t ɛ m ɛ s e m
тӗнче	t ɛ n tʃ e
тӗнчене	t ɛ n tʃ e n e
тӗнчере	t ɛ n tʃ e r e
тӗнчери	t ɛ n tʃ e r i
тӗнчипех	t ɛ n tʃ i p e χ
тӗп	t ɛ p
тӗпе	t ɛ p e
тӗпленме	t ɛ p l e n m e
тӗпленччӗр	t ɛ p l e n tʃ tʃ ɛ r
тӗплӗ	t ɛ p l ɛ
тӗплӗн	t ɛ p l ɛ n
тӗплӗнрех	t ɛ p l ɛ n r e χ
тӗпрен	t ɛ p r e n
тӗпренчӗкӗсем	t ɛ p r e n tʃ ɛ k ɛ s e m
тӗпчев	t ɛ p tʃ e v
тӗпчеве	t ɛ p tʃ e v e
тӗпчевҫӗсем	t ɛ p tʃ e v ɕ ɛ s e m
тӗпчесе	t ɛ p tʃ e s e
тӗпчет	t ɛ p tʃ e t
тӗпчеҫҫӗ	t ɛ p tʃ e ɕː ɛ
тӗпӗ	t ɛ p ɛ
тӗрев	t ɛ r e v
тӗрлеҫҫӗ	t ɛ r l e ɕː ɛ
тӗрлӗ	t ɛ r l ɛ
тӗрмерен	t ɛ r m e r e n
тӗртмелли	t ɛ r t m e lː i
тӗртсе	t ɛ r ts e
тӗрӗ	t ɛ r ɛ
тӗрӗпе	t ɛ r ɛ p e
тӗрӗс	t ɛ r ɛ s
тӗрӗс-тӗкел	t ɛ r ɛ s t ɛ k e l
тӗрӗсех	t ɛ r ɛ s e χ
тӗрӗслев	t ɛ r ɛ s l e v
тӗрӗслеве	t ɛ r ɛ s l e v e
тӗрӗслевпе	t ɛ r ɛ s l e v p e
тӗрӗслевӗ	t ɛ r ɛ s l e v ɛ
тӗрӗслемелле	t ɛ r ɛ s l e m e lː e
тӗрӗслени	t ɛ r ɛ s l e n i
тӗрӗсленме	t ɛ r ɛ s l e n m e
тӗрӗсленсе	t ɛ r ɛ s l e n s e
тӗрӗсленӗ	t ɛ r ɛ s l e n ɛ
тӗрӗслерӗ	t ɛ r ɛ s l e r ɛ
тӗрӗслесе	t ɛ r ɛ s l e s e
тӗрӗслеҫҫӗ	t ɛ r ɛ s l e ɕː ɛ
тӗрӗслӗр	t ɛ r ɛ s l ɛ r
тӗрӗсрех	t ɛ r ɛ s r e χ
тӗрӗссипе	t ɛ r ɛ sː i p e
тӗслӗ	t ɛ s l ɛ
тӗслӗн	t ɛ s l ɛ n
тӗслӗх	t ɛ s l ɛ χ
тӗслӗхпе	t ɛ s l ɛ χ p e
тӗслӗхрен	t ɛ s l ɛ χ r e n
тӗслӗхсем	t ɛ s l ɛ χ s e m
тӗслӗхсене	t ɛ s l ɛ χ s e n e
тӗслӗхӗ	t ɛ s l ɛ χ ɛ
тӗсне	t ɛ s n e
тӗссӗрленнӗ	t ɛ sː ɛ r l e nː ɛ
тӗсӗ	t ɛ s ɛ
тӗсӗнче	t ɛ s ɛ n tʃ e
тӗсӗсемпе	t ɛ s ɛ s e m p e
тӗттӗм	t ɛ tː ɛ m
тӗттӗмрех	t ɛ tː ɛ m r e χ
тӗшмӗшле	t ɛ ʃ m ɛ ʃ l e
тӗшӗрӗлсе	t ɛ ʃ ɛ r ɛ l s e
тӳлевлӗ	t y l e v l ɛ
тӳлевсӗр	t y l e v s ɛ r
тӳлевсӗрех	t y l e v s ɛ r e χ
тӳлеме	t y l e m e
тӳлемен	t y l e m e n
тӳлемех	t y l e m e χ
тӳлесе	t y l e s e
тӳлетпӗр	t y l e t p ɛ r
тӳлеттерме	t y l e tː e r m e
тӳлеҫҫӗ	t y l e ɕː ɛ
тӳминчен	t y m i n tʃ e n
тӳпе	t y p e
тӳпене	t y p e n e
тӳперен	t y p e r e n
тӳре-шара	t y r e ʃ ɑ r ɑ
тӳре-шарана	t y r e ʃ ɑ r ɑ n ɑ
тӳре-шарапа	t y r e ʃ ɑ r ɑ p ɑ
тӳресен	t y r e s e n
тӳрех	t y r e χ
тӳрккессӗн	t y r kː e sː ɛ n
тӳрленчӗ	t y r l e n tʃ ɛ
тӳрлетӳсем	t y r l e t y s e m
тӳрре	t y rː e
тӳрремӗн	t y rː e m ɛ n
тӳрӗ	t y r ɛ
тӳсрӗ	t y s r ɛ
уголовлӑ	u g o l o v l ʌ
удмурт	u d m u r t
уй	u j
уй-хирти	u j χ i r t i
уйра	u j r ɑ
уйрӑласшӑн	u j r ʌ l ɑ s ʃ ʌ n
уйрӑлман	u j r ʌ l m ɑ n
уйрӑлнӑ	u j r ʌ l n ʌ
уйрӑлчӗҫ	u j r ʌ l tʃ ɛ ɕ
уйрӑм	u j r ʌ m
уйрӑма	u j r ʌ m ɑ
уйрӑмах	u j r ʌ m ɑ χ
уйрӑммӑн	u j r ʌ mː ʌ n
уйрӑмне	u j r ʌ m n e
уйрӑмпа	u j r ʌ m p ɑ
уйрӑмсем	u j r ʌ m s e m
уйрӑмӗ	u j r ʌ m ɛ
уйрӑмӗнче	u j r ʌ m ɛ n tʃ e
уйсенче	u j s e n tʃ e
уйӑрать	u j ʌ r ɑ t
уйӑраяс	u j ʌ r ɑ j ɑ s
уйӑрма	u j ʌ r m ɑ
уйӑрнӑ	u j ʌ r n ʌ
уйӑрса	u j ʌ r s ɑ
уйӑрчӗ	u j ʌ r tʃ ɛ
уйӑрӗҫ	u j ʌ r ɛ ɕ
уйӑх	u j ʌ χ
уйӑхран	u j ʌ χ r ɑ n
уйӑхсерен	u j ʌ χ s e r e n
уйӑхӗ	u j ʌ χ ɛ
уйӑхӗн	u j ʌ χ ɛ n
уйӑхӗнче	u j ʌ χ ɛ n tʃ e
уйӑхӗнчен	u j ʌ χ ɛ n tʃ e n
уйӑхӗнченпех	u j ʌ χ ɛ n tʃ e n p e χ
уйӑхӗнчех	u j ʌ χ ɛ n tʃ e χ
уйӑхӗнчи	u j ʌ χ ɛ n tʃ i
уйӑхӗсенче	u j ʌ χ ɛ s e n tʃ e
уйӑхӗччен	u j ʌ χ ɛ tʃ tʃ e n
укроп	u k r o p
уксус	u k s u s
укҫа	u k ɕ ɑ
укҫа-тенке	u k ɕ ɑ t e n k e
укҫа-тенкӗ	u k ɕ ɑ t e n k ɛ
укҫа-тенкӗпе	u k ɕ ɑ t e n k ɛ p e
укҫан	u k ɕ ɑ n
укҫана	u k ɕ ɑ n ɑ
укҫапа	u k ɕ ɑ p ɑ
укҫасем	u k ɕ ɑ s e m
укҫасене	u k ɕ ɑ s e n e
укҫасӑр	u k ɕ ɑ s ʌ r
укҫашӑн	u k ɕ ɑ ʃ ʌ n
укҫи	u k ɕ i
укҫине	u k ɕ i n e
улатӑр	u l ɑ t ʌ r
улатӑрта	u l ɑ t ʌ r t ɑ
улатӑрти	u l ɑ t ʌ r t i
улма-ҫырлана	u l m ɑ ɕ ɯ r l ɑ n ɑ
улми	u l m i
улмие	u l m i e
улмуҫҫи	u l m u ɕː i
ултав	u l t ɑ v
ултавҫӑсене	u l t ɑ v ɕ ʌ s e n e
улталакан	u l t ɑ l ɑ k ɑ n
улталаса	u l t ɑ l ɑ s ɑ
улттӑ	u l tː ʌ
улттӑри	u l tː ʌ r i
ултӑ	u l t ʌ
улшӑнать	u l ʃ ʌ n ɑ t
улшӑннине	u l ʃ ʌ nː i n e
улшӑннӑ	u l ʃ ʌ nː ʌ
улшӑнса	u l ʃ ʌ n s ɑ
улшӑну	u l ʃ ʌ n u
улшӑнусем	u l ʃ ʌ n u s e m
улшӑнчӗ	u l ʃ ʌ n tʃ ɛ
улшӑнӑва	u l ʃ ʌ n ʌ v ɑ
улшӑнӑвӗ	u l ʃ ʌ n ʌ v ɛ
улшӑнӗ	u l ʃ ʌ n ɛ
ульянӑн	u l j ɑ n ʌ n
улӑп	u l ʌ p
улӑх-ҫарана	u l ʌ χ ɕ ɑ r ɑ n ɑ
улӑштарас	u l ʌ ʃ t ɑ r ɑ s
улӑштараҫҫӗ	u l ʌ ʃ t ɑ r ɑ ɕː ɛ
улӑштарма	u l ʌ ʃ t ɑ r m ɑ
умне	u m n e
умра	u m r ɑ
умран	u m r ɑ n
умӗн	u m ɛ n
умӗнче	u m ɛ n tʃ e
умӗнчен	u m ɛ n tʃ e n
умӗнчи	u m ɛ n tʃ i
ун	u n
унашкал	u n ɑ ʃ k ɑ l
унашкалли	u n ɑ ʃ k ɑ lː i
университета	u n i v e r s i t e t ɑ
университетра	u n i v e r s i t e t r ɑ
университечӗ	u n i v e r s i t e tʃ ɛ
униче	u n i tʃ e
унпа	u n p ɑ
унран	u n r ɑ n
унсӑр	u n s ʌ r
унсӑрӑн	u n s ʌ r ʌ n
унта	u n t ɑ
унталла	u n t ɑ lː ɑ
унталла-кунталла	u n t ɑ lː ɑ k u n t ɑ lː ɑ
унтан	u n t ɑ n
унтанпа	u n t ɑ n p ɑ
унтах	u n t ɑ χ
унти	u n t i
унтисем	u n t i s e m
унччен	u n tʃ tʃ e n
унчченхи	u n tʃ tʃ e n χ i
уншӑнах	u n ʃ ʌ n ɑ χ
унӑн	u n ʌ n
упаленсе	u p ɑ l e n s e
управлени	u p r ɑ v l e n i
управленийӗ	u p r ɑ v l e n i j ɛ
управленине	u p r ɑ v l e n i n e
упрамалла	u p r ɑ m ɑ lː ɑ
упрамалли	u p r ɑ m ɑ lː i
упрамаллине	u p r ɑ m ɑ lː i n e
упрамашкӑн	u p r ɑ m ɑ ʃ k ʌ n
упранакан	u p r ɑ n ɑ k ɑ n
упранӑ	u p r ɑ n ʌ
упраса	u p r ɑ s ɑ
упӑшка	u p ʌ ʃ k ɑ
упӑшки	u p ʌ ʃ k i
упӑшкине	u p ʌ ʃ k i n e
упӑшкисен	u p ʌ ʃ k i s e n
упӑшкисене	u p ʌ ʃ k i s e n e
ура	u r ɑ
урайне	u r ɑ j n e
ураллӑ	u r ɑ lː ʌ
урам	u r ɑ m
урама	u r ɑ m ɑ
урамра	u r ɑ m r ɑ
урамрах	u r ɑ m r ɑ χ
урамсемпе	u r ɑ m s e m p e
урамӗ	u r ɑ m ɛ
урамӗнчи	u r ɑ m ɛ n tʃ i
ураскилтре	u r ɑ s k i l t r e
ураскильт	u r ɑ s k i l t
урасӑр	u r ɑ s ʌ r
урине	u r i n e
уринене	u r i n e n e
уринче	u r i n tʃ e
урлӑ	u r l ʌ
урок	u r o k
урока	u r o k ɑ
уроксене	u r o k s e n e
урокӗсене	u r o k ɛ s e n e
урпа	u r p ɑ
уртаракан	u r t ɑ r ɑ k ɑ n
урхан	u r χ ɑ n
урӑр	u r ʌ r
урӑх	u r ʌ χ
урӑхларах	u r ʌ χ l ɑ r ɑ χ
усал	u s ɑ l
усламҫӑпа	u s l ɑ m ɕ ʌ p ɑ
условисем	u s l o v i s e m
усман	u s m ɑ n
усмарӗ-ха	u s m ɑ r ɛ χ ɑ
усрав	u s r ɑ v
усрама	u s r ɑ m ɑ
усрамалла	u s r ɑ m ɑ lː ɑ
усрасси	u s r ɑ sː i
усса	u sː ɑ
усси	u sː i
устармасть	u s t ɑ r m ɑ s t
усӑ	u s ʌ
усӑллӑ	u s ʌ lː ʌ
усӑнчӗҫ	u s ʌ n tʃ ɛ ɕ
усӑсӑр	u s ʌ s ʌ r
утаймаҫҫӗ	u t ɑ j m ɑ ɕː ɛ
утасшӑн	u t ɑ s ʃ ʌ n
утать	u t ɑ t
утилиэацилӗр	u t i l i e ɑ ts i l ɛ r
утма	u t m ɑ
утнӑ	u t n ʌ
утрӑм	u t r ʌ m
утрӗ	u t r ɛ
утса	u ts ɑ
утта	u tː ɑ
уттарчӗ	u tː ɑ r tʃ ɛ
утюгшӑн	u t j u g ʃ ʌ n
утӑ	u t ʌ
утӑ-улӑм	u t ʌ u l ʌ m
утӑма	u t ʌ m ɑ
утӑмран	u t ʌ m r ɑ n
ухмах	u χ m ɑ χ
участковӑйсем	u tʃ ɑ s t k o v ʌ j s e m
участковӑйӗ	u tʃ ɑ s t k o v ʌ j ɛ
училишинче	u tʃ i l i ʃ i n tʃ e
учительницӑна	u tʃ i t e l n i ts ʌ n ɑ
учительсене	u tʃ i t e l s e n e
учителӗ	u tʃ i t e l ɛ
учреждение	u tʃ r e ʒ d e n i e
учрежденийӗсене	u tʃ r e ʒ d e n i j ɛ s e n e
учрежденине	u tʃ r e ʒ d e n i n e
учрежденисемпе	u tʃ r e ʒ d e n i s e m p e
учрежеденийӗсене	u tʃ r e ʒ e d e n i j ɛ s e n e
ушкӑн	u ʃ k ʌ n
ушкӑна	u ʃ k ʌ n ɑ
ушкӑнне	u ʃ k ʌ nː e
ушкӑнра	u ʃ k ʌ n r ɑ
ушкӑнрах	u ʃ k ʌ n r ɑ χ
ушкӑнсен	u ʃ k ʌ n s e n
ушкӑнӗ	u ʃ k ʌ n ɛ
ушкӑнӗн	u ʃ k ʌ n ɛ n
ушкӑнӗсем	u ʃ k ʌ n ɛ s e m
ушкӑнӗсенче	u ʃ k ʌ n ɛ s e n tʃ e
уэбекистанри	u e b e k i s t ɑ n r i
уя	u j ɑ
уяв	u j ɑ v
уяв-мероприяти	u j ɑ v m e r o p r i j ɑ t i
уява	u j ɑ v ɑ
уявне	u j ɑ v n e
уявра	u j ɑ v r ɑ
уявӑн	u j ɑ v ʌ n
уявӗ	u j ɑ v ɛ
уҫланкине	u ɕ l ɑ n k i n e
уҫма	u ɕ m ɑ
уҫнӑ	u ɕ n ʌ
уҫрӑм	u ɕ r ʌ m
уҫрӑмӑр	u ɕ r ʌ m ʌ r
уҫрӗ	u ɕ r ɛ
уҫса	u ɕ s ɑ
уҫсан	u ɕ s ɑ n
уҫӑ	u ɕ ʌ
уҫӑлма	u ɕ ʌ l m ɑ
уҫӑлмалла	u ɕ ʌ l m ɑ lː ɑ
уҫӑлни	u ɕ ʌ l n i
уҫӑлнӑ	u ɕ ʌ l n ʌ
уҫӑлса	u ɕ ʌ l s ɑ
уҫӑлсан	u ɕ ʌ l s ɑ n
уҫӑлтарма	u ɕ ʌ l t ɑ r m ɑ
уҫӑлчӗ	u ɕ ʌ l tʃ ɛ
уҫӑлӗ	u ɕ ʌ l ɛ
уҫӑмлатасси	u ɕ ʌ m l ɑ t ɑ sː i
уҫӑмлатаҫҫӗ	u ɕ ʌ m l ɑ t ɑ ɕː ɛ
уҫӑмлатма	u ɕ ʌ m l ɑ t m ɑ
уҫӑмлатӗҫ	u ɕ ʌ m l ɑ t ɛ ɕ
уҫӗҫ	u ɕ ɛ ɕ
фабрикӑна	f ɑ b r i k ʌ n ɑ
факультетӗнчен	f ɑ k u l t e t ɛ n tʃ e n
фанкциллӗ	f ɑ n k ts i lː ɛ
фанфурик	f ɑ n f u r i k
фанфурике	f ɑ n f u r i k e
фарук	f ɑ r u k
фасада	f ɑ s ɑ d ɑ
федералсем	f e d e r ɑ l s e m
федераци	f e d e r ɑ ts i
фельдшерсем	f e l d ʃ e r s e m
фенри	f e n r i
фергана	f e r g ɑ n ɑ
ферганари	f e r g ɑ n ɑ r i
фермер	f e r m e r
фермипе	f e r m i p e
фермӑна	f e r m ʌ n ɑ
фестиваль	f e s t i v ɑ l
фестивальне	f e s t i v ɑ l n e
фестивальсенчен	f e s t i v ɑ l s e n tʃ e n
фестивальте	f e s t i v ɑ l t e
фестивальтен	f e s t i v ɑ l t e n
фестивалӗ	f e s t i v ɑ l ɛ
филиал	f i l i ɑ l
фильм	f i l m
фильма	f i l m ɑ
фильмри	f i l m r i
фильмсем	f i l m s e m
фильмсене	f i l m s e n e
фильмӗнче	f i l m ɛ n tʃ e
финал	f i n ɑ l
финалне	f i n ɑ l n e
финанс	f i n ɑ n s
фирмӑра	f i r m ʌ r ɑ
фиэика	f i e i k ɑ
фиэикӑпа	f i e i k ʌ p ɑ
фляжкӑсенчи	f l j ɑ ʒ k ʌ s e n tʃ i
фойинче	f o j i n tʃ e
фолликулне	f o lː i k u l n e
фончӗ	f o n tʃ ɛ
форма	f o r m ɑ
формат	f o r m ɑ t
фортепьяно	f o r t e p j ɑ n o
форумра	f o r u m r ɑ
фотоаппарат	f o t o ɑ pː ɑ r ɑ t
фотограф	f o t o g r ɑ f
фреэеровшикре	f r e e e r o v ʃ i k r e
фристайлҫӑсене	f r i s t ɑ j l ɕ ʌ s e n e
фронтри	f r o n t r i
фрончӗн	f r o n tʃ ɛ n
функциллӗ	f u n k ts i lː ɛ
функцисемпе	f u n k ts i s e m p e
футбол	f u t b o l
футболистсен	f u t b o l i s ts e n
хаваслӑ	χ ɑ v ɑ s l ʌ
хаваслӑн	χ ɑ v ɑ s l ʌ n
хаваспах	χ ɑ v ɑ s p ɑ χ
хавхалантарать	χ ɑ v χ ɑ l ɑ n t ɑ r ɑ t
хавхалантараҫҫӗ	χ ɑ v χ ɑ l ɑ n t ɑ r ɑ ɕː ɛ
хавхалантарма	χ ɑ v χ ɑ l ɑ n t ɑ r m ɑ
хавхалантармалли	χ ɑ v χ ɑ l ɑ n t ɑ r m ɑ lː i
хавхалантарчӗ	χ ɑ v χ ɑ l ɑ n t ɑ r tʃ ɛ
хавхалантарӑва	χ ɑ v χ ɑ l ɑ n t ɑ r ʌ v ɑ
хавхалантарӗ	χ ɑ v χ ɑ l ɑ n t ɑ r ɛ
хавхалану	χ ɑ v χ ɑ l ɑ n u
хавхаланӑвне	χ ɑ v χ ɑ l ɑ n ʌ v n e
хавшаккине	χ ɑ v ʃ ɑ kː i n e
хавшарӗ	χ ɑ v ʃ ɑ r ɛ
хайлавпа	χ ɑ j l ɑ v p ɑ
хайланӑ	χ ɑ j l ɑ n ʌ
хайхи	χ ɑ j χ i
хайхискер	χ ɑ j χ i s k e r
хайхискерсем	χ ɑ j χ i s k e r s e m
хайхискерсене	χ ɑ j χ i s k e r s e n e
хак	χ ɑ k
хака	χ ɑ k ɑ
хакалава	χ ɑ k ɑ l ɑ v ɑ
хаклавсемпе	χ ɑ k l ɑ v s e m p e
хакларӗҫ	χ ɑ k l ɑ r ɛ ɕ
хакласан	χ ɑ k l ɑ s ɑ n
хаклать	χ ɑ k l ɑ t
хаклаҫҫӗ	χ ɑ k l ɑ ɕː ɛ
хакли	χ ɑ k l i
хаклӑ	χ ɑ k l ʌ
хакне	χ ɑ k n e
хаксене	χ ɑ k s e n e
хакӗ	χ ɑ k ɛ
хакӗсемпе	χ ɑ k ɛ s e m p e
халалланӑ	χ ɑ l ɑ lː ɑ n ʌ
халалне	χ ɑ l ɑ l n e
халах	χ ɑ l ɑ χ
халех	χ ɑ l e χ
халиччен	χ ɑ l i tʃ tʃ e n
халичченхинчен	χ ɑ l i tʃ tʃ e n χ i n tʃ e n
халь	χ ɑ l
хальлӗхе	χ ɑ lː ɛ χ e
хальхи	χ ɑ l χ i
хальхинче	χ ɑ l χ i n tʃ e
халӑх	χ ɑ l ʌ χ
халӑха	χ ɑ l ʌ χ ɑ
халӑхпа	χ ɑ l ʌ χ p ɑ
халӑхран	χ ɑ l ʌ χ r ɑ n
халӑхсен	χ ɑ l ʌ χ s e n
халӑхсене	χ ɑ l ʌ χ s e n e
халӑхшӑн	χ ɑ l ʌ χ ʃ ʌ n
халӑхӑм	χ ɑ l ʌ χ ʌ m
халӑхӑн	χ ɑ l ʌ χ ʌ n
халӑхӗ	χ ɑ l ʌ χ ɛ
халӑхӗнчен	χ ɑ l ʌ χ ɛ n tʃ e n
халӑхӗшӗн	χ ɑ l ʌ χ ɛ ʃ ɛ n
халӗ	χ ɑ l ɛ
хам	χ ɑ m
хама	χ ɑ m ɑ
хамах	χ ɑ m ɑ χ
хампа	χ ɑ m p ɑ
хамӑн	χ ɑ m ʌ n
хамӑр	χ ɑ m ʌ r
хамӑра	χ ɑ m ʌ r ɑ
хамӑртан	χ ɑ m ʌ r t ɑ n
хамӑрӑн	χ ɑ m ʌ r ʌ n
хапрӑкӗнчи	χ ɑ p r ʌ k ɛ n tʃ i
хапха	χ ɑ p χ ɑ
хапхасем	χ ɑ p χ ɑ s e m
хапӑл	χ ɑ p ʌ l
хапӑлласах	χ ɑ p ʌ lː ɑ s ɑ χ
харпӑр	χ ɑ r p ʌ r
харпӑрлӑхне	χ ɑ r p ʌ r l ʌ χ n e
харсӑррисене	χ ɑ r s ʌ rː i s e n e
хастар	χ ɑ s t ɑ r
хастарлӑхӗпе	χ ɑ s t ɑ r l ʌ χ ɛ p e
хастарсем	χ ɑ s t ɑ r s e m
хастарсен	χ ɑ s t ɑ r s e n
хастарӗсем	χ ɑ s t ɑ r ɛ s e m
хастарӗсене	χ ɑ s t ɑ r ɛ s e n e
хастарӗсенчен	χ ɑ s t ɑ r ɛ s e n tʃ e n
хатӗр	χ ɑ t ɛ r
хатӗр-хӗтӗрпе	χ ɑ t ɛ r χ ɛ t ɛ r p e
хатӗр-ҫке	χ ɑ t ɛ r ɕ k e
хатӗре	χ ɑ t ɛ r e
хатӗрлемелле	χ ɑ t ɛ r l e m e lː e
хатӗрлемешкӗн	χ ɑ t ɛ r l e m e ʃ k ɛ n
хатӗрленет	χ ɑ t ɛ r l e n e t
хатӗрленеттӗм	χ ɑ t ɛ r l e n e tː ɛ m
хатӗрленеҫҫӗ	χ ɑ t ɛ r l e n e ɕː ɛ
хатӗрленипе	χ ɑ t ɛ r l e n i p e
хатӗрленисӗр	χ ɑ t ɛ r l e n i s ɛ r
хатӗрленме	χ ɑ t ɛ r l e n m e
хатӗрленнессипе	χ ɑ t ɛ r l e nː e sː i p e
хатӗрленнӗ	χ ɑ t ɛ r l e nː ɛ
хатӗрленӗ	χ ɑ t ɛ r l e n ɛ
хатӗрленӳ	χ ɑ t ɛ r l e n y
хатӗрлесе	χ ɑ t ɛ r l e s e
хатӗрлеҫҫӗ	χ ɑ t ɛ r l e ɕː ɛ
хатӗрлӗҫ	χ ɑ t ɛ r l ɛ ɕ
хатӗрсем	χ ɑ t ɛ r s e m
хатӗрсемпе	χ ɑ t ɛ r s e m p e
хатӗрччӗ	χ ɑ t ɛ r tʃ tʃ ɛ
хатӗрӗ	χ ɑ t ɛ r ɛ
хатӗрӗн	χ ɑ t ɛ r ɛ n
хатӗрӗсем	χ ɑ t ɛ r ɛ s e m
хатӗрӗсене	χ ɑ t ɛ r ɛ s e n e
хаш	χ ɑ ʃ
хаяр	χ ɑ j ɑ r
хаяррине	χ ɑ j ɑ rː i n e
хаяррӑн	χ ɑ j ɑ rː ʌ n
хаҫат	χ ɑ ɕ ɑ t
хаҫатӑн	χ ɑ ɕ ɑ t ʌ n
хваттер	χ v ɑ tː e r
хваттере	χ v ɑ tː e r e
хваттерлӗ	χ v ɑ tː e r l ɛ
хваттерне	χ v ɑ tː e r n e
хваттерпе	χ v ɑ tː e r p e
хваттерте	χ v ɑ tː e r t e
хваттерти	χ v ɑ tː e r t i
хевешски	χ e v e ʃ s k i
хими	χ i m i
химик	χ i m i k
химиотерапи	χ i m i o t e r ɑ p i
химипе	χ i m i p e
химпромран	χ i m p r o m r ɑ n
хир	χ i r
хирте	χ i r t e
хирург	χ i r u r g
хирӗлме	χ i r ɛ l m e
хирӗнче	χ i r ɛ n tʃ e
хирӗҫ	χ i r ɛ ɕ
хирӗҫлемерӗ	χ i r ɛ ɕ l e m e r ɛ
хирӗҫленӗ	χ i r ɛ ɕ l e n ɛ
хирӗҫлетӳ	χ i r ɛ ɕ l e t y
хирӗҫлеҫҫӗ	χ i r ɛ ɕ l e ɕː ɛ
хирӗҫнӗ	χ i r ɛ ɕ n ɛ
хирӗҫсе	χ i r ɛ ɕ s e
хирӗҫтерме	χ i r ɛ ɕ t e r m e
хирӗҫӳ	χ i r ɛ ɕ y
хисеплемеллине	χ i s e p l e m e lː i n e
хисеплемеҫҫӗ	χ i s e p l e m e ɕː ɛ
хисеплет	χ i s e p l e t
хисеплеҫҫӗ	χ i s e p l e ɕː ɛ
хисеплӗ	χ i s e p l ɛ
хистеместӗп	χ i s t e m e s t ɛ p
хистенипе	χ i s t e n i p e
хистенӗ	χ i s t e n ɛ
хистерӗм	χ i s t e r ɛ m
хистет-ши	χ i s t e tʃ i
хитре	χ i t r e
ходункие	χ o d u n k i e
холодильник	χ o l o d i l n i k
холодильникӗнче	χ o l o d i l n i k ɛ n tʃ e
холоп	χ o l o p
хореографи	χ o r e o g r ɑ f i
хорнсор	χ o r n s o r
хоррорсем	χ o rː o r s e m
храмӑн	χ r ɑ m ʌ n
хрантсусла	χ r ɑ n ts u s l ɑ
хресчен	χ r e s tʃ e n
ху	χ u
художника	χ u d o ʒ n i k ɑ
художникне	χ u d o ʒ n i k n e
художниксен	χ u d o ʒ n i k s e n
хуйхӑран	χ u j χ ʌ r ɑ n
хул-ҫурӑма	χ u l ɕ u r ʌ m ɑ
хула	χ u l ɑ
хулана	χ u l ɑ n ɑ
хулара	χ u l ɑ r ɑ
хуларан	χ u l ɑ r ɑ n
хуларах	χ u l ɑ r ɑ χ
хулари	χ u l ɑ r i
хуларисем	χ u l ɑ r i s e m
хули	χ u l i
хулине	χ u l i n e
хулинче	χ u l i n tʃ e
хулинчен	χ u l i n tʃ e n
хулинчи	χ u l i n tʃ i
хулисем	χ u l i s e m
хулисенчи	χ u l i s e n tʃ i
хулла	χ u lː ɑ
хулпуҫҫирен	χ u l p u ɕː i r e n
хулӑн	χ u l ʌ n
хулӑнӑшех	χ u l ʌ n ʌ ʃ e χ
хума	χ u m ɑ
хумханчӗ	χ u m χ ɑ n tʃ ɛ
хунавсене	χ u n ɑ v s e n e
хуни	χ u n i
хунямӑшне	χ u n j ɑ m ʌ ʃ n e
хунямӑшӗ	χ u n j ɑ m ʌ ʃ ɛ
хунӑ	χ u n ʌ
хунӑ-ши	χ u n ʌ ʃ i
хунӑччӗ	χ u n ʌ tʃ tʃ ɛ
хуп	χ u p
хуп-хура	χ u p χ u r ɑ
хупах	χ u p ɑ χ
хупаҫҫӗ-ха	χ u p ɑ ɕː ɛ χ ɑ
хуплайман	χ u p l ɑ j m ɑ n
хуплама	χ u p l ɑ m ɑ
хуплансан	χ u p l ɑ n s ɑ n
хупланӑ	χ u p l ɑ n ʌ
хупласа	χ u p l ɑ s ɑ
хупман	χ u p m ɑ n
хупнӑ	χ u p n ʌ
хуппинчен	χ u pː i n tʃ e n
хупса	χ u p s ɑ
хупсан	χ u p s ɑ n
хупӑнни	χ u p ʌ nː i
хупӑннипе	χ u p ʌ nː i p e
хура	χ u r ɑ
хуравлаймарӗҫ	χ u r ɑ v l ɑ j m ɑ r ɛ ɕ
хуравлаканччӗ	χ u r ɑ v l ɑ k ɑ n tʃ tʃ ɛ
хуравларӗ	χ u r ɑ v l ɑ r ɛ
хуравлас	χ u r ɑ v l ɑ s
хурал	χ u r ɑ l
хуралне	χ u r ɑ l n e
хуралтӑ	χ u r ɑ l t ʌ
хуралтӑ-витене	χ u r ɑ l t ʌ v i t e n e
хуралтӑсем	χ u r ɑ l t ʌ s e m
хуралтӑсене	χ u r ɑ l t ʌ s e n e
хуралҫисем	χ u r ɑ l ɕ i s e m
хуралҫисене	χ u r ɑ l ɕ i s e n e
хуралҫисенчен	χ u r ɑ l ɕ i s e n tʃ e n
хуралҫӑ	χ u r ɑ l ɕ ʌ
хуралҫӑна	χ u r ɑ l ɕ ʌ n ɑ
хуралҫӑсем	χ u r ɑ l ɕ ʌ s e m
хуралҫӑсемпе	χ u r ɑ l ɕ ʌ s e m p e
хуранӗпе	χ u r ɑ n ɛ p e
хурать	χ u r ɑ t
хуриччен	χ u r i tʃ tʃ e n
хурлан	χ u r l ɑ n
хурланнипе	χ u r l ɑ nː i p e
хурланса	χ u r l ɑ n s ɑ
хурлӑхлӑ	χ u r l ʌ χ l ʌ
хурса	χ u r s ɑ
хурҫҫӗ	χ u r ɕː ɛ
хурӑн	χ u r ʌ n
хусан	χ u s ɑ n
хусана	χ u s ɑ n ɑ
хусах	χ u s ɑ χ
хускалмасӑр	χ u s k ɑ l m ɑ s ʌ r
хусканусем	χ u s k ɑ n u s e m
хускатнӑ	χ u s k ɑ t n ʌ
хускатрӑм	χ u s k ɑ t r ʌ m
хускатсан	χ u s k ɑ ts ɑ n
хут	χ u t
хута	χ u t ɑ
хутар	χ u t ɑ r
хутара	χ u t ɑ r ɑ
хутаҫ	χ u t ɑ ɕ
хутаҫа	χ u t ɑ ɕ ɑ
хутлӑ	χ u t l ʌ
хутне	χ u t n e
хутпа	χ u t p ɑ
хутра	χ u t r ɑ
хутран-ситрен	χ u t r ɑ n s i t r e n
хутса	χ u ts ɑ
хутсене	χ u ts e n e
хутчен	χ u t tʃ e n
хутшӑнакан	χ u tʃ ʌ n ɑ k ɑ n
хутшӑнасшӑн	χ u tʃ ʌ n ɑ s ʃ ʌ n
хутшӑнатпӑр	χ u tʃ ʌ n ɑ t p ʌ r
хутшӑнаттӑм	χ u tʃ ʌ n ɑ tː ʌ m
хутшӑнать	χ u tʃ ʌ n ɑ t
хутшӑнатӑп	χ u tʃ ʌ n ɑ t ʌ p
хутшӑнаҫҫӗ	χ u tʃ ʌ n ɑ ɕː ɛ
хутшӑнма	χ u tʃ ʌ n m ɑ
хутшӑннӑ	χ u tʃ ʌ nː ʌ
хутшӑнса	χ u tʃ ʌ n s ɑ
хутшӑнусем	χ u tʃ ʌ n u s e m
хутшӑнусене	χ u tʃ ʌ n u s e n e
хутшӑнӑвӗсем	χ u tʃ ʌ n ʌ v ɛ s e m
хутшӑнӗҫ	χ u tʃ ʌ n ɛ ɕ
хутӑш	χ u t ʌ ʃ
хутӑштармаллине	χ u t ʌ ʃ t ɑ r m ɑ lː i n e
хутӗнче	χ u t ɛ n tʃ e
хучӗ	χ u tʃ ɛ
хушаматӑма	χ u ʃ ɑ m ɑ t ʌ m ɑ
хушма	χ u ʃ m ɑ
хушнӑ	χ u ʃ n ʌ
хушрӗҫ	χ u ʃ r ɛ ɕ
хушу	χ u ʃ u
хушупа	χ u ʃ u p ɑ
хушусем	χ u ʃ u s e m
хушши	χ u ʃː i
хушшине	χ u ʃː i n e
хушшинче	χ u ʃː i n tʃ e
хушшинчи	χ u ʃː i n tʃ i
хушшипе	χ u ʃː i p e
хушӑва	χ u ʃ ʌ v ɑ
хушӑкӗнче	χ u ʃ ʌ k ɛ n tʃ e
хушӑкӗнчен	χ u ʃ ʌ k ɛ n tʃ e n
хушӑнмалла	χ u ʃ ʌ n m ɑ lː ɑ
хушӑнчӗ	χ u ʃ ʌ n tʃ ɛ
хушӑра	χ u ʃ ʌ r ɑ
хушӑран	χ u ʃ ʌ r ɑ n
хуҫаланать	χ u ɕ ɑ l ɑ n ɑ t
хуҫаланаҫҫӗ	χ u ɕ ɑ l ɑ n ɑ ɕː ɛ
хуҫаланни	χ u ɕ ɑ l ɑ nː i
хуҫаланӗ	χ u ɕ ɑ l ɑ n ɛ
хуҫалӑх	χ u ɕ ɑ l ʌ χ
хуҫалӑхра	χ u ɕ ɑ l ʌ χ r ɑ
хуҫалӑхри	χ u ɕ ɑ l ʌ χ r i
хуҫалӑхсем	χ u ɕ ɑ l ʌ χ s e m
хуҫалӑхӑн-мӗн	χ u ɕ ɑ l ʌ χ ʌ n m ɛ n
хуҫана	χ u ɕ ɑ n ɑ
хуҫи	χ u ɕ i
хуҫин	χ u ɕ i n
хуҫисем	χ u ɕ i s e m
хуҫисене	χ u ɕ i s e n e
хуҫланмасть	χ u ɕ l ɑ n m ɑ s t
хуҫмастӑп	χ u ɕ m ɑ s t ʌ p
хуҫнӑ	χ u ɕ n ʌ
хуҫса	χ u ɕ s ɑ
хывас	χ ɯ v ɑ s
хывма	χ ɯ v m ɑ
хывнӑ	χ ɯ v n ʌ
хывнӑшӑн	χ ɯ v n ʌ ʃ ʌ n
хывса	χ ɯ v s ɑ
хыпалансах	χ ɯ p ɑ l ɑ n s ɑ χ
хыпар	χ ɯ p ɑ r
хыпара	χ ɯ p ɑ r ɑ
хыпарлама	χ ɯ p ɑ r l ɑ m ɑ
хыпарланӑ	χ ɯ p ɑ r l ɑ n ʌ
хыпарлар	χ ɯ p ɑ r l ɑ r
хыпарлать	χ ɯ p ɑ r l ɑ t
хыпарлӗҫ	χ ɯ p ɑ r l ɛ ɕ
хыпаршӑн	χ ɯ p ɑ r ʃ ʌ n
хыпаттӑм	χ ɯ p ɑ tː ʌ m
хыпса	χ ɯ p s ɑ
хырӑм	χ ɯ r ʌ m
хырӑмӗ	χ ɯ r ʌ m ɛ
хыснара	χ ɯ s n ɑ r ɑ
хыснаран	χ ɯ s n ɑ r ɑ n
хыснине	χ ɯ s n i n e
хытах	χ ɯ t ɑ χ
хыткан	χ ɯ t k ɑ n
хытса	χ ɯ ts ɑ
хытӑ	χ ɯ t ʌ
хытӑрах	χ ɯ t ʌ r ɑ χ
хыҫҫӑн	χ ɯ ɕː ʌ n
хыҫҫӑнах	χ ɯ ɕː ʌ n ɑ χ
хыҫҫӑнхи	χ ɯ ɕː ʌ n χ i
хыҫӗнче	χ ɯ ɕ ɛ n tʃ e
хыҫӗнчен	χ ɯ ɕ ɛ n tʃ e n
хӑв	χ ʌ v
хӑвалакан	χ ʌ v ɑ l ɑ k ɑ n
хӑваламаҫҫӗ	χ ʌ v ɑ l ɑ m ɑ ɕː ɛ
хӑваласа	χ ʌ v ɑ l ɑ s ɑ
хӑвалаҫҫӗ	χ ʌ v ɑ l ɑ ɕː ɛ
хӑварайман	χ ʌ v ɑ r ɑ j m ɑ n
хӑваракансене	χ ʌ v ɑ r ɑ k ɑ n s e n e
хӑварар	χ ʌ v ɑ r ɑ r
хӑварас	χ ʌ v ɑ r ɑ s
хӑварассишӗн	χ ʌ v ɑ r ɑ sː i ʃ ɛ n
хӑварасшӑн	χ ʌ v ɑ r ɑ s ʃ ʌ n
хӑварать	χ ʌ v ɑ r ɑ t
хӑварма	χ ʌ v ɑ r m ɑ
хӑвармалла	χ ʌ v ɑ r m ɑ lː ɑ
хӑварман	χ ʌ v ɑ r m ɑ n
хӑвармашкӑн	χ ʌ v ɑ r m ɑ ʃ k ʌ n
хӑварнине	χ ʌ v ɑ r n i n e
хӑварнӑ	χ ʌ v ɑ r n ʌ
хӑвартӑм	χ ʌ v ɑ r t ʌ m
хӑварӗҫ	χ ʌ v ɑ r ɛ ɕ
хӑватлӑ	χ ʌ v ɑ t l ʌ
хӑвӑр	χ ʌ v ʌ r
хӑвӑра	χ ʌ v ʌ r ɑ
хӑвӑрт	χ ʌ v ʌ r t
хӑвӑртах	χ ʌ v ʌ r t ɑ χ
хӑвӑртрах	χ ʌ v ʌ r t r ɑ χ
хӑвӑрӑн	χ ʌ v ʌ r ʌ n
хӑех	χ ʌ e χ
хӑй	χ ʌ j
хӑйех	χ ʌ j e χ
хӑйматлӑх	χ ʌ j m ɑ t l ʌ χ
хӑйне	χ ʌ j n e
хӑйпе	χ ʌ j p e
хӑйсем	χ ʌ j s e m
хӑйсемпе	χ ʌ j s e m p e
хӑйсен	χ ʌ j s e n
хӑйсене	χ ʌ j s e n e
хӑйӑр	χ ʌ j ʌ r
хӑйӗн	χ ʌ j ɛ n
хӑйӗншӗн	χ ʌ j ɛ n ʃ ɛ n
хӑлат	χ ʌ l ɑ t
хӑлха	χ ʌ l χ ɑ
хӑлхана	χ ʌ l χ ɑ n ɑ
хӑлхине	χ ʌ l χ i n e
хӑмасем	χ ʌ m ɑ s e m
хӑмине	χ ʌ m i n e
хӑмла	χ ʌ m l ɑ
хӑмпӑсем	χ ʌ m p ʌ s e m
хӑмӑр	χ ʌ m ʌ r
хӑна	χ ʌ n ɑ
хӑнакур	χ ʌ n ɑ k u r
хӑнана	χ ʌ n ɑ n ɑ
хӑнасем	χ ʌ n ɑ s e m
хӑнасене	χ ʌ n ɑ s e n e
хӑнӑхиччен	χ ʌ n ʌ χ i tʃ tʃ e n
хӑнӑхмашкӑн	χ ʌ n ʌ χ m ɑ ʃ k ʌ n
хӑнӑхнӑ	χ ʌ n ʌ χ n ʌ
хӑнӑхса	χ ʌ n ʌ χ s ɑ
хӑнӑхтарусене	χ ʌ n ʌ χ t ɑ r u s e n e
хӑнӑхтарчӗ	χ ʌ n ʌ χ t ɑ r tʃ ɛ
хӑнӑхтарӑвӗсем	χ ʌ n ʌ χ t ɑ r ʌ v ɛ s e m
хӑпарать	χ ʌ p ɑ r ɑ t
хӑпарма	χ ʌ p ɑ r m ɑ
хӑпармашкӑн	χ ʌ p ɑ r m ɑ ʃ k ʌ n
хӑпарнӑ	χ ʌ p ɑ r n ʌ
хӑпарса	χ ʌ p ɑ r s ɑ
хӑпартасси	χ ʌ p ɑ r t ɑ sː i
хӑпартаҫҫӗ	χ ʌ p ɑ r t ɑ ɕː ɛ
хӑпартланнӑ	χ ʌ p ɑ r t l ɑ nː ʌ
хӑпартлантарчӗ	χ ʌ p ɑ r t l ɑ n t ɑ r tʃ ɛ
хӑпартма	χ ʌ p ɑ r t m ɑ
хӑпартнӑ	χ ʌ p ɑ r t n ʌ
хӑпарчӗ	χ ʌ p ɑ r tʃ ɛ
хӑпас	χ ʌ p ɑ s
хӑпраттарасшӑн	χ ʌ p r ɑ tː ɑ r ɑ s ʃ ʌ n
хӑр-хар	χ ʌ r χ ɑ r
хӑрамасӑр	χ ʌ r ɑ m ɑ s ʌ r
хӑранӑ	χ ʌ r ɑ n ʌ
хӑрарӑм	χ ʌ r ɑ r ʌ m
хӑратаймастӑн	χ ʌ r ɑ t ɑ j m ɑ s t ʌ n
хӑратман	χ ʌ r ɑ t m ɑ n
хӑратрӗ	χ ʌ r ɑ t r ɛ
хӑратса	χ ʌ r ɑ ts ɑ
хӑрать	χ ʌ r ɑ t
хӑрушлӑх	χ ʌ r u ʃ l ʌ χ
хӑрушсӑр	χ ʌ r u ʃ s ʌ r
хӑрушсӑрлӑх	χ ʌ r u ʃ s ʌ r l ʌ χ
хӑрушӑ	χ ʌ r u ʃ ʌ
хӑрӑк-харӑк	χ ʌ r ʌ k χ ɑ r ʌ k
хӑрӑк-харӑка	χ ʌ r ʌ k χ ɑ r ʌ k ɑ
хӑрӑм	χ ʌ r ʌ m
хӑрӑмпа	χ ʌ r ʌ m p ɑ
хӑтарать	χ ʌ t ɑ r ɑ t
хӑтарма	χ ʌ t ɑ r m ɑ
хӑтлавӗнече	χ ʌ t l ɑ v ɛ n e tʃ e
хӑтланма	χ ʌ t l ɑ n m ɑ
хӑтланнишӗн	χ ʌ t l ɑ nː i ʃ ɛ n
хӑтланнӑ	χ ʌ t l ɑ nː ʌ
хӑтлӑ	χ ʌ t l ʌ
хӑтлӑлатас	χ ʌ t l ʌ l ɑ t ɑ s
хӑтлӑлатма	χ ʌ t l ʌ l ɑ t m ɑ
хӑтлӑлатмашкӑн	χ ʌ t l ʌ l ɑ t m ɑ ʃ k ʌ n
хӑтлӑлатӗҫ	χ ʌ t l ʌ l ɑ t ɛ ɕ
хӑтлӑх	χ ʌ t l ʌ χ
хӑтӑлаймарӗ	χ ʌ t ʌ l ɑ j m ɑ r ɛ
хӑтӑласси	χ ʌ t ʌ l ɑ sː i
хӑтӑлма	χ ʌ t ʌ l m ɑ
хӑтӑлмалла-ши	χ ʌ t ʌ l m ɑ lː ɑ ʃ i
хӑш	χ ʌ ʃ
хӑш-пӗр	χ ʌ ʃ p ɛ r
хӑшкӑлчӗ	χ ʌ ʃ k ʌ l tʃ ɛ
хӑшне	χ ʌ ʃ n e
хӑшне-пӗрне	χ ʌ ʃ n e p ɛ r n e
хӑшпӗр	χ ʌ ʃ p ɛ r
хӑшӗ-пӗри	χ ʌ ʃ ɛ p ɛ r i
хӑшӗ-пӗрин	χ ʌ ʃ ɛ p ɛ r i n
хӑшӗ-пӗрисем	χ ʌ ʃ ɛ p ɛ r i s e m
хӑшӗсене	χ ʌ ʃ ɛ s e n e
хӑю	χ ʌ j u
хӑҫан	χ ʌ ɕ ɑ n
хӑҫанччен	χ ʌ ɕ ɑ n tʃ tʃ e n
хӗвел	χ ɛ v e l
хӗвел-тухӑҫӗнче	χ ɛ v e l t u χ ʌ ɕ ɛ n tʃ e
хӗвеланӑҫ	χ ɛ v e l ɑ n ʌ ɕ
хӗвеланӑҫӗнче	χ ɛ v e l ɑ n ʌ ɕ ɛ n tʃ e
хӗвеллӗ	χ ɛ v e lː ɛ
хӗвелтен	χ ɛ v e l t e n
хӗветӗр	χ ɛ v e t ɛ r
хӗвӗшӳ	χ ɛ v ɛ ʃ y
хӗл	χ ɛ l
хӗлеҫ	χ ɛ l e ɕ
хӗлле	χ ɛ lː e
хӗллехи	χ ɛ lː e χ i
хӗлӗхсене	χ ɛ l ɛ χ s e n e
хӗпӗртерӗҫ	χ ɛ p ɛ r t e r ɛ ɕ
хӗпӗртесе	χ ɛ p ɛ r t e s e
хӗр	χ ɛ r
хӗр-упраҫа	χ ɛ r u p r ɑ ɕ ɑ
хӗр-хӗрарӑмсенчен	χ ɛ r χ ɛ r ɑ r ʌ m s e n tʃ e n
хӗрарӑм	χ ɛ r ɑ r ʌ m
хӗрарӑмпа	χ ɛ r ɑ r ʌ m p ɑ
хӗрарӑмсем	χ ɛ r ɑ r ʌ m s e m
хӗрарӑмсемпе	χ ɛ r ɑ r ʌ m s e m p e
хӗрарӑмсен	χ ɛ r ɑ r ʌ m s e n
хӗрарӑмӑн	χ ɛ r ɑ r ʌ m ʌ n
хӗрача	χ ɛ r ɑ tʃ ɑ
хӗрачан	χ ɛ r ɑ tʃ ɑ n
хӗрачана	χ ɛ r ɑ tʃ ɑ n ɑ
хӗрачапа	χ ɛ r ɑ tʃ ɑ p ɑ
хӗрачасем	χ ɛ r ɑ tʃ ɑ s e m
хӗрачасене	χ ɛ r ɑ tʃ ɑ s e n e
хӗре	χ ɛ r e
хӗрелнӗ	χ ɛ r e l n ɛ
хӗресленекен	χ ɛ r e s l e n e k e n
хӗресленнӗ	χ ɛ r e s l e nː ɛ
хӗрлӗ	χ ɛ r l ɛ
хӗрне	χ ɛ r n e
хӗрри	χ ɛ rː i
хӗррине	χ ɛ rː i n e
хӗррипе	χ ɛ rː i p e
хӗрсе	χ ɛ r s e
хӗрсем	χ ɛ r s e m
хӗрсех	χ ɛ r s e χ
хӗртет	χ ɛ r t e t
хӗртнӗ	χ ɛ r t n ɛ
хӗртнӗрен	χ ɛ r t n ɛ r e n
хӗртнӗҫем	χ ɛ r t n ɛ ɕ e m
хӗрупраҫсене	χ ɛ r u p r ɑ ɕ s e n e
хӗрхеннипе	χ ɛ r χ e nː i p e
хӗрхеннӗ	χ ɛ r χ e nː ɛ
хӗрхеннӗрен	χ ɛ r χ e nː ɛ r e n
хӗрхентӗм	χ ɛ r χ e n t ɛ m
хӗрӗ	χ ɛ r ɛ
хӗрӗм	χ ɛ r ɛ m
хӗрӗн	χ ɛ r ɛ n
хӗрӗпе	χ ɛ r ɛ p e
хӗрӗшӗн	χ ɛ r ɛ ʃ ɛ n
хӗсни	χ ɛ s n i
хӗсӗнсе	χ ɛ s ɛ n s e
хӗсӗнсех	χ ɛ s ɛ n s e χ
хӗсӗрлеҫҫӗ	χ ɛ s ɛ r l e ɕː ɛ
хӗтӗртнӗ	χ ɛ t ɛ r t n ɛ
хӗҫне	χ ɛ ɕ n e
хӳсе	χ y s e
хӳтӗлеме	χ y t ɛ l e m e
хӳтӗленмелли	χ y t ɛ l e n m e lː i
целлофон	ts e lː o f o n
центра	ts e n t r ɑ
центрне	ts e n t r n e
центрӗ	ts e n t r ɛ
церемоние	ts e r e m o n i e
цех	ts e χ
цехӗнче	ts e χ ɛ n tʃ e
циклон	ts i k l o n
цинк	ts i n k
цирк	ts i r k
цирка	ts i r k ɑ
цоколь	ts o k o l
чавнӑ	tʃ ɑ v n ʌ
чакараса	tʃ ɑ k ɑ r ɑ s ɑ
чакарнӑ	tʃ ɑ k ɑ r n ʌ
чакмасть	tʃ ɑ k m ɑ s t
чакнӑ	tʃ ɑ k n ʌ
чаксах	tʃ ɑ k s ɑ χ
чапаев	tʃ ɑ p ɑ e v
чаплӑ	tʃ ɑ p l ʌ
чаплӑччӗ	tʃ ɑ p l ʌ tʃ tʃ ɛ
чапне	tʃ ɑ p n e
чарман	tʃ ɑ r m ɑ n
чарнӑ	tʃ ɑ r n ʌ
чарса	tʃ ɑ r s ɑ
чару	tʃ ɑ r u
чарӑва	tʃ ɑ r ʌ v ɑ
чарӑнаймастӑп	tʃ ɑ r ʌ n ɑ j m ɑ s t ʌ p
чарӑнман	tʃ ɑ r ʌ n m ɑ n
чарӑнмиччӗ	tʃ ɑ r ʌ n m i tʃ tʃ ɛ
чарӑннине	tʃ ɑ r ʌ nː i n e
чарӑннӑ	tʃ ɑ r ʌ nː ʌ
чарӑнса	tʃ ɑ r ʌ n s ɑ
чарӑну	tʃ ɑ r ʌ n u
чарӑнура	tʃ ɑ r ʌ n u r ɑ
чарӑнусем	tʃ ɑ r ʌ n u s e m
чарӑнусенче	tʃ ɑ r ʌ n u s e n tʃ e
чарӑнӑва	tʃ ɑ r ʌ n ʌ v ɑ
чарӑнӑвне	tʃ ɑ r ʌ n ʌ v n e
чарӑнӑвӗ	tʃ ɑ r ʌ n ʌ v ɛ
чарӑнӗ	tʃ ɑ r ʌ n ɛ
час	tʃ ɑ s
час-часах	tʃ ɑ s tʃ ɑ s ɑ χ
часах	tʃ ɑ s ɑ χ
часрах	tʃ ɑ s r ɑ χ
чейник	tʃ e j n i k
чейпе	tʃ e j p e
челябинск	tʃ e l j ɑ b i n s k
чемпионатӗнчен	tʃ e m p i o n ɑ t ɛ n tʃ e n
чемпионачӗ	tʃ e m p i o n ɑ tʃ ɛ
черет	tʃ e r e t
черетлесе	tʃ e r e t l e s e
черетлӗ	tʃ e r e t l ɛ
черетпе	tʃ e r e t p e
черетре	tʃ e r e t r e
черкке	tʃ e r kː e
чернова	tʃ e r n o v ɑ
чечек	tʃ e tʃ e k
чечексем	tʃ e tʃ e k s e m
чи	tʃ i
чикеймесӗр	tʃ i k e j m e s ɛ r
чикмеллине	tʃ i k m e lː i n e
чикмен	tʃ i k m e n
чикмерӗм	tʃ i k m e r ɛ m
чикнӗ	tʃ i k n ɛ
чиксе	tʃ i k s e
чикӗ	tʃ i k ɛ
чиновникӗсем	tʃ i n o v n i k ɛ s e m
чипер	tʃ i p e r
чиперех	tʃ i p e r e χ
чиперскер	tʃ i p e r s k e r
чир	tʃ i r
чире	tʃ i r e
чиркӗве	tʃ i r k ɛ v e
чиркӗвне	tʃ i r k ɛ v n e
чиркӗвӗн	tʃ i r k ɛ v ɛ n
чиркӳ	tʃ i r k y
чиркӳре	tʃ i r k y r e
чирленӗ	tʃ i r l e n ɛ
чирлесе	tʃ i r l e s e
чирлессе	tʃ i r l e sː e
чирли	tʃ i r l i
чирлисем	tʃ i r l i s e m
чирлисемпе	tʃ i r l i s e m p e
чирлисене	tʃ i r l i s e n e
чирлӗ	tʃ i r l ɛ
чирне	tʃ i r n e
чирпе	tʃ i r p e
чирсемпе	tʃ i r s e m p e
чиртен	tʃ i r t e n
чирӗн	tʃ i r ɛ n
чирӗнчен	tʃ i r ɛ n tʃ e n
чирӗпе	tʃ i r ɛ p e
чирӗсем	tʃ i r ɛ s e m
чирӗсемпе	tʃ i r ɛ s e m p e
чр	tʃ r
чуварлейри	tʃ u v ɑ r l e j r i
чул	tʃ u l
чулне	tʃ u l n e
чулсемпе	tʃ u l s e m p e
чулхула	tʃ u l χ u l ɑ
чулхулара	tʃ u l χ u l ɑ r ɑ
чун	tʃ u n
чун-чӗреллӗ	tʃ u n tʃ ɛ r e lː ɛ
чуна	tʃ u n ɑ
чунлӑ	tʃ u n l ʌ
чунне	tʃ u nː e
чунра	tʃ u n r ɑ
чунран	tʃ u n r ɑ n
чунсене	tʃ u n s e n e
чунтан	tʃ u n t ɑ n
чуншӑн	tʃ u n ʃ ʌ n
чунӑма	tʃ u n ʌ m ɑ
чунӗ	tʃ u n ɛ
чунӗнче	tʃ u n ɛ n tʃ e
чунӗпе	tʃ u n ɛ p e
чуп	tʃ u p
чупасси	tʃ u p ɑ sː i
чупать	tʃ u p ɑ t
чупаҫҫӗ	tʃ u p ɑ ɕː ɛ
чупма	tʃ u p m ɑ
чупнӑ	tʃ u p n ʌ
чупрӑм	tʃ u p r ʌ m
чупрӗ	tʃ u p r ɛ
чупса	tʃ u p s ɑ
чупсам	tʃ u p s ɑ m
чура	tʃ u r ɑ
чустана	tʃ u s t ɑ n ɑ
чутайран	tʃ u t ɑ j r ɑ n
чутах	tʃ u t ɑ χ
чух	tʃ u χ
чухламанскерсене	tʃ u χ l ɑ m ɑ n s k e r s e n e
чухлӗ	tʃ u χ l ɛ
чухне	tʃ u χ n e
чухнех	tʃ u χ n e χ
чухнехи	tʃ u χ n e χ i
чылай	tʃ ɯ l ɑ j
чылайӑшне	tʃ ɯ l ɑ j ʌ ʃ n e
чылайӑшӗ	tʃ ɯ l ɑ j ʌ ʃ ɛ
чыслама	tʃ ɯ s l ɑ m ɑ
чысланӑ	tʃ ɯ s l ɑ n ʌ
чысласа	tʃ ɯ s l ɑ s ɑ
чыхӑна-чыхӑна	tʃ ɯ χ ʌ n ɑ tʃ ɯ χ ʌ n ɑ
чӑваш	tʃ ʌ v ɑ ʃ
чӑвашла	tʃ ʌ v ɑ ʃ l ɑ
чӑвашлах-ха	tʃ ʌ v ɑ ʃ l ɑ χː ɑ
чӑвашлӑх	tʃ ʌ v ɑ ʃ l ʌ χ
чӑвашран	tʃ ʌ v ɑ ʃ r ɑ n
чӑвашсем	tʃ ʌ v ɑ ʃ s e m
чӑвашсен	tʃ ʌ v ɑ ʃ s e n
чӑвашсене	tʃ ʌ v ɑ ʃ s e n e
чӑвашстат	tʃ ʌ v ɑ ʃ s t ɑ t
чӑл	tʃ ʌ l
чӑлт	tʃ ʌ l t
чӑмӑртама	tʃ ʌ m ʌ r t ɑ m ɑ
чӑмӑртану	tʃ ʌ m ʌ r t ɑ n u
чӑмӑрӗ	tʃ ʌ m ʌ r ɛ
чӑн	tʃ ʌ n
чӑн-чӑн	tʃ ʌ n tʃ ʌ n
чӑнах	tʃ ʌ n ɑ χ
чӑнлавсем	tʃ ʌ n l ɑ v s e m
чӑннине	tʃ ʌ nː i n e
чӑннипе	tʃ ʌ nː i p e
чӑннипех	tʃ ʌ nː i p e χ
чӑрмавсене	tʃ ʌ r m ɑ v s e n e
чӑрмантарнӑ	tʃ ʌ r m ɑ n t ɑ r n ʌ
чӑрӑш	tʃ ʌ r ʌ ʃ
чӑтаймасӑр	tʃ ʌ t ɑ j m ɑ s ʌ r
чӑтаймиех	tʃ ʌ t ɑ j m i e χ
чӑтма	tʃ ʌ t m ɑ
чӑтмалла	tʃ ʌ t m ɑ lː ɑ
чӑтмасть	tʃ ʌ t m ɑ s t
чӑтнӑ	tʃ ʌ t n ʌ
чӑтрӑм-ши	tʃ ʌ t r ʌ m ʃ i
чӑтса	tʃ ʌ ts ɑ
чӑтӑмсӑррӑн	tʃ ʌ t ʌ m s ʌ rː ʌ n
чӑх-чӗп	tʃ ʌ χ tʃ ɛ p
чӗкеҫ	tʃ ɛ k e ɕ
чӗлем	tʃ ɛ l e m
чӗлхе	tʃ ɛ l χ e
чӗлхе-и	tʃ ɛ l χ e i
чӗлхене	tʃ ɛ l χ e n e
чӗлхепе	tʃ ɛ l χ e p e
чӗлхерен	tʃ ɛ l χ e r e n
чӗлхесен	tʃ ɛ l χ e s e n
чӗлхесене	tʃ ɛ l χ e s e n e
чӗлхи	tʃ ɛ l χ i
чӗлхине	tʃ ɛ l χ i n e
чӗлхисен	tʃ ɛ l χ i s e n
чӗлхисене	tʃ ɛ l χ i s e n e
чӗлхӳне	tʃ ɛ l χ y n e
чӗмпӗр	tʃ ɛ m p ɛ r
чӗмпӗрте	tʃ ɛ m p ɛ r t e
чӗнекенсем	tʃ ɛ n e k e n s e m
чӗнетчӗҫ	tʃ ɛ n e t tʃ ɛ ɕ
чӗнеҫҫӗ	tʃ ɛ n e ɕː ɛ
чӗнме	tʃ ɛ n m e
чӗнмен-туман	tʃ ɛ n m e n t u m ɑ n
чӗннӗ	tʃ ɛ nː ɛ
чӗнсе	tʃ ɛ n s e
чӗнсен	tʃ ɛ n s e n
чӗппи	tʃ ɛ pː i
чӗр	tʃ ɛ r
чӗре	tʃ ɛ r e
чӗрепе	tʃ ɛ r e p e
чӗререн	tʃ ɛ r e r e n
чӗри	tʃ ɛ r i
чӗркуҫҫи	tʃ ɛ r k u ɕː i
чӗркуҫҫийӗ	tʃ ɛ r k u ɕː i j ɛ
чӗррӗн	tʃ ɛ rː ɛ n
чӗртме	tʃ ɛ r t m e
чӗртсе	tʃ ɛ r ts e
чӗрчунсем	tʃ ɛ r tʃ u n s e m
чӗрӗ	tʃ ɛ r ɛ
чӗрӗ-ҫке	tʃ ɛ r ɛ ɕ k e
чӗрӗк	tʃ ɛ r ɛ k
чӗрӗлчӗҫ	tʃ ɛ r ɛ l tʃ ɛ ɕ
чӗрӗлӗҫ	tʃ ɛ r ɛ l ɛ ɕ
чӗтрекен	tʃ ɛ t r e k e n
чӗҫҫӗ	tʃ ɛ ɕː ɛ
чӳк	tʃ y k
чӳрече	tʃ y r e tʃ e
чӳречерен	tʃ y r e tʃ e r e n
чӳречесен	tʃ y r e tʃ e s e n
чӳречи	tʃ y r e tʃ i
чӳхеме	tʃ y χ e m e
ш	ʃ
шавласа	ʃ ɑ v l ɑ s ɑ
шавлаҫҫӗ	ʃ ɑ v l ɑ ɕː ɛ
шавлӑ	ʃ ɑ v l ʌ
шайлашура	ʃ ɑ j l ɑ ʃ u r ɑ
шаймиев	ʃ ɑ j m i e v
шайри	ʃ ɑ j r i
шайӗ	ʃ ɑ j ɛ
шайӗнче	ʃ ɑ j ɛ n tʃ e
шайӗнчи	ʃ ɑ j ɛ n tʃ i
шаккамарӗ	ʃ ɑ kː ɑ m ɑ r ɛ
шала	ʃ ɑ l ɑ
шалти	ʃ ɑ l t i
шалтлатса	ʃ ɑ l t l ɑ ts ɑ
шалу	ʃ ɑ l u
шалӑва	ʃ ɑ l ʌ v ɑ
шалӑвне	ʃ ɑ l ʌ v n e
шанаймасть	ʃ ɑ n ɑ j m ɑ s t
шанатпӑр	ʃ ɑ n ɑ t p ʌ r
шанаҫҫӗ	ʃ ɑ n ɑ ɕː ɛ
шанни	ʃ ɑ nː i
шаннӑ	ʃ ɑ nː ʌ
шанса	ʃ ɑ n s ɑ
шантарать	ʃ ɑ n t ɑ r ɑ t
шантараҫҫӗ	ʃ ɑ n t ɑ r ɑ ɕː ɛ
шантарнӑ	ʃ ɑ n t ɑ r n ʌ
шантарчӗ	ʃ ɑ n t ɑ r tʃ ɛ
шантарчӗҫ	ʃ ɑ n t ɑ r tʃ ɛ ɕ
шанчӗ	ʃ ɑ n tʃ ɛ
шапаша	ʃ ɑ p ɑ ʃ ɑ
шапашкӑна	ʃ ɑ p ɑ ʃ k ʌ n ɑ
шапашран	ʃ ɑ p ɑ ʃ r ɑ n
шапитора	ʃ ɑ p i t o r ɑ
шар	ʃ ɑ r
шарама	ʃ ɑ r ɑ m ɑ
шарт	ʃ ɑ r t
шарф	ʃ ɑ r f
шарши	ʃ ɑ r ʃ i
шатӑртаттаракан	ʃ ɑ t ʌ r t ɑ tː ɑ r ɑ k ɑ n
шахмат	ʃ ɑ χ m ɑ t
шашлык	ʃ ɑ ʃ l ɯ k
шашлыкӑн	ʃ ɑ ʃ l ɯ k ʌ n
швед	ʃ v e d
швецин	ʃ v e ts i n
шевроле-круэ	ʃ e v r o l e k r u e
шел	ʃ e l
шеллемен	ʃ e lː e m e n
шеллеместӗм	ʃ e lː e m e s t ɛ m
шеллемесӗр	ʃ e lː e m e s ɛ r
шеллемеҫҫӗ	ʃ e lː e m e ɕː ɛ
шелленипе	ʃ e lː e n i p e
шеллеттерекен	ʃ e lː e tː e r e k e n
шеллеттӗмӗр	ʃ e lː e tː ɛ m ɛ r
шеллетӗп	ʃ e lː e t ɛ p
шелччӗ	ʃ e l tʃ tʃ ɛ
шеф-поварсем	ʃ e f p o v ɑ r s e m
шеф-поварсен	ʃ e f p o v ɑ r s e n
шешме	ʃ e ʃ m e
шикленесси	ʃ i k l e n e sː i
шикленет	ʃ i k l e n e t
шикленеҫҫӗ	ʃ i k l e n e ɕː ɛ
шикленмелли	ʃ i k l e n m e lː i
шикленмен	ʃ i k l e n m e n
шикленместӗр	ʃ i k l e n m e s t ɛ r
шикленнипе	ʃ i k l e nː i p e
шикленсе	ʃ i k l e n s e
шиклентерет	ʃ i k l e n t e r e t
шиклентермен	ʃ i k l e n t e r m e n
шикленчӗ	ʃ i k l e n tʃ ɛ
шикленӳ	ʃ i k l e n y
шикленӳсенчен	ʃ i k l e n y s e n tʃ e n
шиклӗх	ʃ i k l ɛ χ
шина	ʃ i n ɑ
шкап	ʃ k ɑ p
шкул	ʃ k u l
шкула	ʃ k u l ɑ
шкулне	ʃ k u l n e
шкулсемпе	ʃ k u l s e m p e
шкулсенче	ʃ k u l s e n tʃ e
шкулта	ʃ k u l t ɑ
шкултан	ʃ k u l t ɑ n
шкулти	ʃ k u l t i
шкулӑн	ʃ k u l ʌ n
шкулӗ	ʃ k u l ɛ
шкулӗн	ʃ k u l ɛ n
шкулӗсем	ʃ k u l ɛ s e m
шмелев	ʃ m e l e v
шовинистсем	ʃ o v i n i s ts e m
шоколадлӑ	ʃ o k o l ɑ d l ʌ
шоферӗ	ʃ o f e r ɛ
шпалерсем	ʃ p ɑ l e r s e m
штраф	ʃ t r ɑ f
штрафлаҫҫӗ	ʃ t r ɑ f l ɑ ɕː ɛ
штукатуркӑпа	ʃ t u k ɑ t u r k ʌ p ɑ
шукӑль	ʃ u k ʌ l
шултра	ʃ u l t r ɑ
шупашкар	ʃ u p ɑ ʃ k ɑ r
шупашкара	ʃ u p ɑ ʃ k ɑ r ɑ
шупашкарне	ʃ u p ɑ ʃ k ɑ r n e
шупашкарта	ʃ u p ɑ ʃ k ɑ r t ɑ
шупашкартан	ʃ u p ɑ ʃ k ɑ r t ɑ n
шупашкарти	ʃ u p ɑ ʃ k ɑ r t i
шупашкарӗ	ʃ u p ɑ ʃ k ɑ r ɛ
шур	ʃ u r
шура	ʃ u r ɑ
шуратать	ʃ u r ɑ t ɑ t
шуратмалла	ʃ u r ɑ t m ɑ lː ɑ
шуратса	ʃ u r ɑ ts ɑ
шуркасси	ʃ u r k ɑ sː i
шуркассисем	ʃ u r k ɑ sː i s e m
шурӑ	ʃ u r ʌ
шут	ʃ u t
шута	ʃ u t ɑ
шутламастӑп	ʃ u t l ɑ m ɑ s t ʌ p
шутланаттӑмӑр	ʃ u t l ɑ n ɑ tː ʌ m ʌ r
шутланать	ʃ u t l ɑ n ɑ t
шутланаҫҫӗ	ʃ u t l ɑ n ɑ ɕː ɛ
шутланӑ	ʃ u t l ɑ n ʌ
шутланӑ-ха	ʃ u t l ɑ n ʌ χ ɑ
шутланӑскер	ʃ u t l ɑ n ʌ s k e r
шутласа	ʃ u t l ɑ s ɑ
шутласан	ʃ u t l ɑ s ɑ n
шутлатӑп	ʃ u t l ɑ t ʌ p
шутлӑ	ʃ u t l ʌ
шутне	ʃ u t n e
шутра	ʃ u t r ɑ
шутсӑр	ʃ u ts ʌ r
шутӗнче	ʃ u t ɛ n tʃ e
шухашӗпе	ʃ u χ ɑ ʃ ɛ p e
шухӑш	ʃ u χ ʌ ʃ
шухӑша	ʃ u χ ʌ ʃ ɑ
шухӑшлаймастӑм	ʃ u χ ʌ ʃ l ɑ j m ɑ s t ʌ m
шухӑшлама	ʃ u χ ʌ ʃ l ɑ m ɑ
шухӑшламалла	ʃ u χ ʌ ʃ l ɑ m ɑ lː ɑ
шухӑшламан	ʃ u χ ʌ ʃ l ɑ m ɑ n
шухӑшланине	ʃ u χ ʌ ʃ l ɑ n i n e
шухӑшланӑ	ʃ u χ ʌ ʃ l ɑ n ʌ
шухӑшларӑм	ʃ u χ ʌ ʃ l ɑ r ʌ m
шухӑшласа	ʃ u χ ʌ ʃ l ɑ s ɑ
шухӑшлассисем	ʃ u χ ʌ ʃ l ɑ sː i s e m
шухӑшлаттарӗ	ʃ u χ ʌ ʃ l ɑ tː ɑ r ɛ
шухӑшлать	ʃ u χ ʌ ʃ l ɑ t
шухӑшлаҫҫӗ	ʃ u χ ʌ ʃ l ɑ ɕː ɛ
шухӑшлӑ	ʃ u χ ʌ ʃ l ʌ
шухӑшне	ʃ u χ ʌ ʃ n e
шухӑшпа	ʃ u χ ʌ ʃ p ɑ
шухӑшсемпе	ʃ u χ ʌ ʃ s e m p e
шухӑшсен	ʃ u χ ʌ ʃ s e n
шухӑшсене	ʃ u χ ʌ ʃ s e n e
шухӑшсенчен	ʃ u χ ʌ ʃ s e n tʃ e n
шухӑшӗ	ʃ u χ ʌ ʃ ɛ
шухӑшӗпе	ʃ u χ ʌ ʃ ɛ p e
шухӑшӗсене	ʃ u χ ʌ ʃ ɛ s e n e
шучӗ	ʃ u tʃ ɛ
шыв	ʃ ɯ v
шыва	ʃ ɯ v ɑ
шывланнӑ	ʃ ɯ v l ɑ nː ʌ
шывне	ʃ ɯ v n e
шывра	ʃ ɯ v r ɑ
шывсӑр	ʃ ɯ v s ʌ r
шывӑн	ʃ ɯ v ʌ n
шывӗ	ʃ ɯ v ɛ
шыравне	ʃ ɯ r ɑ v n e
шыравӗнче	ʃ ɯ r ɑ v ɛ n tʃ e
шырама	ʃ ɯ r ɑ m ɑ
шырани	ʃ ɯ r ɑ n i
шыранӑ	ʃ ɯ r ɑ n ʌ
шыранӑ-ха	ʃ ɯ r ɑ n ʌ χ ɑ
шыраса	ʃ ɯ r ɑ s ɑ
шырасан	ʃ ɯ r ɑ s ɑ n
шыратчӗҫ	ʃ ɯ r ɑ t tʃ ɛ ɕ
шыраҫҫӗ	ʃ ɯ r ɑ ɕː ɛ
шыҫҫа	ʃ ɯ ɕː ɑ
шыҫҫинчен	ʃ ɯ ɕː i n tʃ e n
шыҫӑ	ʃ ɯ ɕ ʌ
шыҫӑпа	ʃ ɯ ɕ ʌ p ɑ
шыҫӑран	ʃ ɯ ɕ ʌ r ɑ n
шӑйӑрттарнӑ	ʃ ʌ j ʌ r tː ɑ r n ʌ
шӑк	ʃ ʌ k
шӑккалат	ʃ ʌ kː ɑ l ɑ t
шӑккӑлат	ʃ ʌ kː ʌ l ɑ t
шӑл	ʃ ʌ l
шӑла	ʃ ʌ l ɑ
шӑлавар	ʃ ʌ l ɑ v ɑ r
шӑлавара	ʃ ʌ l ɑ v ɑ r ɑ
шӑлаварне	ʃ ʌ l ɑ v ɑ r n e
шӑлаварпа	ʃ ʌ l ɑ v ɑ r p ɑ
шӑллӑм	ʃ ʌ lː ʌ m
шӑлне	ʃ ʌ l n e
шӑлӗн	ʃ ʌ l ɛ n
шӑлӗсене	ʃ ʌ l ɛ s e n e
шӑматкун	ʃ ʌ m ɑ t k u n
шӑматкунсерен	ʃ ʌ m ɑ t k u n s e r e n
шӑмӑ	ʃ ʌ m ʌ
шӑмӑна	ʃ ʌ m ʌ n ɑ
шӑна	ʃ ʌ n ɑ
шӑнкӑравлакансем	ʃ ʌ n k ʌ r ɑ v l ɑ k ɑ n s e m
шӑнкӑравлама	ʃ ʌ n k ʌ r ɑ v l ɑ m ɑ
шӑнкӑравламалла	ʃ ʌ n k ʌ r ɑ v l ɑ m ɑ lː ɑ
шӑнкӑравлани	ʃ ʌ n k ʌ r ɑ v l ɑ n i
шӑнкӑравланӑ	ʃ ʌ n k ʌ r ɑ v l ɑ n ʌ
шӑнкӑравларӑм	ʃ ʌ n k ʌ r ɑ v l ɑ r ʌ m
шӑнкӑравларӗ	ʃ ʌ n k ʌ r ɑ v l ɑ r ɛ
шӑнкӑравласа	ʃ ʌ n k ʌ r ɑ v l ɑ s ɑ
шӑнкӑравласшӑнччӗ	ʃ ʌ n k ʌ r ɑ v l ɑ s ʃ ʌ n tʃ tʃ ɛ
шӑнкӑравлатӑп	ʃ ʌ n k ʌ r ɑ v l ɑ t ʌ p
шӑнкӑравлаҫҫӗ	ʃ ʌ n k ʌ r ɑ v l ɑ ɕː ɛ
шӑнмалла	ʃ ʌ n m ɑ lː ɑ
шӑнса	ʃ ʌ n s ɑ
шӑнтаҫҫӗ	ʃ ʌ n t ɑ ɕː ɛ
шӑнтса	ʃ ʌ n ts ɑ
шӑнтӑр	ʃ ʌ n t ʌ r
шӑп	ʃ ʌ p
шӑпа	ʃ ʌ p ɑ
шӑпах	ʃ ʌ p ɑ χ
шӑпи	ʃ ʌ p i
шӑпине	ʃ ʌ p i n e
шӑплӑха	ʃ ʌ p l ʌ χ ɑ
шӑрантарса	ʃ ʌ r ɑ n t ɑ r s ɑ
шӑрпӑкпа	ʃ ʌ r p ʌ k p ɑ
шӑрши	ʃ ʌ r ʃ i
шӑршӑ	ʃ ʌ r ʃ ʌ
шӑршӑллӑ	ʃ ʌ r ʃ ʌ lː ʌ
шӑршӑллӑччӗ	ʃ ʌ r ʃ ʌ lː ʌ tʃ tʃ ɛ
шӑрҫаран	ʃ ʌ r ɕ ɑ r ɑ n
шӑрӑх	ʃ ʌ r ʌ χ
шӑрӑхра	ʃ ʌ r ʌ χ r ɑ
шӑтарнӑ	ʃ ʌ t ɑ r n ʌ
шӑтарса	ʃ ʌ t ɑ r s ɑ
шӑтнине	ʃ ʌ t n i n e
шӑтнӑ	ʃ ʌ t n ʌ
шӑтӑк-путӑклӑ	ʃ ʌ t ʌ k p u t ʌ k l ʌ
шӗвек	ʃ ɛ v e k
шӗвеке	ʃ ɛ v e k e
шӗвекпе	ʃ ɛ v e k p e
шӗвексем	ʃ ɛ v e k s e m
шӗвексен	ʃ ɛ v e k s e n
шӗкӗр	ʃ ɛ k ɛ r
шӗм	ʃ ɛ m
шӗмӗн	ʃ ɛ m ɛ n
шӗнерпуҫ	ʃ ɛ n e r p u ɕ
шӳрпи	ʃ y r p i
шӳтлекене	ʃ y t l e k e n e
шӳтлеме	ʃ y t l e m e
ывӑл	ɯ v ʌ l
ывӑл-хӗрӗ	ɯ v ʌ l χ ɛ r ɛ
ывӑла	ɯ v ʌ l ɑ
ывӑлне	ɯ v ʌ l n e
ывӑлсем	ɯ v ʌ l s e m
ывӑлӑм	ɯ v ʌ l ʌ m
ывӑлӗ	ɯ v ʌ l ɛ
ывӑлӗнчен	ɯ v ʌ l ɛ n tʃ e n
ывӑлӗпе	ɯ v ʌ l ɛ p e
ывӑлӗсем	ɯ v ʌ l ɛ s e m
ывӑтмалла	ɯ v ʌ t m ɑ lː ɑ
ыйтакан	ɯ j t ɑ k ɑ n
ыйтатчӗ	ɯ j t ɑ t tʃ ɛ
ыйтать	ɯ j t ɑ t
ыйтаҫҫӗ	ɯ j t ɑ ɕː ɛ
ыйтма	ɯ j t m ɑ
ыйтман	ɯ j t m ɑ n
ыйтни	ɯ j t n i
ыйтнине	ɯ j t n i n e
ыйтнипе	ɯ j t n i p e
ыйтнӑ	ɯ j t n ʌ
ыйтрӑм	ɯ j t r ʌ m
ыйтрӗ	ɯ j t r ɛ
ыйтрӗҫ	ɯ j t r ɛ ɕ
ыйтса	ɯ j ts ɑ
ыйту	ɯ j t u
ыйтупа	ɯ j t u p ɑ
ыйтусем	ɯ j t u s e m
ыйтусене	ɯ j t u s e n e
ыйтӑва	ɯ j t ʌ v ɑ
ыйтӑвах	ɯ j t ʌ v ɑ χ
ыйтӑвӗсем	ɯ j t ʌ v ɛ s e m
ыйтӑвӗсене	ɯ j t ʌ v ɛ s e n e
ыйтӑр	ɯ j t ʌ r
ыйхӑ	ɯ j χ ʌ
ыйхӑран	ɯ j χ ʌ r ɑ n
ылтӑн	ɯ l t ʌ n
ыран	ɯ r ɑ n
ырантан	ɯ r ɑ n t ɑ n
ыранхи	ɯ r ɑ n χ i
ыратма	ɯ r ɑ t m ɑ
ыратнине	ɯ r ɑ t n i n e
ыратнӑ	ɯ r ɑ t n ʌ
ыратрӗ	ɯ r ɑ t r ɛ
ыраттарнӑ	ɯ r ɑ tː ɑ r n ʌ
ыратӑвӗ	ɯ r ɑ t ʌ v ɛ
ырламалла	ɯ r l ɑ m ɑ lː ɑ
ырланӑ	ɯ r l ɑ n ʌ
ырласа	ɯ r l ɑ s ɑ
ырӑ	ɯ r ʌ
ырӑ-ырӑ	ɯ r ʌ ɯ r ʌ
ырӑпа	ɯ r ʌ p ɑ
ырӑпах	ɯ r ʌ p ɑ χ
ырӑрах	ɯ r ʌ r ɑ χ
ыталама	ɯ t ɑ l ɑ m ɑ
ыталать	ɯ t ɑ l ɑ t
ытараймаҫҫӗ	ɯ t ɑ r ɑ j m ɑ ɕː ɛ
ытарайми	ɯ t ɑ r ɑ j m i
ытарли	ɯ t ɑ r l i
ытла	ɯ t l ɑ
ытларах	ɯ t l ɑ r ɑ χ
ытлари	ɯ t l ɑ r i
ытлашши	ɯ t l ɑ ʃː i
ытлашшипех	ɯ t l ɑ ʃː i p e χ
ытти	ɯ tː i
ыттисене	ɯ tː i s e n e
ыхракасси	ɯ χ r ɑ k ɑ sː i
эаведенийӗсем	e ɑ v e d e n i j ɛ s e m
эаведенине	e ɑ v e d e n i n e
эаведуюший	e ɑ v e d u j u ʃ i j
эаводне	e ɑ v o d n e
эадани	e ɑ d ɑ n i
эадание	e ɑ d ɑ n i e
эаданисене	e ɑ d ɑ n i s e n e
эадорнов	e ɑ d o r n o v
эал	e ɑ l
эалне	e ɑ l n e
эалра	e ɑ l r ɑ
эалӗнче	e ɑ l ɛ n tʃ e
эанятисене	e ɑ n j ɑ t i s e n e
эаря	e ɑ r j ɑ
эарядкӑна	e ɑ r j ɑ d k ʌ n ɑ
эаявлени	e ɑ j ɑ v l e n i
эвеэдный	e v e e d n ɯ j
эгер	e g e r
эй	e j
эковолонтерсен	e k o v o l o n t e r s e n
экологи	e k o l o g i
экологие	e k o l o g i e
экономика	e k o n o m i k ɑ
экономикине	e k o n o m i k i n e
экранра	e k r ɑ n r ɑ
экс-мэр	e k s m e r
экс-пуҫлӑх	e k s p u ɕ l ʌ χ
экс-пуҫлӑхӗ	e k s p u ɕ l ʌ χ ɛ
экс-ҫумӑн	e k s ɕ u m ʌ n
экскаватор	e k s k ɑ v ɑ t o r
экскаваторшик	e k s k ɑ v ɑ t o r ʃ i k
экскурсие	e k s k u r s i e
экскурсовод	e k s k u r s o v o d
эксперт	e k s p e r t
экспертиэи	e k s p e r t i e i
экспоэицийӗнче	e k s p o e i ts i j ɛ n tʃ e
экэаменне	e k e ɑ m e nː e
электрикре	e l e k t r i k r e
электричество	e l e k t r i tʃ e s t v o
электробуссем	e l e k t r o b u sː e m
электрон	e l e k t r o n
электронлӑ	e l e k t r o n l ʌ
электротехника	e l e k t r o t e χ n i k ɑ
электроэнерги	e l e k t r o e n e r g i
электроэнергипе	e l e k t r o e n e r g i p e
элиста	e l i s t ɑ
элтепер	e l t e p e r
элтепере	e l t e p e r e
элтеперӗ	e l t e p e r ɛ
элчисем	e l tʃ i s e m
эльвира	e l v i r ɑ
элӗк	e l ɛ k
элӗке	e l ɛ k e
элӗксемпе	e l ɛ k s e m p e
эмел	e m e l
эмелсен	e m e l s e n
эмелсене	e m e l s e n e
энциклопеди	e n ts i k l o p e d i
энциклопедине	e n ts i k l o p e d i n e
эольникова	e o l n i k o v ɑ
эоопарка	e o o p ɑ r k ɑ
эохерпа	e o χ e r p ɑ
эоя	e o j ɑ
эп	e p
эпилепсипе	e p i l e p s i p e
эпир	e p i r
эппин	e pː i n
эпӗ	e p ɛ
эрех	e r e χ
эрех-сӑра	e r e χ s ʌ r ɑ
эрех-сӑрапа	e r e χ s ʌ r ɑ p ɑ
эрехпе	e r e χ p e
эреш-алкана	e r e ʃ ɑ l k ɑ n ɑ
эрешсене	e r e ʃ s e n e
эрне	e r n e
эрнекун	e r n e k u n
эрнекунччен	e r n e k u n tʃ tʃ e n
эрнене	e r n e n e
эрнере	e r n e r e
эрнерен	e r n e r e n
эрнинче	e r n i n tʃ e
эс	e s
эсир	e s i r
эстони	e s t o n i
эстонире	e s t o n i r e
эстонла	e s t o n l ɑ
эсӗ	e s ɛ
эсӗр	e s ɛ r
этем	e t e m
этемккене	e t e m kː e n e
этика	e t i k ɑ
этнолог	e t n o l o g
эубрпа	e u b r p ɑ
эффектпа	e f f e k t p ɑ
эх	e χ
юбилей	j u b i l e j
юбиляр	j u b i l j ɑ r
юбка	j u b k ɑ
юл	j u l
юлаймастӑмӑр	j u l ɑ j m ɑ s t ʌ m ʌ r
юлас	j u l ɑ s
юлать	j u l ɑ t
юлашки	j u l ɑ ʃ k i
юлашкинчен	j u l ɑ ʃ k i n tʃ e n
юлма	j u l m ɑ
юлман	j u l m ɑ n
юлмарӗ	j u l m ɑ r ɛ
юлмасть	j u l m ɑ s t
юлмаҫҫӗ	j u l m ɑ ɕː ɛ
юлнӑ	j u l n ʌ
юлнӑскер	j u l n ʌ s k e r
юлташ	j u l t ɑ ʃ
юлташсене	j u l t ɑ ʃ s e n e
юлташӑмсем	j u l t ɑ ʃ ʌ m s e m
юлташӗсем	j u l t ɑ ʃ ɛ s e m
юлташӗсемпе	j u l t ɑ ʃ ɛ s e m p e
юлташӗсене	j u l t ɑ ʃ ɛ s e n e
юлчӗҫ	j u l tʃ ɛ ɕ
юльӑпа	j u l ʌ p ɑ
юля	j u l j ɑ
юлӗ	j u l ɛ
юмах	j u m ɑ χ
юмахри	j u m ɑ χ r i
юн	j u n
юна	j u n ɑ
юнашар	j u n ɑ ʃ ɑ r
юнашарти	j u n ɑ ʃ ɑ r t i
юнне	j u nː e
юнра	j u n r ɑ
юнри	j u n r i
юпа	j u p ɑ
юр	j u r
юр-вар	j u r v ɑ r
юр-варне	j u r v ɑ r n e
юраково	j u r ɑ k o v o
юраман	j u r ɑ m ɑ n
юрамасть	j u r ɑ m ɑ s t
юратаканни	j u r ɑ t ɑ k ɑ nː i
юратаканскер	j u r ɑ t ɑ k ɑ n s k e r
юрататпӑр	j u r ɑ t ɑ t p ʌ r
юратать	j u r ɑ t ɑ t
юрататӑп-ҫке	j u r ɑ t ɑ t ʌ p ɕ k e
юратма	j u r ɑ t m ɑ
юратман	j u r ɑ t m ɑ n
юратмастӑп	j u r ɑ t m ɑ s t ʌ p
юратнине	j u r ɑ t n i n e
юратнӑ	j u r ɑ t n ʌ
юратрӗ	j u r ɑ t r ɛ
юратса	j u r ɑ ts ɑ
юрату	j u r ɑ t u
юратура	j u r ɑ t u r ɑ
юрать	j u r ɑ t
юратӑва	j u r ɑ t ʌ v ɑ
юратӑвне	j u r ɑ t ʌ v n e
юратӑвӗ	j u r ɑ t ʌ v ɛ
юриех	j u r i e χ
юрий	j u r i j
юрист	j u r i s t
юрлама	j u r l ɑ m ɑ
юрланӑ	j u r l ɑ n ʌ
юрра	j u rː ɑ
юрри	j u rː i
юррисене	j u rː i s e n e
юрӑ	j u r ʌ
юрӑ-кӗвӗ	j u r ʌ k ɛ v ɛ
юрӑ-кӗвӗсӗр	j u r ʌ k ɛ v ɛ s ɛ r
юрӑ-ташӑ	j u r ʌ t ɑ ʃ ʌ
юрӑ-ташӑпа	j u r ʌ t ɑ ʃ ʌ p ɑ
юрӑхлӑ	j u r ʌ χ l ʌ
юрӑҫ	j u r ʌ ɕ
юрӗ	j u r ɛ
юсав	j u s ɑ v
юсавра	j u s ɑ v r ɑ
юсавсӑр	j u s ɑ v s ʌ r
юсама	j u s ɑ m ɑ
юсамаллаччӗ	j u s ɑ m ɑ lː ɑ tʃ tʃ ɛ
юсамашкӑн	j u s ɑ m ɑ ʃ k ʌ n
юсанине	j u s ɑ n i n e
юсанмалли	j u s ɑ n m ɑ lː i
юсанӑ	j u s ɑ n ʌ
юсарӑмӑр	j u s ɑ r ʌ m ʌ r
юсасси	j u s ɑ sː i
юсӗҫ	j u s ɛ ɕ
ют	j u t
ютра	j u t r ɑ
ютшӑнмаҫҫӗ	j u tʃ ʌ n m ɑ ɕː ɛ
юхан	j u χ ɑ n
юханшыв	j u χ ɑ n ʃ ɯ v
юханшыва	j u χ ɑ n ʃ ɯ v ɑ
юханшывӗн	j u χ ɑ n ʃ ɯ v ɛ n
юхрӗ	j u χ r ɛ
юхса	j u χ s ɑ
юххана	j u χː ɑ n ɑ
юхӑмне	j u χ ʌ m n e
юхӑмӗ	j u χ ʌ m ɛ
юхӑмӗнче	j u χ ʌ m ɛ n tʃ e
явап	j ɑ v ɑ p
яваплӑ	j ɑ v ɑ p l ʌ
яваплӑхне	j ɑ v ɑ p l ʌ χ n e
явмалли	j ɑ v m ɑ lː i
явнӑ	j ɑ v n ʌ
явнӑччӗ	j ɑ v n ʌ tʃ tʃ ɛ
яврӗҫ	j ɑ v r ɛ ɕ
явӑнать	j ɑ v ʌ n ɑ t
явӑш	j ɑ v ʌ ʃ
явӑҫнӑскер	j ɑ v ʌ ɕ n ʌ s k e r
явӑҫтарма	j ɑ v ʌ ɕ t ɑ r m ɑ
явӑҫтармалли	j ɑ v ʌ ɕ t ɑ r m ɑ lː i
якку	j ɑ kː u
яковлевӑн	j ɑ k o v l e v ʌ n
якур	j ɑ k u r
ял	j ɑ l
яла	j ɑ l ɑ
ялавӗпе	j ɑ l ɑ v ɛ p e
ялан	j ɑ l ɑ n
яланах	j ɑ l ɑ n ɑ χ
яланхиллех	j ɑ l ɑ n χ i lː e χ
ялйыш	j ɑ l j ɯ ʃ
ялне	j ɑ l n e
ялнелле	j ɑ l n e lː e
ялсене	j ɑ l s e n e
ялсенчен	j ɑ l s e n tʃ e n
ялсенчи	j ɑ l s e n tʃ i
ялта	j ɑ l t ɑ
ялтан	j ɑ l t ɑ n
ялтах	j ɑ l t ɑ χ
ялти	j ɑ l t i
ялтӑркка	j ɑ l t ʌ r kː ɑ
ялӑн	j ɑ l ʌ n
ялӗ	j ɑ l ɛ
ялӗнче	j ɑ l ɛ n tʃ e
ялӗнчен	j ɑ l ɛ n tʃ e n
ялӗнчи	j ɑ l ɛ n tʃ i
ялӗсем	j ɑ l ɛ s e m
ялӗсен	j ɑ l ɛ s e n
ялӗсенче	j ɑ l ɛ s e n tʃ e
яма	j ɑ m ɑ
ямалла	j ɑ m ɑ lː ɑ
ямаллах	j ɑ m ɑ lː ɑ χ
яман	j ɑ m ɑ n
яманак	j ɑ m ɑ n ɑ k
янкӑр	j ɑ n k ʌ r
янтӑлаҫҫӗ	j ɑ n t ʌ l ɑ ɕː ɛ
янӑ	j ɑ n ʌ
янӑ-тӑр	j ɑ n ʌ t ʌ r
янӑ-ши	j ɑ n ʌ ʃ i
янӑравӗпе	j ɑ n ʌ r ɑ v ɛ p e
янӑрать	j ɑ n ʌ r ɑ t
янӑскере	j ɑ n ʌ s k e r e
япала	j ɑ p ɑ l ɑ
япалан	j ɑ p ɑ l ɑ n
япалана	j ɑ p ɑ l ɑ n ɑ
япаланах	j ɑ p ɑ l ɑ n ɑ χ
япалапа	j ɑ p ɑ l ɑ p ɑ
япаласем	j ɑ p ɑ l ɑ s e m
япаласен	j ɑ p ɑ l ɑ s e n
япаласене	j ɑ p ɑ l ɑ s e n e
япали	j ɑ p ɑ l i
япрак	j ɑ p r ɑ k
япӑх	j ɑ p ʌ χ
япӑхланнӑ	j ɑ p ʌ χ l ɑ nː ʌ
япӑхлансах	j ɑ p ʌ χ l ɑ n s ɑ χ
япӑхрах	j ɑ p ʌ χ r ɑ χ
ярайман	j ɑ r ɑ j m ɑ n
ярас	j ɑ r ɑ s
ярать	j ɑ r ɑ t
яраҫҫӗ	j ɑ r ɑ ɕː ɛ
ярлӑксемпе	j ɑ r l ʌ k s e m p e
ярмӑрккӑ	j ɑ r m ʌ r kː ʌ
ярославль	j ɑ r o s l ɑ v l
ярса	j ɑ r s ɑ
ярӑн	j ɑ r ʌ n
ярӑнаймастӑм	j ɑ r ʌ n ɑ j m ɑ s t ʌ m
ярӑнакан	j ɑ r ʌ n ɑ k ɑ n
ярӑннӑ	j ɑ r ʌ nː ʌ
ярӑнса	j ɑ r ʌ n s ɑ
ярӑнтараҫҫӗ	j ɑ r ʌ n t ɑ r ɑ ɕː ɛ
ят	j ɑ t
ят-шыва	j ɑ tʃ ɯ v ɑ
ята	j ɑ t ɑ
ятарласа	j ɑ t ɑ r l ɑ s ɑ
ятарлӑ	j ɑ t ɑ r l ʌ
ятларӗ	j ɑ t l ɑ r ɛ
ятлӑ	j ɑ t l ʌ
ятне	j ɑ t n e
ятпа	j ɑ t p ɑ
ятран	j ɑ t r ɑ n
ятӑм	j ɑ t ʌ m
ятӑмӑр	j ɑ t ʌ m ʌ r
ятӗнченех	j ɑ t ɛ n tʃ e n e χ
яхтисене	j ɑ χ t i s e n e
яхӑн	j ɑ χ ʌ n
ячӗ	j ɑ tʃ ɛ
ячӗллӗ	j ɑ tʃ ɛ lː ɛ
ячӗпе	j ɑ tʃ ɛ p e
ячӗҫ	j ɑ tʃ ɛ ɕ
яш-кӗрӗме	j ɑ ʃ k ɛ r ɛ m e
яш-кӗрӗмпе	j ɑ ʃ k ɛ r ɛ m p e
яшка	j ɑ ʃ k ɑ
яшкана	j ɑ ʃ k ɑ n ɑ
яшсемпе	j ɑ ʃ s e m p e
яшӑн	j ɑ ʃ ʌ n
ҫ	ɕ
ҫав	ɕ ɑ v
ҫавал	ɕ ɑ v ɑ l
ҫавна	ɕ ɑ v n ɑ
ҫавнашкал	ɕ ɑ v n ɑ ʃ k ɑ l
ҫавнашкалах	ɕ ɑ v n ɑ ʃ k ɑ l ɑ χ
ҫавра	ɕ ɑ v r ɑ
ҫаврӑнаҫҫӗ	ɕ ɑ v r ʌ n ɑ ɕː ɛ
ҫаврӑннӑ	ɕ ɑ v r ʌ nː ʌ
ҫавсен	ɕ ɑ v s e n
ҫавсене	ɕ ɑ v s e n e
ҫавӑн	ɕ ɑ v ʌ n
ҫавӑнпа	ɕ ɑ v ʌ n p ɑ
ҫавӑнпах	ɕ ɑ v ʌ n p ɑ χ
ҫавӑнта	ɕ ɑ v ʌ n t ɑ
ҫавӑнтан	ɕ ɑ v ʌ n t ɑ n
ҫавӑнтанпа	ɕ ɑ v ʌ n t ɑ n p ɑ
ҫавӑнтах	ɕ ɑ v ʌ n t ɑ χ
ҫавӑншӑн	ɕ ɑ v ʌ n ʃ ʌ n
ҫавӑрнӑскер	ɕ ɑ v ʌ r n ʌ s k e r
ҫавӑрса	ɕ ɑ v ʌ r s ɑ
ҫавӑртӑмӑр	ɕ ɑ v ʌ r t ʌ m ʌ r
ҫавӑтса	ɕ ɑ v ʌ ts ɑ
ҫак	ɕ ɑ k
ҫакланни	ɕ ɑ k l ɑ nː i
ҫакланнӑ	ɕ ɑ k l ɑ nː ʌ
ҫакна	ɕ ɑ k n ɑ
ҫакнашкал	ɕ ɑ k n ɑ ʃ k ɑ l
ҫаксене	ɕ ɑ k s e n e
ҫакӑ	ɕ ɑ k ʌ
ҫакӑн	ɕ ɑ k ʌ n
ҫакӑнса	ɕ ɑ k ʌ n s ɑ
ҫакӑнта	ɕ ɑ k ʌ n t ɑ
ҫакӑнтан	ɕ ɑ k ʌ n t ɑ n
ҫамрӑк	ɕ ɑ m r ʌ k
ҫамрӑкланать	ɕ ɑ m r ʌ k l ɑ n ɑ t
ҫамрӑксем	ɕ ɑ m r ʌ k s e m
ҫамрӑксен	ɕ ɑ m r ʌ k s e n
ҫамрӑксене	ɕ ɑ m r ʌ k s e n e
ҫамрӑксенче	ɕ ɑ m r ʌ k s e n tʃ e
ҫамрӑксенчен	ɕ ɑ m r ʌ k s e n tʃ e n
ҫамрӑкскер	ɕ ɑ m r ʌ k s k e r
ҫамрӑкӗсем	ɕ ɑ m r ʌ k ɛ s e m
ҫамӑрксен	ɕ ɑ m ʌ r k s e n
ҫанталӑк	ɕ ɑ n t ɑ l ʌ k
ҫанталӑка	ɕ ɑ n t ɑ l ʌ k ɑ
ҫанӑ	ɕ ɑ n ʌ
ҫапах	ɕ ɑ p ɑ χ
ҫапкаланчӑк	ɕ ɑ p k ɑ l ɑ n tʃ ʌ k
ҫапла	ɕ ɑ p l ɑ
ҫапларах	ɕ ɑ p l ɑ r ɑ χ
ҫаплах	ɕ ɑ p l ɑ χ
ҫапма	ɕ ɑ p m ɑ
ҫапса	ɕ ɑ p s ɑ
ҫаптарчӗ	ɕ ɑ p t ɑ r tʃ ɛ
ҫапӑҫнӑ	ɕ ɑ p ʌ ɕ n ʌ
ҫапӑҫса	ɕ ɑ p ʌ ɕ s ɑ
ҫапӑҫу	ɕ ɑ p ʌ ɕ u
ҫапӑҫура	ɕ ɑ p ʌ ɕ u r ɑ
ҫапӑҫуран	ɕ ɑ p ʌ ɕ u r ɑ n
ҫапӑҫусем	ɕ ɑ p ʌ ɕ u s e m
ҫапӑҫусене	ɕ ɑ p ʌ ɕ u s e n e
ҫапӑҫусенче	ɕ ɑ p ʌ ɕ u s e n tʃ e
ҫар	ɕ ɑ r
ҫарамас	ɕ ɑ r ɑ m ɑ s
ҫармӑс	ɕ ɑ r m ʌ s
ҫарпуҫӗсемпе	ɕ ɑ r p u ɕ ɛ s e m p e
ҫартан	ɕ ɑ r t ɑ n
ҫемйи	ɕ e m j i
ҫемйине	ɕ e m j i n e
ҫемйипе	ɕ e m j i p e
ҫемйипех	ɕ e m j i p e χ
ҫемйисем	ɕ e m j i s e m
ҫемье	ɕ e m e
ҫемьеленнӗ-и	ɕ e m e l e nː ɛ i
ҫемьеллисемшӗн	ɕ e m e lː i s e m ʃ ɛ n
ҫемьен	ɕ e m e n
ҫемьене	ɕ e m e n e
ҫемьере	ɕ e m e r e
ҫемьери	ɕ e m e r i
ҫемьесене	ɕ e m e s e n e
ҫемьешӗн	ɕ e m e ʃ ɛ n
ҫемҫе	ɕ e m ɕ e
ҫепӗҫ	ɕ e p ɛ ɕ
ҫепӗҫлӗхне	ɕ e p ɛ ɕ l ɛ χ n e
ҫеҫ	ɕ e ɕ
ҫеҫ-и	ɕ e ɕ i
ҫеҫмер	ɕ e ɕ m e r
ҫеҫпӗл	ɕ e ɕ p ɛ l
ҫи	ɕ i
ҫивиттисем	ɕ i v i tː i s e m
ҫивӗттине	ɕ i v ɛ tː i n e
ҫивӗч	ɕ i v ɛ tʃ
ҫивӗчленме	ɕ i v ɛ tʃ l e n m e
ҫивӗчӗ	ɕ i v ɛ tʃ ɛ
ҫиеле	ɕ i e l e
ҫиелтен	ɕ i e l t e n
ҫиелти	ɕ i e l t i
ҫиес	ɕ i e s
ҫиесшӗн	ɕ i e s ʃ ɛ n
ҫиет	ɕ i e t
ҫиеҫҫӗ	ɕ i e ɕː ɛ
ҫийӗнче	ɕ i j ɛ n tʃ e
ҫийӗнчех	ɕ i j ɛ n tʃ e χ
ҫил	ɕ i l
ҫилленме	ɕ i lː e n m e
ҫилленнӗ	ɕ i lː e nː ɛ
ҫилпе	ɕ i l p e
ҫимеллисӗр	ɕ i m e lː i s ɛ r
ҫиместӗп	ɕ i m e s t ɛ p
ҫимӗҫ	ɕ i m ɛ ɕ
ҫимӗҫӗсен	ɕ i m ɛ ɕ ɛ s e n
ҫине	ɕ i n e
ҫинелле	ɕ i n e lː e
ҫинче	ɕ i n tʃ e
ҫинчен	ɕ i n tʃ e n
ҫинчеччӗ	ɕ i n tʃ e tʃ tʃ ɛ
ҫинчи	ɕ i n tʃ i
ҫинӗ	ɕ i n ɛ
ҫиппе	ɕ i pː e
ҫирӗме	ɕ i r ɛ m e
ҫирӗмрен	ɕ i r ɛ m r e n
ҫирӗп	ɕ i r ɛ p
ҫирӗп-ха	ɕ i r ɛ p χ ɑ
ҫирӗплетес	ɕ i r ɛ p l e t e s
ҫирӗплетесси	ɕ i r ɛ p l e t e sː i
ҫирӗплетесшӗн	ɕ i r ɛ p l e t e s ʃ ɛ n
ҫирӗплетме	ɕ i r ɛ p l e t m e
ҫирӗплетмелле	ɕ i r ɛ p l e t m e lː e
ҫирӗплетмелли	ɕ i r ɛ p l e t m e lː i
ҫирӗплетнӗ	ɕ i r ɛ p l e t n ɛ
ҫирӗплетӗҫ	ɕ i r ɛ p l e t ɛ ɕ
ҫирӗплӗхне	ɕ i r ɛ p l ɛ χ n e
ҫисе	ɕ i s e
ҫитеймен	ɕ i t e j m e n
ҫитеймесен	ɕ i t e j m e s e n
ҫитеймест	ɕ i t e j m e s t
ҫитейместчӗ	ɕ i t e j m e s t tʃ ɛ
ҫитеймеҫҫӗ	ɕ i t e j m e ɕː ɛ
ҫитекенни	ɕ i t e k e nː i
ҫитекенсен	ɕ i t e k e n s e n
ҫителӗклӗ	ɕ i t e l ɛ k l ɛ
ҫителӗксӗр	ɕ i t e l ɛ k s ɛ r
ҫителӗксӗртен-ши	ɕ i t e l ɛ k s ɛ r t e n ʃ i
ҫитереймен-ши	ɕ i t e r e j m e n ʃ i
ҫитерессине	ɕ i t e r e sː i n e
ҫитересшӗн-ха	ɕ i t e r e s ʃ ɛ n χ ɑ
ҫитерме	ɕ i t e r m e
ҫитермешкӗн	ɕ i t e r m e ʃ k ɛ n
ҫитернӗ	ɕ i t e r n ɛ
ҫитерчӗҫ	ɕ i t e r tʃ ɛ ɕ
ҫитес	ɕ i t e s
ҫитессине	ɕ i t e sː i n e
ҫитет	ɕ i t e t
ҫитетӗп	ɕ i t e t ɛ p
ҫитеҫҫӗ	ɕ i t e ɕː ɛ
ҫити	ɕ i t i
ҫитиччен	ɕ i t i tʃ tʃ e n
ҫитме	ɕ i t m e
ҫитмелле	ɕ i t m e lː e
ҫитмеллеччӗ	ɕ i t m e lː e tʃ tʃ ɛ
ҫитмеллине	ɕ i t m e lː i n e
ҫитмен	ɕ i t m e n
ҫитмен-ха	ɕ i t m e n χ ɑ
ҫитменлӗх	ɕ i t m e n l ɛ χ
ҫитменлӗхе	ɕ i t m e n l ɛ χ e
ҫитменлӗхсене	ɕ i t m e n l ɛ χ s e n e
ҫитменнипе	ɕ i t m e nː i p e
ҫитменнисен	ɕ i t m e nː i s e n
ҫитмест	ɕ i t m e s t
ҫитмӗл	ɕ i t m ɛ l
ҫитнисене	ɕ i t n i s e n e
ҫитнӗ	ɕ i t n ɛ
ҫитнӗччӗ	ɕ i t n ɛ tʃ tʃ ɛ
ҫитрӗ	ɕ i t r ɛ
ҫитрӗм	ɕ i t r ɛ m
ҫитрӗҫ	ɕ i t r ɛ ɕ
ҫитсе	ɕ i ts e
ҫитсен	ɕ i ts e n
ҫитӗ	ɕ i t ɛ
ҫитӗнекен	ɕ i t ɛ n e k e n
ҫитӗнет	ɕ i t ɛ n e t
ҫитӗннӗ	ɕ i t ɛ nː ɛ
ҫитӗнӗвне	ɕ i t ɛ n ɛ v n e
ҫитӗнӳ	ɕ i t ɛ n y
ҫитӗнӳсем	ɕ i t ɛ n y s e m
ҫиччӗ	ɕ i tʃ tʃ ɛ
ҫиччӗмӗш	ɕ i tʃ tʃ ɛ m ɛ ʃ
ҫиҫтерсе	ɕ i ɕ t e r s e
ҫу	ɕ u
ҫу-у-ук	ɕ u u u k
ҫу-ҫӗртме	ɕ u ɕ ɛ r t m e
ҫук	ɕ u k
ҫук-ши	ɕ u k ʃ i
ҫуккипе	ɕ u kː i p e
ҫукчӗ	ɕ u k tʃ ɛ
ҫул	ɕ u l
ҫул-йӗр	ɕ u l j ɛ r
ҫула	ɕ u l ɑ
ҫулах	ɕ u l ɑ χ
ҫулла	ɕ u lː ɑ
ҫуллана	ɕ u lː ɑ n ɑ
ҫуллахи	ɕ u lː ɑ χ i
ҫулленех	ɕ u lː e n e χ
ҫуллӑ	ɕ u lː ʌ
ҫулмалли	ɕ u l m ɑ lː i
ҫулне	ɕ u l n e
ҫулпа	ɕ u l p ɑ
ҫулран	ɕ u l r ɑ n
ҫулсем	ɕ u l s e m
ҫулсене	ɕ u l s e n e
ҫулсенче	ɕ u l s e n tʃ e
ҫулсерен	ɕ u l s e r e n
ҫулта	ɕ u l t ɑ
ҫулталӑк	ɕ u l t ɑ l ʌ k
ҫулталӑкра	ɕ u l t ɑ l ʌ k r ɑ
ҫултан	ɕ u l t ɑ n
ҫултах	ɕ u l t ɑ χ
ҫулти	ɕ u l t i
ҫулхи	ɕ u l χ i
ҫулҫӳреве	ɕ u l ɕ y r e v e
ҫулҫӳревҫӗ	ɕ u l ɕ y r e v ɕ ɛ
ҫулӑм	ɕ u l ʌ m
ҫулӑма	ɕ u l ʌ m ɑ
ҫулӑмра	ɕ u l ʌ m r ɑ
ҫулӑн	ɕ u l ʌ n
ҫулӗ	ɕ u l ɛ
ҫулӗн	ɕ u l ɛ n
ҫулӗсенче	ɕ u l ɛ s e n tʃ e
ҫума	ɕ u m ɑ
ҫумне	ɕ u m n e
ҫумра	ɕ u m r ɑ
ҫумранах	ɕ u m r ɑ n ɑ χ
ҫумӑн	ɕ u m ʌ n
ҫумӑр	ɕ u m ʌ r
ҫумӑрпа	ɕ u m ʌ r p ɑ
ҫумӑрта	ɕ u m ʌ r t ɑ
ҫумӗ	ɕ u m ɛ
ҫумӗнче	ɕ u m ɛ n tʃ e
ҫумӗнчи	ɕ u m ɛ n tʃ i
ҫунакан	ɕ u n ɑ k ɑ n
ҫунатлӑ	ɕ u n ɑ t l ʌ
ҫунаттисене	ɕ u n ɑ tː i s e n e
ҫуннӑ	ɕ u nː ʌ
ҫунса	ɕ u n s ɑ
ҫунӑ	ɕ u n ʌ
ҫунӑччӗ	ɕ u n ʌ tʃ tʃ ɛ
ҫунӗ	ɕ u n ɛ
ҫупӑрларӗҫ	ɕ u p ʌ r l ɑ r ɛ ɕ
ҫур	ɕ u r
ҫуралама	ɕ u r ɑ l ɑ m ɑ
ҫураласран	ɕ u r ɑ l ɑ s r ɑ n
ҫуралман	ɕ u r ɑ l m ɑ n
ҫурални	ɕ u r ɑ l n i
ҫуралнӑ	ɕ u r ɑ l n ʌ
ҫуралнӑскере	ɕ u r ɑ l n ʌ s k e r e
ҫуралнӑскерсем	ɕ u r ɑ l n ʌ s k e r s e m
ҫуралса	ɕ u r ɑ l s ɑ
ҫуралсан	ɕ u r ɑ l s ɑ n
ҫуралсанах	ɕ u r ɑ l s ɑ n ɑ χ
ҫуран	ɕ u r ɑ n
ҫуратакансене	ɕ u r ɑ t ɑ k ɑ n s e n e
ҫуратать	ɕ u r ɑ t ɑ t
ҫуратмалли	ɕ u r ɑ t m ɑ lː i
ҫуратни	ɕ u r ɑ t n i
ҫуратнӑ	ɕ u r ɑ t n ʌ
ҫуратрӑм-шим	ɕ u r ɑ t r ʌ m ʃ i m
ҫуратрӗ	ɕ u r ɑ t r ɛ
ҫуратса	ɕ u r ɑ ts ɑ
ҫуркаланнӑ	ɕ u r k ɑ l ɑ nː ʌ
ҫуркунне	ɕ u r k u nː e
ҫуркуннехи	ɕ u r k u nː e χ i
ҫурла	ɕ u r l ɑ
ҫурса	ɕ u r s ɑ
ҫурт	ɕ u r t
ҫурта	ɕ u r t ɑ
ҫуртне	ɕ u r t n e
ҫуртпа	ɕ u r t p ɑ
ҫуртра	ɕ u r t r ɑ
ҫуртран	ɕ u r t r ɑ n
ҫуртсене	ɕ u r ts e n e
ҫуртшӑн	ɕ u r tʃ ʌ n
ҫуртӑн	ɕ u r t ʌ n
ҫуртӗнче	ɕ u r t ɛ n tʃ e
ҫуртӗнчен	ɕ u r t ɛ n tʃ e n
ҫуртӗнчи	ɕ u r t ɛ n tʃ i
ҫурхахӗ	ɕ u r χ ɑ χ ɛ
ҫурхи	ɕ u r χ i
ҫурчӗ	ɕ u r tʃ ɛ
ҫурчӗсем	ɕ u r tʃ ɛ s e m
ҫурчӗсен	ɕ u r tʃ ɛ s e n
ҫурҫӗр	ɕ u r ɕ ɛ r
ҫурӑ	ɕ u r ʌ
ҫурӑксем	ɕ u r ʌ k s e m
ҫурӑлнине	ɕ u r ʌ l n i n e
ҫурӑлса	ɕ u r ʌ l s ɑ
ҫурӑмӗ	ɕ u r ʌ m ɛ
ҫуса	ɕ u s ɑ
ҫут	ɕ u t
ҫуталса	ɕ u t ɑ l s ɑ
ҫутатать	ɕ u t ɑ t ɑ t
ҫутатса	ɕ u t ɑ ts ɑ
ҫути	ɕ u t i
ҫутӑ	ɕ u t ʌ
ҫутӑлма	ɕ u t ʌ l m ɑ
ҫутӑпа	ɕ u t ʌ p ɑ
ҫутӑрах	ɕ u t ʌ r ɑ χ
ҫутӑсем	ɕ u t ʌ s e m
ҫутӗҫ	ɕ u t ɛ ɕ
ҫухалать	ɕ u χ ɑ l ɑ t
ҫухалма	ɕ u χ ɑ l m ɑ
ҫухални	ɕ u χ ɑ l n i
ҫухалнине	ɕ u χ ɑ l n i n e
ҫухалнӑ	ɕ u χ ɑ l n ʌ
ҫухалса	ɕ u χ ɑ l s ɑ
ҫухалсан	ɕ u χ ɑ l s ɑ n
ҫухалчӗ	ɕ u χ ɑ l tʃ ɛ
ҫухатать	ɕ u χ ɑ t ɑ t
ҫухатмарӑм	ɕ u χ ɑ t m ɑ r ʌ m
ҫухатнӑ	ɕ u χ ɑ t n ʌ
ҫухатнӑскер	ɕ u χ ɑ t n ʌ s k e r
ҫухатнӑскерсен	ɕ u χ ɑ t n ʌ s k e r s e n
ҫухатнӑччӗю	ɕ u χ ɑ t n ʌ tʃ tʃ ɛ j u
ҫухатрӑн	ɕ u χ ɑ t r ʌ n
ҫухатусем	ɕ u χ ɑ t u s e m
ҫухатӑва	ɕ u χ ɑ t ʌ v ɑ
ҫухрӑмран	ɕ u χ r ʌ m r ɑ n
ҫухӑрнине	ɕ u χ ʌ r n i n e
ҫывхараймӑн	ɕ ɯ v χ ɑ r ɑ j m ʌ n
ҫывхарать	ɕ ɯ v χ ɑ r ɑ t
ҫывӑратӑп	ɕ ɯ v ʌ r ɑ t ʌ p
ҫывӑраҫҫӗ	ɕ ɯ v ʌ r ɑ ɕː ɛ
ҫывӑрма	ɕ ɯ v ʌ r m ɑ
ҫывӑрса	ɕ ɯ v ʌ r s ɑ
ҫывӑрсах	ɕ ɯ v ʌ r s ɑ χ
ҫывӑрттарма	ɕ ɯ v ʌ r tː ɑ r m ɑ
ҫывӑх	ɕ ɯ v ʌ χ
ҫывӑхарах	ɕ ɯ v ʌ χ ɑ r ɑ χ
ҫывӑхланӗ	ɕ ɯ v ʌ χ l ɑ n ɛ
ҫывӑхне	ɕ ɯ v ʌ χ n e
ҫывӑхнерех	ɕ ɯ v ʌ χ n e r e χ
ҫывӑхра	ɕ ɯ v ʌ χ r ɑ
ҫывӑхри	ɕ ɯ v ʌ χ r i
ҫывӑхӗнче	ɕ ɯ v ʌ χ ɛ n tʃ e
ҫывӑхӗнчи	ɕ ɯ v ʌ χ ɛ n tʃ i
ҫын	ɕ ɯ n
ҫынна	ɕ ɯ nː ɑ
ҫыннин	ɕ ɯ nː i n
ҫыннипе	ɕ ɯ nː i p e
ҫыннисем	ɕ ɯ nː i s e m
ҫыннисемпе	ɕ ɯ nː i s e m p e
ҫыннисемшӗн	ɕ ɯ nː i s e m ʃ ɛ n
ҫыннисен	ɕ ɯ nː i s e n
ҫыннисене	ɕ ɯ nː i s e n e
ҫыннӑн	ɕ ɯ nː ʌ n
ҫынпа	ɕ ɯ n p ɑ
ҫынсем	ɕ ɯ n s e m
ҫынсемпе	ɕ ɯ n s e m p e
ҫынсемсӗр	ɕ ɯ n s e m s ɛ r
ҫынсемшӗн	ɕ ɯ n s e m ʃ ɛ n
ҫынсен	ɕ ɯ n s e n
ҫынсене	ɕ ɯ n s e n e
ҫыпӑҫтаркӑчсем	ɕ ɯ p ʌ ɕ t ɑ r k ʌ tʃ s e m
ҫырава	ɕ ɯ r ɑ v ɑ
ҫыравҫин	ɕ ɯ r ɑ v ɕ i n
ҫыравҫӑ	ɕ ɯ r ɑ v ɕ ʌ
ҫыравҫӑсем	ɕ ɯ r ɑ v ɕ ʌ s e m
ҫыракан	ɕ ɯ r ɑ k ɑ n
ҫыран	ɕ ɯ r ɑ n
ҫыранлӑхне	ɕ ɯ r ɑ n l ʌ χ n e
ҫырас	ɕ ɯ r ɑ s
ҫыраҫҫӗ	ɕ ɯ r ɑ ɕː ɛ
ҫырлах	ɕ ɯ r l ɑ χ
ҫырлахас	ɕ ɯ r l ɑ χ ɑ s
ҫырлахма	ɕ ɯ r l ɑ χ m ɑ
ҫырлахмаҫҫӗ	ɕ ɯ r l ɑ χ m ɑ ɕː ɛ
ҫырлахнӑ	ɕ ɯ r l ɑ χ n ʌ
ҫырли	ɕ ɯ r l i
ҫырма	ɕ ɯ r m ɑ
ҫырмалла	ɕ ɯ r m ɑ lː ɑ
ҫырмана	ɕ ɯ r m ɑ n ɑ
ҫырмапа	ɕ ɯ r m ɑ p ɑ
ҫырмасем	ɕ ɯ r m ɑ s e m
ҫырнӑ	ɕ ɯ r n ʌ
ҫырнӑччӗ	ɕ ɯ r n ʌ tʃ tʃ ɛ
ҫырса	ɕ ɯ r s ɑ
ҫыртарасси	ɕ ɯ r t ɑ r ɑ sː i
ҫыртса	ɕ ɯ r ts ɑ
ҫыру	ɕ ɯ r u
ҫырулӑхӗн	ɕ ɯ r u l ʌ χ ɛ n
ҫырупа	ɕ ɯ r u p ɑ
ҫырура	ɕ ɯ r u r ɑ
ҫырусем	ɕ ɯ r u s e m
ҫырусемпе	ɕ ɯ r u s e m p e
ҫырусене	ɕ ɯ r u s e n e
ҫырчӗҫ	ɕ ɯ r tʃ ɛ ɕ
ҫырӑвне	ɕ ɯ r ʌ v n e
ҫырӑннисем	ɕ ɯ r ʌ nː i s e m
ҫырӑнӑр	ɕ ɯ r ʌ n ʌ r
ҫыхрӗҫ	ɕ ɯ χ r ɛ ɕ
ҫыхӑнатпӑр	ɕ ɯ χ ʌ n ɑ t p ʌ r
ҫыхӑнать	ɕ ɯ χ ʌ n ɑ t
ҫыхӑнма	ɕ ɯ χ ʌ n m ɑ
ҫыхӑнни	ɕ ɯ χ ʌ nː i
ҫыхӑннин	ɕ ɯ χ ʌ nː i n
ҫыхӑннисене	ɕ ɯ χ ʌ nː i s e n e
ҫыхӑннӑ	ɕ ɯ χ ʌ nː ʌ
ҫыхӑнтарма	ɕ ɯ χ ʌ n t ɑ r m ɑ
ҫыхӑну	ɕ ɯ χ ʌ n u
ҫыхӑнӑва	ɕ ɯ χ ʌ n ʌ v ɑ
ҫӑва	ɕ ʌ v ɑ
ҫӑвана	ɕ ʌ v ɑ n ɑ
ҫӑвар	ɕ ʌ v ɑ r
ҫӑвара	ɕ ʌ v ɑ r ɑ
ҫӑвать-и	ɕ ʌ v ɑ t i
ҫӑвӑнса	ɕ ʌ v ʌ n s ɑ
ҫӑвӗ	ɕ ʌ v ɛ
ҫӑвӗпех	ɕ ʌ v ɛ p e χ
ҫӑка	ɕ ʌ k ɑ
ҫӑкӑр	ɕ ʌ k ʌ r
ҫӑкӑра	ɕ ʌ k ʌ r ɑ
ҫӑкӑрлӑх	ɕ ʌ k ʌ r l ʌ χ
ҫӑкӑрпа	ɕ ʌ k ʌ r p ɑ
ҫӑл	ɕ ʌ l
ҫӑла	ɕ ʌ l ɑ
ҫӑлавҫӑсем	ɕ ʌ l ɑ v ɕ ʌ s e m
ҫӑлавҫӑсене	ɕ ʌ l ɑ v ɕ ʌ s e n e
ҫӑлатӑп	ɕ ʌ l ɑ t ʌ p
ҫӑлмалла	ɕ ʌ l m ɑ lː ɑ
ҫӑлра	ɕ ʌ l r ɑ
ҫӑлса	ɕ ʌ l s ɑ
ҫӑлти	ɕ ʌ l t i
ҫӑлтӑрпа	ɕ ʌ l t ʌ r p ɑ
ҫӑлтӑрсем	ɕ ʌ l t ʌ r s e m
ҫӑлтӑрсене	ɕ ʌ l t ʌ r s e n e
ҫӑм	ɕ ʌ m
ҫӑмарта	ɕ ʌ m ɑ r t ɑ
ҫӑмӑл	ɕ ʌ m ʌ l
ҫӑмӑлах	ɕ ʌ m ʌ l ɑ χ
ҫӑмӑллӑнах	ɕ ʌ m ʌ lː ʌ n ɑ χ
ҫӑмӑллӑха	ɕ ʌ m ʌ lː ʌ χ ɑ
ҫӑмӑлрах	ɕ ʌ m ʌ l r ɑ χ
ҫӑмӑлттай	ɕ ʌ m ʌ l tː ɑ j
ҫӑмӗ	ɕ ʌ m ɛ
ҫӑп-ҫӑра	ɕ ʌ p ɕ ʌ r ɑ
ҫӑрса	ɕ ʌ r s ɑ
ҫӑрӑлать	ɕ ʌ r ʌ l ɑ t
ҫӑткӑн	ɕ ʌ t k ʌ n
ҫӑтса	ɕ ʌ ts ɑ
ҫӗклекен	ɕ ɛ k l e k e n
ҫӗкленет	ɕ ɛ k l e n e t
ҫӗкленнӗ	ɕ ɛ k l e nː ɛ
ҫӗкленчӗ	ɕ ɛ k l e n tʃ ɛ
ҫӗкленӗ	ɕ ɛ k l e n ɛ
ҫӗклерӗ	ɕ ɛ k l e r ɛ
ҫӗклесси	ɕ ɛ k l e sː i
ҫӗлен	ɕ ɛ l e n
ҫӗлесе	ɕ ɛ l e s e
ҫӗлеттертӗмӗр	ɕ ɛ l e tː e r t ɛ m ɛ r
ҫӗлӗкӗ	ɕ ɛ l ɛ k ɛ
ҫӗмӗрле	ɕ ɛ m ɛ r l e
ҫӗмӗрлене	ɕ ɛ m ɛ r l e n e
ҫӗмӗрлерен	ɕ ɛ m ɛ r l e r e n
ҫӗмӗрлесем	ɕ ɛ m ɛ r l e s e m
ҫӗмӗрт	ɕ ɛ m ɛ r t
ҫӗмӗрӗлнӗ	ɕ ɛ m ɛ r ɛ l n ɛ
ҫӗмӗрӗлсе	ɕ ɛ m ɛ r ɛ l s e
ҫӗнетес	ɕ ɛ n e t e s
ҫӗнетеҫҫӗ	ɕ ɛ n e t e ɕː ɛ
ҫӗнетме	ɕ ɛ n e t m e
ҫӗнетмешкӗн	ɕ ɛ n e t m e ʃ k ɛ n
ҫӗнетнине	ɕ ɛ n e t n i n e
ҫӗнетнӗ	ɕ ɛ n e t n ɛ
ҫӗнетрӗҫ	ɕ ɛ n e t r ɛ ɕ
ҫӗнни	ɕ ɛ nː i
ҫӗннине	ɕ ɛ nː i n e
ҫӗнсе	ɕ ɛ n s e
ҫӗнтерееҫҫӗ-ши	ɕ ɛ n t e r e e ɕː ɛ ʃ i
ҫӗнтерессе	ɕ ɛ n t e r e sː e
ҫӗнтерет	ɕ ɛ n t e r e t
ҫӗнтереҫҫӗ	ɕ ɛ n t e r e ɕː ɛ
ҫӗнтерме	ɕ ɛ n t e r m e
ҫӗнтерни	ɕ ɛ n t e r n i
ҫӗнтернӗ	ɕ ɛ n t e r n ɛ
ҫӗнтерчӗ	ɕ ɛ n t e r tʃ ɛ
ҫӗнтерӗвӗнче	ɕ ɛ n t e r ɛ v ɛ n tʃ e
ҫӗнтерӳҫине	ɕ ɛ n t e r y ɕ i n e
ҫӗнтерӳҫӗсене	ɕ ɛ n t e r y ɕ ɛ s e n e
ҫӗньялта	ɕ ɛ n j ɑ l t ɑ
ҫӗнӗ	ɕ ɛ n ɛ
ҫӗнӗлӗхсене	ɕ ɛ n ɛ l ɛ χ s e n e
ҫӗнӗрен	ɕ ɛ n ɛ r e n
ҫӗпре	ɕ ɛ p r e
ҫӗр	ɕ ɛ r
ҫӗр-шывне	ɕ ɛ r ʃ ɯ v n e
ҫӗр-ҫӗр	ɕ ɛ r ɕ ɛ r
ҫӗре	ɕ ɛ r e
ҫӗрле	ɕ ɛ r l e
ҫӗрме	ɕ ɛ r m e
ҫӗрпе	ɕ ɛ r p e
ҫӗрпӗве	ɕ ɛ r p ɛ v e
ҫӗрпӳ	ɕ ɛ r p y
ҫӗрпӳелсем	ɕ ɛ r p y e l s e m
ҫӗрпӳре	ɕ ɛ r p y r e
ҫӗрте	ɕ ɛ r t e
ҫӗртен	ɕ ɛ r t e n
ҫӗртме	ɕ ɛ r t m e
ҫӗрулми	ɕ ɛ r u l m i
ҫӗршыв	ɕ ɛ r ʃ ɯ v
ҫӗршыва	ɕ ɛ r ʃ ɯ v ɑ
ҫӗршывра	ɕ ɛ r ʃ ɯ v r ɑ
ҫӗршыври	ɕ ɛ r ʃ ɯ v r i
ҫӗршывсем	ɕ ɛ r ʃ ɯ v s e m
ҫӗршывсене	ɕ ɛ r ʃ ɯ v s e n e
ҫӗршывӑм	ɕ ɛ r ʃ ɯ v ʌ m
ҫӗршывӑн	ɕ ɛ r ʃ ɯ v ʌ n
ҫӗрӗ	ɕ ɛ r ɛ
ҫӗрӗн-кунӗн	ɕ ɛ r ɛ n k u n ɛ n
ҫӗрӗпех	ɕ ɛ r ɛ p e χ
ҫӗтӗк	ɕ ɛ t ɛ k
ҫӗҫҫе	ɕ ɛ ɕː e
ҫӗҫҫи	ɕ ɛ ɕː i
ҫӳл	ɕ y l
ҫӳлелле	ɕ y l e lː e
ҫӳлерех	ɕ y l e r e χ
ҫӳллерех	ɕ y lː e r e χ
ҫӳллех	ɕ y lː e χ
ҫӳллӗ	ɕ y lː ɛ
ҫӳлте	ɕ y l t e
ҫӳлти	ɕ y l t i
ҫӳлӗксенче	ɕ y l ɛ k s e n tʃ e
ҫӳп-ҫап	ɕ y p ɕ ɑ p
ҫӳп-ҫапа	ɕ y p ɕ ɑ p ɑ
ҫӳп-ҫапран	ɕ y p ɕ ɑ p r ɑ n
ҫӳре	ɕ y r e
ҫӳреве	ɕ y r e v e
ҫӳрекен	ɕ y r e k e n
ҫӳрекенсем	ɕ y r e k e n s e m
ҫӳрекенсемшӗн	ɕ y r e k e n s e m ʃ ɛ n
ҫӳреме	ɕ y r e m e
ҫӳремелле	ɕ y r e m e lː e
ҫӳремелли	ɕ y r e m e lː i
ҫӳремест	ɕ y r e m e s t
ҫӳремеҫҫӗ	ɕ y r e m e ɕː ɛ
ҫӳренине	ɕ y r e n i n e
ҫӳренӗ	ɕ y r e n ɛ
ҫӳрерӗ	ɕ y r e r ɛ
ҫӳрерӗҫ	ɕ y r e r ɛ ɕ
ҫӳрес	ɕ y r e s
ҫӳресси	ɕ y r e sː i
ҫӳрет	ɕ y r e t
ҫӳретпӗр	ɕ y r e t p ɛ r
ҫӳреттересси	ɕ y r e tː e r e sː i
ҫӳреттересшӗн	ɕ y r e tː e r e s ʃ ɛ n
ҫӳреттерменнине	ɕ y r e tː e r m e nː i n e
ҫӳреҫҫӗ	ɕ y r e ɕː ɛ
ҫӳрӗҫ	ɕ y r ɛ ɕ
ҫӳхелсе	ɕ y χ e l s e
ҫӳхетмесӗрех	ɕ y χ e t m e s ɛ r e χ
ҫӳҫ	ɕ y ɕ
ҫӳҫе	ɕ y ɕ e
ҫӳҫне	ɕ y ɕ n e
ҫӳҫӗ	ɕ y ɕ ɛ
ӑмӑртать	ʌ m ʌ r t ɑ t
ӑмӑрткайӑксем	ʌ m ʌ r t k ɑ j ʌ k s e m
ӑмӑртни	ʌ m ʌ r t n i
ӑмӑрту	ʌ m ʌ r t u
ӑмӑртура	ʌ m ʌ r t u r ɑ
ӑмӑртуран	ʌ m ʌ r t u r ɑ n
ӑмӑртусем	ʌ m ʌ r t u s e m
ӑмӑртусене	ʌ m ʌ r t u s e n e
ӑмӑртусенче	ʌ m ʌ r t u s e n tʃ e
ӑмӑртӑва	ʌ m ʌ r t ʌ v ɑ
ӑмӑртӑвӑн	ʌ m ʌ r t ʌ v ʌ n
ӑмӑртӑвӗ	ʌ m ʌ r t ʌ v ɛ
ӑмӑртӑвӗн	ʌ m ʌ r t ʌ v ɛ n
ӑмӑртӑвӗсене	ʌ m ʌ r t ʌ v ɛ s e n e
ӑна	ʌ n ɑ
ӑна-кӑна	ʌ n ɑ k ʌ n ɑ
ӑнлавсем	ʌ n l ɑ v s e m
ӑнланать	ʌ n l ɑ n ɑ t
ӑнланма	ʌ n l ɑ n m ɑ
ӑнланмалла	ʌ n l ɑ n m ɑ lː ɑ
ӑнланманнисем	ʌ n l ɑ n m ɑ nː i s e m
ӑнланманнисене	ʌ n l ɑ n m ɑ nː i s e n e
ӑнланманскерсем	ʌ n l ɑ n m ɑ n s k e r s e m
ӑнланмастӑм	ʌ n l ɑ n m ɑ s t ʌ m
ӑнланмастӑп	ʌ n l ɑ n m ɑ s t ʌ p
ӑнланмасӑр	ʌ n l ɑ n m ɑ s ʌ r
ӑнланни	ʌ n l ɑ nː i
ӑнланнине	ʌ n l ɑ nː i n e
ӑнланнӑ	ʌ n l ɑ nː ʌ
ӑнланса	ʌ n l ɑ n s ɑ
ӑнлантарайман	ʌ n l ɑ n t ɑ r ɑ j m ɑ n
ӑнлантарнӑ	ʌ n l ɑ n t ɑ r n ʌ
ӑнлантарса	ʌ n l ɑ n t ɑ r s ɑ
ӑнмасан	ʌ n m ɑ s ɑ n
ӑнсӑртран	ʌ n s ʌ r t r ɑ n
ӑнтӑлнӑ	ʌ n t ʌ l n ʌ
ӑнтӑлӑвне	ʌ n t ʌ l ʌ v n e
ӑнӑҫлӑ	ʌ n ʌ ɕ l ʌ
ӑнӑҫу	ʌ n ʌ ɕ u
ӑру	ʌ r u
ӑрури	ʌ r u r i
ӑрурисене	ʌ r u r i s e n e
ӑрушӑн	ʌ r u ʃ ʌ n
ӑрӑвне	ʌ r ʌ v n e
ӑрӑвӗсем	ʌ r ʌ v ɛ s e m
ӑс	ʌ s
ӑс-тӑн	ʌ s t ʌ n
ӑс-тӑнне	ʌ s t ʌ nː e
ӑс-тӑншӑн	ʌ s t ʌ n ʃ ʌ n
ӑс-хакӑл	ʌ s χ ɑ k ʌ l
ӑса	ʌ s ɑ
ӑсатасшӑнчӗ	ʌ s ɑ t ɑ s ʃ ʌ n tʃ ɛ
ӑсатаҫҫӗ	ʌ s ɑ t ɑ ɕː ɛ
ӑсатнӑ	ʌ s ɑ t n ʌ
ӑсатса	ʌ s ɑ ts ɑ
ӑслӑлӑхсенче	ʌ s l ʌ l ʌ χ s e n tʃ e
ӑсталакан	ʌ s t ɑ l ɑ k ɑ n
ӑсталанӑ	ʌ s t ɑ l ɑ n ʌ
ӑсталарӑмӑр	ʌ s t ɑ l ɑ r ʌ m ʌ r
ӑсталӑхне	ʌ s t ɑ l ʌ χ n e
ӑстараххи	ʌ s t ɑ r ɑ χː i
ӑстарахчӗ	ʌ s t ɑ r ɑ χ tʃ ɛ
ӑстаччӗ	ʌ s t ɑ tʃ tʃ ɛ
ӑстисем	ʌ s t i s e m
ӑстисен	ʌ s t i s e n
ӑсчах	ʌ s tʃ ɑ χ
ӑсӗ	ʌ s ɛ
ӑсӗ-тӑнӗ	ʌ s ɛ t ʌ n ɛ
ӑша	ʌ ʃ ɑ
ӑшалама	ʌ ʃ ɑ l ɑ m ɑ
ӑшаласа	ʌ ʃ ɑ l ɑ s ɑ
ӑшалаҫҫӗ	ʌ ʃ ɑ l ɑ ɕː ɛ
ӑшне	ʌ ʃ n e
ӑшшӑн	ʌ ʃː ʌ n
ӑшӑ	ʌ ʃ ʌ
ӑшӑ-ха	ʌ ʃ ʌ χ ɑ
ӑшӑнаканскерсем	ʌ ʃ ʌ n ɑ k ɑ n s k e r s e m
ӑшӑнас	ʌ ʃ ʌ n ɑ s
ӑшӑнать	ʌ ʃ ʌ n ɑ t
ӑшӑрах	ʌ ʃ ʌ r ɑ χ
ӑшӑрахчӗ	ʌ ʃ ʌ r ɑ χ tʃ ɛ
ӑшӑтакан	ʌ ʃ ʌ t ɑ k ɑ n
ӑшӑтмалли	ʌ ʃ ʌ t m ɑ lː i
ӑшӑтнӑ	ʌ ʃ ʌ t n ʌ
ӑшӑтрӗ	ʌ ʃ ʌ t r ɛ
ӑшӑтса	ʌ ʃ ʌ ts ɑ
ӑшӗнче	ʌ ʃ ɛ n tʃ e
ӑҫта	ʌ ɕ t ɑ
ӑҫталла	ʌ ɕ t ɑ lː ɑ
ӑҫтан	ʌ ɕ t ɑ n
ӑҫтан-ши	ʌ ɕ t ɑ n ʃ i
ӗлкӗреймен	ɛ l k ɛ r e j m e n
ӗлкӗрейменскер	ɛ l k ɛ r e j m e n s k e r
ӗлкӗреймерӗ	ɛ l k ɛ r e j m e r ɛ
ӗлкӗрнӗ	ɛ l k ɛ r n ɛ
ӗмпӗрт	ɛ m p ɛ r t
ӗмӗр	ɛ m ɛ r
ӗмӗре	ɛ m ɛ r e
ӗмӗрлӗхех	ɛ m ɛ r l ɛ χ e χ
ӗмӗртен	ɛ m ɛ r t e n
ӗмӗтленекенсем	ɛ m ɛ t l e n e k e n s e m
ӗмӗтленет	ɛ m ɛ t l e n e t
ӗмӗтленетӗр-и	ɛ m ɛ t l e n e t ɛ r i
ӗмӗтленмест	ɛ m ɛ t l e n m e s t
ӗмӗтленнӗ	ɛ m ɛ t l e nː ɛ
ӗмӗтленчӗҫ	ɛ m ɛ t l e n tʃ ɛ ɕ
ӗмӗтпе	ɛ m ɛ t p e
ӗмӗтсене	ɛ m ɛ ts e n e
ӗне	ɛ n e
ӗне-сурӑха	ɛ n e s u r ʌ χ ɑ
ӗненме	ɛ n e n m e
ӗненмелле	ɛ n e n m e lː e
ӗнентерекен	ɛ n e n t e r e k e n
ӗнентереҫҫӗ	ɛ n e n t e r e ɕː ɛ
ӗнентермешкӗн	ɛ n e n t e r m e ʃ k ɛ n
ӗнентернӗ	ɛ n e n t e r n ɛ
ӗненчӗ	ɛ n e n tʃ ɛ
ӗнер	ɛ n e r
ӗнерхи	ɛ n e r χ i
ӗнесене	ɛ n e s e n e
ӗнтӗ	ɛ n t ɛ
ӗпхӳре	ɛ p χ y r e
ӗҫ	ɛ ɕ
ӗҫ-пуҫа	ɛ ɕ p u ɕ ɑ
ӗҫе	ɛ ɕ e
ӗҫет	ɛ ɕ e t
ӗҫке	ɛ ɕ k e
ӗҫлеймен	ɛ ɕ l e j m e n
ӗҫлейместӗм	ɛ ɕ l e j m e s t ɛ m
ӗҫлекеленӗ	ɛ ɕ l e k e l e n ɛ
ӗҫлекен	ɛ ɕ l e k e n
ӗҫлекенсем	ɛ ɕ l e k e n s e m
ӗҫлекенсемпе	ɛ ɕ l e k e n s e m p e
ӗҫлекенскер	ɛ ɕ l e k e n s k e r
ӗҫлеме	ɛ ɕ l e m e
ӗҫлемелли	ɛ ɕ l e m e lː i
ӗҫлемест	ɛ ɕ l e m e s t
ӗҫлени	ɛ ɕ l e n i
ӗҫленине	ɛ ɕ l e n i n e
ӗҫленӗ	ɛ ɕ l e n ɛ
ӗҫленӗрен	ɛ ɕ l e n ɛ r e n
ӗҫленӗскер	ɛ ɕ l e n ɛ s k e r
ӗҫлерӗ	ɛ ɕ l e r ɛ
ӗҫлерӗм	ɛ ɕ l e r ɛ m
ӗҫлес	ɛ ɕ l e s
ӗҫлесе	ɛ ɕ l e s e
ӗҫлесен	ɛ ɕ l e s e n
ӗҫлессине	ɛ ɕ l e sː i n e
ӗҫлет	ɛ ɕ l e t
ӗҫлетӗп	ɛ ɕ l e t ɛ p
ӗҫлеҫҫӗ	ɛ ɕ l e ɕː ɛ
ӗҫлӗ	ɛ ɕ l ɛ
ӗҫлӗҫ	ɛ ɕ l ɛ ɕ
ӗҫме	ɛ ɕ m e
ӗҫне	ɛ ɕ n e
ӗҫни	ɛ ɕ n i
ӗҫнӗ	ɛ ɕ n ɛ
ӗҫпе	ɛ ɕ p e
ӗҫре	ɛ ɕ r e
ӗҫрен	ɛ ɕ r e n
ӗҫри	ɛ ɕ r i
ӗҫрӗ	ɛ ɕ r ɛ
ӗҫсе	ɛ ɕ s e
ӗҫсем	ɛ ɕ s e m
ӗҫсемпе	ɛ ɕ s e m p e
ӗҫсен	ɛ ɕ s e n
ӗҫсене	ɛ ɕ s e n e
ӗҫсӗр	ɛ ɕ s ɛ r
ӗҫсӗррисем	ɛ ɕ s ɛ rː i s e m
ӗҫсӗррисен	ɛ ɕ s ɛ rː i s e n
ӗҫтермешкӗн	ɛ ɕ t e r m e ʃ k ɛ n
ӗҫтешӗсем	ɛ ɕ t e ʃ ɛ s e m
ӗҫчен	ɛ ɕ tʃ e n
ӗҫченне	ɛ ɕ tʃ e nː e
ӗҫченрех	ɛ ɕ tʃ e n r e χ
ӗҫченӗсем	ɛ ɕ tʃ e n ɛ s e m
ӗҫченӗсемпе	ɛ ɕ tʃ e n ɛ s e m p e
ӗҫченӗсен	ɛ ɕ tʃ e n ɛ s e n
ӗҫченӗсене	ɛ ɕ tʃ e n ɛ s e n e
ӗҫӗ	ɛ ɕ ɛ
ӗҫӗ-хӗлне	ɛ ɕ ɛ χ ɛ l n e
ӗҫӗн	ɛ ɕ ɛ n
ӗҫӗнче	ɛ ɕ ɛ n tʃ e
ӗҫӗсемпе	ɛ ɕ ɛ s e m p e
ӗҫӗсен	ɛ ɕ ɛ s e n
ӗҫӗсене	ɛ ɕ ɛ s e n e
ӳкерекенсене	y k e r e k e n s e n e
ӳкерекенскер	y k e r e k e n s k e r
ӳкерес	y k e r e s
ӳкерет	y k e r e t
ӳкереҫҫӗ	y k e r e ɕː ɛ
ӳкернӗ	y k e r n ɛ
ӳкерсе	y k e r s e
ӳкерттернӗ	y k e r tː e r n ɛ
ӳкерчӗк	y k e r tʃ ɛ k
ӳкерчӗкре	y k e r tʃ ɛ k r e
ӳкерчӗксем	y k e r tʃ ɛ k s e m
ӳкерчӗксене	y k e r tʃ ɛ k s e n e
ӳкерӗннӗ	y k e r ɛ nː ɛ
ӳкеттӗм	y k e tː ɛ m
ӳкнӗ	y k n ɛ
ӳкнӗ-мӗн	y k n ɛ m ɛ n
ӳкрӗм	y k r ɛ m
ӳксен	y k s e n
ӳкӗннине	y k ɛ nː i n e
ӳмӗнче	y m ɛ n tʃ e
ӳнер	y n e r
ӳнерпе	y n e r p e
ӳнерҫӗ	y n e r ɕ ɛ
ӳнерҫӗсене	y n e r ɕ ɛ s e n e
ӳпкелеме	y p k e l e m e
ӳпкелешнине	y p k e l e ʃ n i n e
ӳркенмен	y r k e n m e n
ӳркенменскер	y r k e n m e n s k e r
ӳркенмерӗм	y r k e n m e r ɛ m
ӳсет	y s e t
ӳсеҫҫӗ	y s e ɕː ɛ
ӳсме	y s m e
ӳсни	y s n i
ӳснӗ	y s n ɛ
ӳссе	y sː e
ӳссех	y sː e χ
ӳстерессипе	y s t e r e sː i p e
ӳстерет	y s t e r e t
ӳстермелли	y s t e r m e lː i
ӳстернӗ	y s t e r n ɛ
ӳстерсе	y s t e r s e
ӳсӗмре	y s ɛ m r e
ӳсӗмри	y s ɛ m r i
ӳсӗмрисен	y s ɛ m r i s e n
ӳсӗмӗ	y s ɛ m ɛ
ӳсӗмӗшӗн	y s ɛ m ɛ ʃ ɛ n
ӳсӗр	y s ɛ r
ӳсӗрле	y s ɛ r l e
ӳсӗрскер	y s ɛ r s k e r
ӳсӗрскерсем	y s ɛ r s k e r s e m
ӳсӗрӗлнӗ	y s ɛ r ɛ l n ɛ
ӳте	y t e
