'dan	ʔ d a˥˦ ŋ
'duniya	ʔ d uː˥ n ɪ˥ j ɛ˩
'idan	ʔ ɪ˥ d a˥˦ ŋ
'ina	ʔ ɪ˥ n aː˩
'japanawa	ʔ dʒ ə˩ p ə˩ n aː˥ w aː˥
'jarumai	ʔ dʒ aː˩ r ɪ˥ m aj˥
'mutum	ʔ m ʊ˩ t ɪ˥˦ ŋ
'wannan	ʔ w a˥ n a˥˦ ŋ
'ya	j̰ aː˥
'yan	ʔ j a˥˦ ŋ
'yan'uwa	ʔ j ŋ ʔ ʊ˩ w aː˥
'yancin	ʔ j a˥ n tʃ ɪ˩ ŋ
'yansanda	ʔ j aː˥ n s a˥ n d aː˩
'yar	j̰ ɛ˥ r
'yaranmu	ʔ j aː˥ r a˩ n m uː˩
'za	ʔ z aː˩
'zai	ʔ z aj˥
a	ʔ a˩
a'a	ʔ aː˥ ʔ aː˩
a'ishatu	ʔ aː˥ ʔ ɪ˩ ʃ ə˥ t ɪ˩
ababnen	ʔ a˩ b ə˩ b n eː˥ ŋ
abacada	ʔ aː˩ b aː˩ tʃ aː˩ d aː˥˦
abada	ʔ a˩ b ə˩ d aː˥˦
abar	ʔ a˩ b a˩ r
abarba	ʔ a˩ b a˩ ɽ b aː˥
abdu	ʔ a˥ b d ɪ˩
abdulhamid	ʔ a˩ b d ɪ˩ l h a˩ m ɪ˥˦ d
abdullah	ʔ a˩ b d ɪ˩ l aː˩
abdullahi	ʔ a˩ b d ɪ˩ l aː˥ h ɪ˩
abdullahia	ʔ a˩ b d ɪ˩ l aː˥ h ɪ˩ aː˩
abdulƙadir	ʔ a˩ b d ɪ˩ l kʼ aː˥ d ɪ˩ r
abdurrahim	ʔ a˩ b d ɪ˩ r ə˩ h ɪ˥˦ ŋ
abdussalamu	ʔ a˩ b d ɪ˩ s ə˩ l aː˥ m ʊ˩
abin	ʔ a˩ b ɪ˩ ŋ
abinci	ʔ a˩ b iː˩ n tʃ iː˥
abincin	ʔ a˩ b iː˩ n tʃ ɪ˩ ŋ
abinda	ʔ a˩ b ɪ˥ n d aː˩
abjadi	ʔ a˥ b dʒ ə˩ d iː˥
abkawa	ʔ a˩ b k aː˥ w aː˥
abokai	ʔ a˩ b oː˥ k aj˥
abokaina	ʔ a˩ b oː˥ k aj˥ n aː˩
abokaine	ʔ a˩ b oː˥ k aj˥ n e˥
abokan	ʔ a˩ b oː˥ k a˩ ŋ
abokanai	ʔ a˩ b oː˥ k a˩ n aj˥
abokanan	ʔ a˩ b oː˥ k a˩ n a˥˦ ŋ
abokansa	ʔ a˩ b oː˥ k a˩ n s aː˩
abokanta	ʔ a˩ b oː˥ k a˩ n t aː˥
abokantaka	ʔ a˩ b oː˥ k a˩ n t ə˥ k aː˩
aboki	ʔ a˩ b oː˥ c iː˥
abokin	ʔ a˩ b oː˥ c ɪ˥ ŋ
abokina	ʔ a˩ b oː˥ c iː˥ n ə˩
abokinsa	ʔ a˩ b oː˥ c iː˥ n s aː˩
abokiya	ʔ a˩ b oː˥ c ɪ˥ j aː˩
abokiyar	ʔ a˩ b oː˥ c ɪ˩ j ɛ˥ r
abotarku	ʔ a˩ b oː˥ t a˥ r kʷ ʊ˩
abu	ʔ a˩ b ʊ˩
abubakar	ʔ a˩ b uː˥ b ə˥ k a˩ r
abubawanm	ʔ a˩ b uː˥ b ə˥ w a˩ m ŋ
abubuwa	ʔ a˩ b uː˥ b ʊ˥ w aː˥
abubuwan	ʔ a˩ b uː˥ b ʊ˩ w a˥ ŋ
abuja	ʔ a˩ b ʊ˩ dʒ aː˩
abun	ʔ a˩ b ʊ˩ ŋ
abunda	ʔ a˩ b ʊ˩ n d aː˩
abune	ʔ a˩ b ʊ˩ n e˥
abuta	ʔ a˩ b uː˥ t aː˩
acan	ʔ a˩ tʃ a˩ ŋ
acca	ʔ a˥ tʃ aː˩
ace	ʔ a˩ tʃ eː˩
ada	ʔ a˥ d ə˩
adabi	ʔ a˥ d ə˩ b iː˥
adabin	ʔ a˥ d ə˩ b ɪ˩ ŋ
adabo	ʔ a˥ d aː˩ b oː˥
adadi	ʔ a˥ d ə˩ d iː˥
adadin	ʔ a˥ d ə˥ d ɪ˩ ŋ
adalci	ʔ a˥ d ə˩ l tʃ iː˥
adam	ʔ a˥ d a˩ ŋ
adama	ʔ a˥ d ə˩ m aː˥
adamu	ʔ aː˩ d ə˩ m ʊ˥
adana	ʔ a˥ d ə˥ n ə˥
adawa	ʔ a˩ d aː˥ w aː˩
adawarmu	ʔ a˩ d aː˥ w a˥ r m uː˩
addaba	ʔ a˩ d ə˥ b aː˩
addinai	ʔ a˩ d iː˥ n aj˥
addinan	ʔ a˩ d iː˥ n a˩ ŋ
addini	ʔ a˩ d iː˥ n iː˩
addinin	ʔ a˩ d iː˥ n ɪ˥ ŋ
addu'a	ʔ a˩ d ɪ˥ ʔ aː˩
addu'ar	ʔ a˩ d ɪ˥ ʔ a˩ r
adduna	ʔ a˩ d uː˥ n aː˩
adereshinmu	ʔ a˩ d eː˩ ɽ eː˩ ʃ ɪ˥ ɲ m uː˩
adire	ʔ a˩ d ɪ˩ r e˥
adireshin	ʔ a˩ d ɪ˩ r e˥ ʃ ɪ˥ ŋ
ado	ʔ a˩ d oː˩
adon	ʔ a˩ d oː˩ ŋ
adrea	ʔ a˩ d ɽ eː˥ aː˩
aduwa	ʔ a˥ d ʊ˥ w aː˩
afganistan	ʔ a˩ ɸ ɡ aː˥ n ɪ˥ s t a˩ ŋ
afghanistan	ʔ a˩ ɸ ɡ h aː˥ n ɪ˥ s t a˩ ŋ
afirka	ʔ a˥ ɸ ɪ˥ r k ə˩
afkuwa	ʔ a˩ ɸ kʷ ʊ˥ w aː˥
africa	ʔ a˩ ɸ r iː˥ tʃ aː˩
afrika	ʔ a˩ ɸ r iː˥ k aː˩
afril	ʔ a˩ ɸ r iː˥ l
afrilu	ʔ a˩ ɸ r iː˥ l ɪ˩
afuwa	ʔ a˩ ɸ ʊ˩ w aː˥
aga	ʔ a˩ ɡ aː˩
agade	ʔ a˩ ɡ ə˩ d e˩
agaji	ʔ a˩ ɡ aː˩ dʒ iː˥
agani	ʔ a˩ ɡ aː˥ n iː˩
agazawa	ʔ a˩ ɡ ə˩ z aː˥ w aː˥
agnes	ʔ a˩ ɡʷ n eː˥ s
agogo	ʔ a˩ ɡʷ oː˥ ɡʷ o˥
agogon	ʔ a˩ ɡʷ oː˥ ɡʷ oː˥ ŋ
agola	ʔ a˥ ɡʷ oː˩ l ə˩
agurin	ʔ a˩ ɡʷ ʊ˩ r ɪ˥ ŋ
agushi	ʔ a˩ ɡʷ ʊ˥ ʃ iː˥
agusta	ʔ a˩ ɡʷ ʊ˥ s t aː˩
agustan	ʔ a˩ ɡʷ ʊ˥ s t a˩ ŋ
agwado	ʔ a˩ ɡʷ aː˩ d oː˥
agwagi	ʔ a˩ ɡʷ ə˥ ɟ iː˩
agwagwa	ʔ a˩ ɡʷ aː˩ ɡʷ aː˥
agyekum	ʔ a˩ ɡʷ j eː˥ kʷ ʊ˩ ŋ
ahalin	ʔ aː˥ l ɪ˩ ŋ
ahmad	ʔ aː˥ m a˩ d
ahmadi	ʔ aː˥ m a˩ d iː˥
ahmadinejad	ʔ aː˥ m a˩ d iː˥ n eː˥ dʒ ə˩ d
ahmed	aː˩ m a˩ d
aibi	ʔ aj˥ b ɪ˩
aibu	ʔ aj˥ b ʊ˩
aika	ʔ aj˥ k aː˩
aikace	ʔ aj˥ k aː˩ tʃ eː˩
aikacen	ʔ aj˥ k aː˩ tʃ eː˩ ŋ
aikata	ʔ aj˥ k ə˥ t aː˩
aikawa	ʔ aj˥ k aː˥ w aː˥
aike	ʔ aj˥ c eː˥
aikewa	ʔ aj˥ c eː˥ w aː˩
aiki	ʔ aj˥ c iː˥
aikin	ʔ aj˥ c ɪ˥ ŋ
aikina	ʔ aj˥ c ɪ˥ n aː˩
aikinmu	ʔ aj˥ c ɪ˥ n m uː˩
aikinsa	ʔ aj˥ c ɪ˥ n s aː˩
aikinta	ʔ aj˥ c ɪ˥ n t aː˩
aiko	ʔ aj˥ kʷ oː˥
ailan	ʔ aj˥ l a˩ ŋ
ainahin	ʔ aj˥ n aː˥ h ɪ˥ ŋ
ainihin	ʔ aj˥ n iː˥ h ɪ˥ ŋ
ainun	ʔ aj˥ n ɪ˩ ŋ
aisha	ʔ iː˩ ʃ aː˥
aishaam	ʔ iː˩ ʃ a˥˦ ŋ
aishatu	ʔ iː˩ ʃ ə˥ t ɪ˩
aiwatar	ʔ aj˩ w ə˥ t a˩ r
aiwatarwa	ʔ aj˩ w ə˥ t ə˩ ɽ w aː˥
aiyukan	ʔ aj˥ j uː˩ k a˩ ŋ
ajali	ʔ a˥ dʒ ə˩ l iː˥
ajami	ʔ a˩ dʒ ə˩ m ɪ˥
aje	ʔ a˩ dʒ e˩
aji	ʔ a˩ dʒ iː˥
ajin	ʔ a˩ dʒ ɪ˥ ŋ
ajiya	ʔ a˩ dʒ ɪ˩ j aː˥
ajiyar	ʔ a˩ dʒ ɪ˩ j ɛ˥ r
ajiye	ʔ a˩ dʒ ɪ˩ j eː˥
ajiyeta	ʔ a˩ dʒ ɪ˩ j eː˥ t aː˩
ajuza	ʔ a˩ dʒ uː˥ z aː˩
aka	ʔ a˥ k aː˩
akai	ʔ a˥ k aj˥
akala	ʔ a˥ k aː˩ l ə˩
akalla	ʔ a˥ k a˥ l aː˩
akan	ʔ a˥ k a˩ ŋ
akanmu	ʔ a˥ k a˩ n m uː˩
akansa	ʔ a˥ k ə˥ n s aː˩
akansu	ʔ a˥ k ə˥ n s ɪ˩
akara	ʔ a˩ k ə˩ ɽ ə˩
akasidan	ʔ a˥ k ə˥ s ɪ˩ d a˥˦ ŋ
akawal	ʔ a˥ k ə˥ w a˩ l
akawali	ʔ a˥ k ə˥ w ə˩ l iː˥
akawu	ʔ a˩ k aː˩ w ʊ˥
ake	ʔ a˩ c eː˥
akeyi	ʔ a˩ c eː˥ j iː˥
akidar	ʔ a˥ c iː˥ d a˩ r
akin	ʔ a˥ c ɪ˥ ŋ
akingbola	ʔ a˥ kʷ ɪ˥˦ ŋ ɡʷ b oː˥ l aː˩
akoi	ʔ a˥ kʷ oː˩ iː˩
akushi	ʔ a˥ kʷ ʊ˩ ʃ iː˥
akuya	ʔ a˩ kʷ ʊ˥ j aː˩
akwai	ʔ a˥ kʷ aj˥
akwasa	ʔ a˥ kʷ ə˥ s aː˥
akwati	ʔ a˩ kʷ aː˩ t ɪ˩
akwatin	ʔ a˩ kʷ aː˩ t ɪ˥ ŋ
akwatun	ʔ a˩ kʷ aː˩ t ɪ˥ ŋ
akwatunan	ʔ a˩ kʷ aː˩ t uː˩ n a˥˦ ŋ
al	ʔ a˩ l
al'ada	ʔ a˩ l ʔ aː˥ d aː˩
al'adar	ʔ a˩ l ʔ aː˥ d aː˩ r
al'adu	ʔ a˩ l ʔ aː˥ d ɪ˩
al'adun	ʔ a˩ l ʔ aː˥ d ɪ˩ ŋ
al'ajabi	ʔ a˩ l ʔ a˥ dʒ ə˩ b iː˥
al'amari	ʔ a˩ l ʔ a˥ m ə˩ r iː˥
al'amarin	ʔ a˩ l ʔ a˥ m ə˩ r ɪ˥ ŋ
al'amuran	ʔ a˩ l ʔ a˥ m ʊ˩ r a˩ ŋ
al'aura	ʔ a˩ l ʔ aw˥ r aː˩
al'uma	ʔ a˩ l ʔ ʊ˥ m aː˩
al'umma	ʔ a˩ l ʔ ʊ˥ m aː˩
al'umman	ʔ a˩ l ʔ ʊ˩ m a˩ ŋ
al'ummarsu	ʔ a˩ l ʔ ʊ˩ m a˥ ɽ uː˥
ala	ʔ a˩ l aː˩
alabe	ʔ a˩ l ə˥ b eː˩
alade	ʔ a˩ l ə˥ d eː˩
alaihissalam	ʔ a˩ l ə˥ aj˩ h ɪ˥ s ə˩ l aː˥ m
alaikum	ʔ a˩ l ə˥ aj˩ kʷ ʊ˩ ŋ
alaka	ʔ a˩ l ə˥ k ə˩
alakar	ʔ a˩ l ə˥ k a˩ r
alal	ʔ a˩ l a˥˦ l
alama	ʔ a˩ l aː˥ m aː˩
alamanta	ʔ a˩ l aː˥ m a˥ n t aː˩
alamar	ʔ a˩ l aː˥ m ə˩ r
alamomi	ʔ a˩ l aː˥ m oː˥ m iː˥
alamomin	ʔ a˩ l aː˥ m oː˥ m ɪ˥ ŋ
alamominku	ʔ a˩ l aː˥ m oː˥ m ɪ˥ ŋ kʷ ʊ˩
alamu	ʔ a˩ l aː˥ m ʊ˩
alamun	ʔ a˩ l aː˥ m ʊ˩ ŋ
alan	ʔ a˩ l a˥˦ ŋ
alaramma	ʔ a˥ l ə˩ r a˥ m ə˩
alatu	ʔ aː˥ l aː˥ t ɪ˩
alawa	ʔ a˩ l aː˥ w aː˩
alawarku	ʔ a˩ l aː˥ w a˥ r kʷ ʊ˩
alaƙa	ʔ a˩ l ə˥ kʼ ə˩
albaras	ʔ a˩ l b ə˥ r a˩ s
albarka	ʔ a˩ l b a˥ r k aː˩
albarkacin	ʔ a˩ l b ə˥ r k aː˩ tʃ ɪ˥ ŋ
albarkar	ʔ a˩ l b ə˥ r k a˩ r
albarkatan	ʔ a˩ l b ə˥ r k ə˥ t a˩ ŋ
albarkatun	ʔ a˩ l b ə˥ r k ə˩ t ɪ˥ ŋ
albarushi	ʔ a˩ l b ə˩ r uː˥ ʃ iː˩
albasa	ʔ a˩ l b ə˥ s aː˩
albashin	ʔ a˩ l b ə˥ ə˩ ʃ ɪ˥˦ ŋ
albishir	ʔ a˩ l b ɪ˥ ʃ ɪ˩ r
alehi	ʔ a˩ l eː˥ h iː˩
alfadari	ʔ a˩ l ɸ ə˥ d ə˥ r iː˥
alfahari	ʔ a˩ l ɸ ə˥ h a˩ r iː˥
alfaharin	ʔ a˩ l ɸ ə˥ h a˩ r ɪ˥ ŋ
alfarma	ʔ a˩ l ɸ ə˥ r m aː˩
alfijir	ʔ a˩ l ɸ ɪ˥ dʒ ɪ˩ r
algaita	ʔ a˩ l ɡ aj˥ t aː˩
algashi	ʔ a˥ l ɡ ə˩ ʃ iː˥
algeria	ʔ a˩ l ɟ eː˥ r ɪ˥ aː˩
alhaji	ʔ a˩ l h a˥ dʒ iː˥
alhaki	ʔ a˩ l h a˥ c iː˥
alhakin	ʔ a˩ l h a˥ c ɪ˥ ŋ
alhali	ʔ a˩ l h aː˥ l iː˥
alhamdulillahi	ʔ a˩ l h a˥ m d ɪ˩ l ɪ˩ l aː˥ h ɪ˩
alhamis	ʔ a˩ l h a˩ m ɪ˥˦ s
alhanzir	ʔ a˩ l h a˩ n z ɪ˥˦ r
alhassan	ʔ a˩ l h s a˩ ŋ
alheri	ʔ a˩ l h eː˥ r iː˩
alherinsa	ʔ a˩ l h eː˥ r iː˩ n s aː˩
alhudahuda	ʔ a˩ l h ʊ˥ d ə˩ h ʊ˥ d ə˩
ali	ʔ a˩ l ɪ˥
alif	ʔ a˥ l ɪ˩ ɸ
aliki	ʔ a˩ l ɪ˩ c iː˥
aliko	ʔ a˩ l ɪ˩ kʷ oː˥
alikoa	ʔ a˩ l ɪ˩ c ɔ˩ aː˩
aliyu	ʔ a˩ l ɪ˥ j ʊ˥
aliyua	ʔ a˩ l ɪ˩ j uː˥ aː˩
aliyuaa	ʔ a˩ l ɪ˩ j uː˥ aː˩
aljabara	ʔ a˩ l dʒ ə˥ b ə˥ r aː˩
aljan	ʔ a˩ l dʒ a˥ ŋ
aljani	ʔ a˩ l dʒ ə˥ n iː˥
aljanna	ʔ a˩ l dʒ a˥ n aː˩
alkadari	ʔ a˩ l k ə˥ d ə˩ r iː˥
alkahira	ʔ a˩ l k aː˥ h ɪ˥ r aː˩
alkali	ʔ a˩ l k aː˥ l iː˥
alkama	ʔ a˩ l k ə˥ m aː˩
alkarya	ʔ a˩ l k a˥ r j aː˩
alkawari	ʔ a˩ l k ə˥ w ə˩ r iː˥
alkawarin	ʔ a˩ l k ə˥ w aː˥ ɽ ɪ˥ ŋ
alkhairi	ʔ a˩ l k aj˩ ɽ iː˩
alkibla	ʔ a˩ l c ɪ˩ b l aː˩
alkiblar	ʔ a˩ l c ɪ˩ b l a˩ r
alkurani	ʔ a˩ l kʷ ʊ˩ ɽ ə˩ n iː˥
alkyabba	ʔ a˩ l c ɛ˥ b aː˩
allah	ʔ a˥ l aː˩
allahu	ʔ a˩ l aː˥ h ʊ˩
allo	ʔ a˩ l oː˥
allon	ʔ a˥ l ɔ˩ ŋ
allura	ʔ a˩ l uː˥ r aː˩
alluran	ʔ a˩ l uː˥ r a˩ ŋ
allurar	ʔ a˩ l uː˥ r a˩ r
almajiri	ʔ a˩ l m aː˥ dʒ ɪ˩ r iː˥
almakashi	ʔ a˩ l m ə˥ k ə˩ ʃ iː˥
almara	ʔ a˩ l m ə˥ r aː˩
almasihu	ʔ a˩ l m ə˩ s iː˥ h ʊ˩
almubazzaranci	ʔ a˩ l m ʊ˩ b a˥ z ə˩ r a˥ n tʃ iː˥
almundahanar	ʔ a˩ l m ʊ˩ n d ə˩ h aː˥ n a˩ r
alpaca	ʔ a˩ l p ə˩ tʃ aː˩
alpha	ʔ a˩ l ɸ aː˥
altine	ʔ a˩ l t ɪ˩ n e˥
alurar	ʔ a˩ l uː˥ r a˩ r
alwala	ʔ a˩ l w ə˩ l aː˥
alƙahira	ʔ a˩ l kʼ aː˥ h ɪ˩ r ə˥
alƙalai	ʔ a˩ l kʼ aː˥ l aj˥
alƙalami	ʔ a˩ l kʼ ə˥ l ə˩ m iː˥
alƙali	ʔ a˩ l kʼ aː˥ l iː˥
alƙalin	ʔ a˩ l kʼ aː˥ l ɪ˩ ŋ
alƙawari	ʔ a˩ l kʼ aː˥ w ə˩ r iː˥
alƙawarin	ʔ a˩ l kʼ ə˥ w aː˥ ɽ ɪ˥ ŋ
alƙur'ani	ʔ a˩ l kʷʼ ʊ˩ r ʔ aː˥ n iː˩
amai	ʔ a˥ m aj˥
amalanke	ʔ a˥ m aː˥ l ɛ˥ ɲ c e˥
amale	ʔ a˥ m aː˥ l e˩
amana	ʔ a˩ m aː˥ n aː˩
amanar	ʔ a˥ m ə˥ n a˩ r
amanarsu	ʔ a˩ m aː˥ n a˩ r uː˩
amarya	ʔ a˥ m a˥ ɽ j aː˥
amawali	ʔ a˥ m aː˥ w ə˩ l iː˥
amazon	ʔ a˥ m z oː˥ ŋ
ambaci	ʔ a˥ m b aː˩ tʃ iː˥
ambaliya	ʔ a˥ m b ə˩ l ɪ˥ j aː˩
ambaliyar	ʔ a˥ m b aː˩ l ɪ˩ j ɛ˥ r
ambata	ʔ a˥ m b ə˥ t aː˩
ambatar	ʔ a˥ m b ə˥ t a˩ r
amerika	ʔ a˥ m eː˥ r ɪ˥ k aː˩
amfana	ʔ a˥ m ɸ aː˥ n aː˩
amfanawa	ʔ a˥ m ɸ aː˥ n aː˥ w aː˥
amfani	ʔ a˥ m ɸ aː˥ n iː˩
amfanin	ʔ a˥ m ɸ aː˩ n ɪ˥ ŋ
amfaninka	ʔ a˥ m ɸ aː˥ n ɪ˩ ŋ k aː˥
amin	ʔ aː˩ m ɪ˥ ŋ
amina	ʔ a˥ m iː˥ n ə˩
aminai	ʔ a˥ m iː˥ n aj˥
aminan	ʔ a˥ m iː˥ n a˥˦ ŋ
amince	ʔ a˩ m iː˥ n tʃ eː˩
amincewa	ʔ a˩ m iː˥ n tʃ eː˥ w aː˩
amincewar	ʔ a˩ m iː˥ n tʃ eː˥ w a˥ r
aminci	ʔ a˩ m iː˥ n tʃ iː˥
amincin	ʔ a˩ m iː˥ n tʃ ɪ˩ ŋ
amini	ʔ a˩ m iː˥ n iː˩
aminta	ʔ a˩ m iː˥ n t aː˥
amintaccen	ʔ a˩ m iː˥ n t ə˥ tʃ eː˩ ŋ
amintakar	ʔ a˩ m iː˥ n t ə˥ k a˩ r
aminu	ʔ a˩ m iː˥ n ɪ˩
amirka	ʔ a˥ m ɪ˩ r k ə˩
amma	ʔ a˩ m aː˥
amman	ʔ a˩ m a˩ ŋ
amsa	ʔ a˥ m s aː˩
amsaam	ʔ a˥ m s a˩ ŋ
amsaamtu	ʔ a˥ m s aː˩ m t ɪ˩
amsar	ʔ a˥ m s a˩ r
amsatu	ʔ a˥ m s ə˥ t ɪ˩
amsawa	ʔ a˥ m s aː˥ w aː˥
amshi	ʔ a˥ m ʃ iː˥
amsoshin	ʔ a˥ m s oː˥ ʃ ɪ˥ ŋ
amurka	ʔ a˥ m ʊ˩ r k ə˩
amurkawa	ʔ a˥ m ʊ˩ r k aː˥ w aː˥
amy	ʔ a˥ m j
an	ʔ a˩ ŋ
ana	ʔ a˩ n ə˩
anabi	ʔ a˥ n ə˩ b iː˥
anaca	ʔ a˩ n ə˩ tʃ ə˩
anan	ʔ a˩ n a˥˦ ŋ
anderson	ʔ a˩ n d eː˥ ɽ s oː˥ ŋ
anfani	ʔ a˩ n ɸ aː˥ n iː˩
anfanin	ʔ a˩ n ɸ aː˩ n ɪ˥ ŋ
ango	ʔ a˥ ŋ ɡʷ o˩
angola	ʔ a˥ ŋ ɡʷ oː˩ l ə˩
angon	ʔ a˥ ŋ ɡʷ oː˥ ŋ
anhui	ʔ a˥ ŋ h uː˥ iː˩
anini	ʔ a˩ n iː˥ n iː˥
aniyar	ʔ a˩ n ɪ˩ j ɛ˥ r
aniyarta	ʔ a˩ n ɪ˩ j ɛ˥ r t aː˩
ankara	ʔ a˥ ŋ k ə˩ r ə˩
ann	ʔ a˩ n
annabi	ʔ a˩ n ə˥ b iː˩
annan	ʔ a˩ n a˥˦ ŋ
annashuwa	ʔ a˩ n ə˩ ʃ ʊ˥ w aː˥
anne	ʔ a˩ n e˥
annoba	ʔ a˩ n oː˩ b aː˥
annuri	ʔ a˩ n uː˥ r iː˩
anta	ʔ a˥ n t aː˩
anzu	ʔ a˩ n z ɪ˩
apple	ʔ a˩ p p l eː˩
ar	ʔ a˥ r
arabiya	ʔ a˩ r ə˩ b ɪ˥ j ɛ˩
arabiyya	ʔ a˩ r ə˩ b ɪ˥ j aː˩
aradu	ʔ a˩ r aː˥ d ɪ˩
araha	ʔ a˩ r ə˩ h aː˥
arba'in	ʔ a˩ r b ə˩ ʔ ɪ˥ ŋ
arbain	ʔ a˩ r b ə˩ ɪ˩ ŋ
arewa	ʔ a˥ ɽ eː˩ w ə˥
arewaci	ʔ a˩ ə˩ ɽ eː˥ w aː˩ tʃ iː˥
arewacin	ʔ a˩ ə˩ ɽ eː˥ w aː˩ tʃ ɪ˥ ŋ
argentina	ʔ a˥ r ɟ eː˥ n t ɪ˥ n aː˩
armashi	ʔ a˥ r m ə˩ ʃ iː˥
aro	ʔ a˥ r ɔ˩
aron	ʔ a˥ r ɔ˩ ŋ
arsenal	ʔ a˩ r eː˥ n a˥˦ l
arziki	ʔ a˥ r z ɪ˩ c iː˥
arzikin	ʔ a˥ r z ɪ˩ c ɪ˥ ŋ
arzikinmu	ʔ a˥ r z ɪ˩ c ɪ˥ n m uː˩
arzikinsu	ʔ a˥ r z ɪ˩ c ɪ˥ n s ɪ˩
arzikinta	ʔ a˥ r z ɪ˩ c ɪ˥ n t aː˩
arziƙi	ʔ a˥ r z ɪ˩ cʼ iː˥
arziƙin	ʔ a˥ r z ɪ˩ cʼ ɪ˥ ŋ
as	ʔ a˩ s
asabar	ʔ a˩ s ə˥ b a˩ r
asabari	ʔ a˥ s ə˥ b ə˩ r iː˥
asabe	ʔ a˩ s ə˩ b e˥
asabeam	ʔ a˩ s ə˩ b e˥ a˥˦ ŋ
asabetu	ʔ a˩ s ə˩ b e˥ t ɪ˩
asali	ʔ a˥ s ə˥ l iː˥
asalin	ʔ a˩ s aː˥ l ɪ˩ ŋ
asalinsa	ʔ a˩ s aː˥ l ɪ˩ n s aː˩
asalinta	ʔ a˥ s ə˥ l ɪ˥ n t aː˩
asara	ʔ a˩ s aː˥ r aː˩
asawaki	ʔ a˩ s ə˥ w aː˩ c iː˥
asean	ʔ ɛ˥ a˥˦ ŋ
asefi	ʔ ɛ˥ ɸ iː˥
aseptic	ʔ ɛ˥ p t ɪ˩ k
asham	ʔ a˥ ʃ a˥ ŋ
ashana	ʔ a˩ ʃ aː˥ n aː˥
ashe	ə˥ ʃ e˥
ashirin	ʔ a˩ ʃ ɪ˩ r ɪ˥ ŋ
asia	ʔ a˥ s ɪ˩ aː˩
asibiti	ʔ a˥ s ɪ˩ b ɪ˥ t ɪ˩
asibitin	ʔ a˥ s ɪ˩ b ɪ˥ t ɪ˩ ŋ
asibitoci	ʔ a˥ s ɪ˩ b ɪ˥ t oː˥ tʃ ɪ˩
asiri	ʔ a˩ s iː˥ r iː˥
asirin	ʔ a˩ s iː˥ r ɪ˥ ŋ
asiya	ʔ aː˥ s ɪ˥ j ɛ˩
aske	ʔ a˥ s c eː˩
askirim	ʔ a˥ s c ɪ˩ ɽ ɪ˩ m
assalamu	ʔ a˥ s ə˥ l aː˥ m ʊ˩
asu	ʔ a˩ s ɪ˩
asuba	ʔ a˩ s ɪ˩ b aː˥˦
asubahi	ʔ a˩ s ɪ˩ b aː˥ h ɪ˩
asusu	ʔ ʊ˩ s ɪ˩
asusun	ʔ a˩ s ɪ˩ s ɪ˩ ŋ
asusunta	ʔ a˩ s ɪ˩ s ɪ˩ n t aː˥
athens	ʔ a˩ t h eː˥ n s
atiku	ʔ a˩ t ɪ˩ kʷ ʊ˩
atisaye	ʔ a˩ t ɪ˩ s aː˥ j eː˥
atisayin	ʔ a˩ t ɪ˩ s aː˥ j ɪ˩ ŋ
atishawa	ʔ a˩ t ɪ˩ ʃ aː˥ w aː˥
atlantika	ʔ a˩ t l a˥ n t ɪ˥ k aː˩
attajiri	ʔ a˩ t aː˥ dʒ ɪ˩ r iː˥
attaura	ʔ a˩ t aw˥ r aː˥
au	ʔ aw˥
audu	ʔ aw˥ d ɪ˩
auduga	ʔ aw˥ d ɪ˩ ɡ aː˥
augusta	ʔ aw˥ ɡʷ ʊ˥ s t aː˩
auku	ʔ aw˥ kʷ ʊ˩
aukuwar	ʔ aw˥ kʷ ʊ˥ w a˥ r
auna	ʔ aw˥ n aː˩
aunt	ʔ aw˥ n t
aura	ʔ aw˥ r aː˩
auransa	ʔ aw˥ r a˥ n s ə˩
aure	ʔ aw˥ ɽ eː˥
auren	ʔ aw˥ ɽ eː˥ ŋ
aurensu	ʔ aw˥ ɽ eː˥ n s ɪ˩
aureta	ʔ aw˥ ɽ eː˥ t aː˩
austaralia	ʔ aw˥ t ə˩ ɽ aː˥ l ɪ˩ aː˩
austaraliya	ʔ aw˥ t ə˩ ɽ aː˥ l ɪ˩ j aː˥
austarlia	ʔ aw˥ t ə˩ ɽ l ɪ˩ aː˩
australia	ʔ aw˥ t r aː˥ l ɪ˩ aː˩
australiya	ʔ aw˥ t r aː˥ l ɪ˩ j aː˥
austria	ʔ aw˥ t r ɪ˥ aː˩
awa	ʔ a˥ w aː˩
awadh	ʔ a˩ w ə˥ d
awanni	ʔ a˩ w a˥ n iː˩
awaza	ʔ a˩ w ə˥ z aː˩
awoyi	ʔ a˩ w oː˩ j ɪ˥
aya	ʔ aː˥ j aː˩
ayaba	ʔ ɛ˩ j ɛ˩ b ə˩
ayan	ʔ ɛ˩ j ŋ
ayanzu	ʔ aː˥ j ɛ˥ ɲ z ɪ˩
ayar	ʔ aː˥ j ɛ˥ r
ayari	ʔ aː˥ j ɛ˩ r iː˥
ayarin	ʔ aː˥ j ɛ˩ r ɪ˥ ŋ
ayin	ʔ aː˥ j ɪ˩ ŋ
ayoyin	ʔ aː˥ j oː˩ j ɪ˥ ŋ
ayuka	ʔ aː˥ j uː˥ k aː˩
ayyuka	ʔ ɛ˩ j uː˥ k aː˩
ayyukan	ʔ ɛ˩ j uː˩ k a˩ ŋ
ayyukansu	ʔ ɛ˩ j uː˥ k aː˩ n s ɪ˩
azaba	ʔ a˩ z aː˥ b aː˩
azaban	ʔ a˩ z ə˥ b a˩ ŋ
azabtar	ʔ a˩ z ə˥ b t a˩ r
azabtarwa	ʔ a˩ z ə˥ b t aː˥ ɽ w aː˥
azahar	ʔ a˩ z ə˥ h a˩ r
azahariyya	ʔ a˩ z ə˩ h a˩ r ɪ˥ j aː˩
azal	ʔ a˩ z a˩ l
azare	ʔ a˩ z aː˥ ɽ eː˩
azumi	ʔ a˥ z ɪ˩ m iː˥
azumi	ʔ a˥ z ɪ˩ m ɪ˥
azurfa	ʔ a˥ z ɪ˩ r ɸ aː˥
azzakari	ʔ a˩ z ə˥ k ə˩ r iː˥
azzalumai	ʔ a˩ z ə˥ l uː˥ m aj˥
aƙalla	ʔ a˩ kʼ a˥ l ə˩
aƙida	ʔ a˩ cʼ iː˥ d aː˩
ba	b aː˩
ba'a	b aː˥ ʔ aː˩
ba'askare	b ə˩ ʔ a˥ s k ə˥ r eː˩
baba	b aː˥ b aː˥
baba	b aː˥ b ə˩
baba	b aː˩ b aː˥
baba	b aː˩ b ə˥
baban	b aː˩ b a˩ ŋ
babana	b aː˩ b ə˥ n ə˥
babangida	b aː˩ b ɛ˥ ɲ ɟ ɪ˩ d aː˥
babangidaa	b aː˩ b ɛ˥ ɲ ɟ ɪ˩ d aː˥
babansa	b aː˩ b a˥ n s ə˩
babarta	b aː˩ b a˥ r t aː˩
babba	b a˩ b ə˥
babban	b a˩ b a˩ ŋ
babbar	b a˩ b a˩ r
babel	b aː˩ b eː˥ l
babi	b ə˩ b iː˥
babin	b aː˩ b ɪ˩ ŋ
babu	b aː˩ b ʊ˥
babur	b aː˩ b ʊ˥ r
bacci	b a˥ tʃ iː˥
baccin	b a˥ tʃ ɪ˩ ŋ
bace	b ə˩ tʃ eː˩
baci	b ə˩ tʃ iː˥
bacin	b aː˩ tʃ ɪ˥ ŋ
bada	b ə˥ d aː˩
badi	b ə˩ d iː˥
bado	b ə˥ d oː˩
badun	b aː˩ d ɪ˩ ŋ
bafaranshe	b ə˥ ɸ aː˥ r ə˥ n ə˥ ʃ e˥
baffa	b a˥ ɸ ə˩
bafilatani	b ə˩ ɸ ɪ˥ l aː˥ t ə˩ n iː˥
bafillace	b ə˩ ɸ ɪ˥ l aː˥ tʃ eː˩
bagadaza	b ə˩ ɡ ə˩ d aː˥ z ə˩
bagwari	b ə˩ ɡʷ aː˥ ɽ iː˥
bahar	b ə˥ h a˩ r
bahaushe	b ə˩ h aw˥ ʃ eː˩
bahili	b ə˩ h iː˥ l iː˩
baho	b aː˥ h oː˩
bahon	b ə˩ h oː˥ ŋ
bai	b aj˥˦
baibai	b aj˩ b aj˥˦
baikon	b aj˩ kʷ oː˩ ŋ
baiti	b aj˥ t iː˩
baitulmali	b aj˩ t ɪ˩ l m aː˥ l ɪ˩
baiwa	b aj˥˦ w aː˥
baiwa	b aj˥˦ w ə˥
baiyana	b aj˩ j aː˥ n aː˩
baiyi	b aj˩ j iː˥
bajau	b ə˥ dʒ aw˥
baje	b ə˥ dʒ e˩
bajinta	b ə˥ dʒ ɪ˥ n t aː˩
bajo	b aː˥ dʒ oː˩
bajon	b ə˥ dʒ ɔ˩ ŋ
baka	b ə˥ k ə˩
baka	b ə˩ k aː˥
bakanta	b ə˩ k a˩ n t aː˥
baki	b aː˩ c iː˥
bakin	b aː˥ c ɪ˩ ŋ
bakinka	b aː˥ c ɪ˩ ŋ k aː˥
bakinsa	b aː˥ c ɪ˩ n s aː˩
bakinta	b aː˥ c ɪ˥ n t aː˩
bako	b ə˥ kʷ oː˩
bakon	b ə˥ kʷ oː˩ ŋ
baku	b ə˥ kʷ ʊ˩
bakunan	b ə˥ kʷ uː˩ n a˥˦ ŋ
bakunci	b ə˥ kʷ uː˥ n tʃ iː˥
bakuwa	b ə˥ kʷ ʊ˥ w aː˥
bakwai	b ə˥ kʷ aj˩
bal	b a˥˦ l
bala'i	b ə˩ l aː˥ ʔ iː˩
bala'in	b ə˩ l aː˥ ʔ ɪ˥ ŋ
balaga	b ə˩ l aː˥ ɡ aː˥
balaraba	b ə˩ l aː˥ r ə˥ b ə˩
balarabe	b ə˩ l aː˥ r ə˥ b eː˩
balarabe	b ə˩ l aː˥ r ə˥ b e˩
balaraben	b ə˩ l aː˥ r ə˥ b eː˩ ŋ
balas	b ə˥ l a˩ s
balcony	b ə˩ l tʃ oː˥ n j
baligai	b ə˩ l ɪ˥ ɡ aj˥
ballet	b ə˩ l eː˥ t
bama	b aː˥ m aː˩
bambam	b a˩ m b a˥ ŋ
bamban	b a˩ m b a˩ ŋ
bambanci	b a˩ m b a˥ n tʃ iː˥
bambancin	b a˩ m b a˥ n tʃ ɪ˩ ŋ
bambanta	b a˩ m b a˥ n t aː˩
bamu	b aː˥ m ʊ˩
bamuwa	b a˩ m ʊ˥ w aː˥
ban	b a˩ ŋ
bana	b ə˥ n ə˥
banban	b a˩ ŋ b a˩ ŋ
banbanci	b a˩ ŋ b a˥ n tʃ iː˥
banbancin	b a˩ ŋ b a˥ n tʃ ɪ˩ ŋ
banbanta	b a˩ ŋ b a˥ n t aː˩
banci	b a˥ n tʃ iː˥
band	b a˩ n d
banda	b a˩ n d aː˥
bandariya	b a˩ n d ə˩ r ɪ˥ j ɛ˩
bane	b aː˥ n e˥
bang	b a˩ ŋ
banga	b a˩ ŋ ɡ aː˥
bangare	b a˥ ŋ ɡ ə˥ ɽ eː˩
bangaren	b a˥ ŋ ɡ ə˥ ɽ eː˩ ŋ
bangarori	b a˥ ŋ ɡ ə˥ ɽ oː˩ ɽ iː˥
bangarorin	b a˥ ŋ ɡ ə˥ ɽ oː˩ ɽ ɪ˥ ŋ
bango	b a˥ ŋ ɡʷ oː˥
bangon	b a˥ ŋ ɡʷ oː˥ ŋ
bani	b aː˥ n iː˩
banji	b aː˥ n dʒ iː˥
banki	b ɛ˥ ɲ c iː˩
bankin	b ɛ˥ ɲ c ɪ˥ ŋ
bankuna	b a˩ ŋ kʷ ʊ˩ n aː˥
bankunan	b a˩ ŋ kʷ uː˩ n a˥˦ ŋ
bankwana	b a˩ ŋ kʷ ə˥ n ə˥
bansanka	b aː˥ n s a˥ ŋ k aː˥
banɗaki	b aː˥ n ɗ aː˥ c iː˩
bao	b ə˥ o˥
bappa	b a˥ p p ə˩
bar	b a˩ r
bara	b aː˩ r aː˥
bara	b aː˩ ɽ ə˥
bara	b ə˥ r aː˩
bara	b ə˥ ɽ aː˩
barack	b ə˩ r ə˩ k
baraka	b aː˩ ɽ ə˥ k aː˥
bararo	b ə˩ r ə˩ r oː˥
barasa	b ə˩ r aː˥ s aː˩
barau	b ə˩ ɽ aw˥
barayi	b ə˥ ɽ aː˩ j iː˥
barazana	b aː˩ ɽ ə˥ z ə˥ n ə˥
barazanar	b aː˩ ɽ ə˥ z ə˥ n a˩ r
barazil	b ə˩ r ə˩ z ɪ˥˦ l
barbarci	b a˥ ɽ b a˥ ɽ tʃ iː˥
barci	b a˥ ɽ tʃ iː˥
bare	b ə˩ ɽ eː˥
barewa	b ə˩ ɽ eː˥ w aː˥
bargo	b a˩ r ɡʷ oː˥
bari	b ə˩ r iː˥
barin	b ə˩ ɽ ɪ˥ ŋ
barinka	b a˩ r ɪ˩ ŋ k aː˥
barka	b a˥ r k aː˩
barkanku	b a˥ r k a˩ ŋ kʷ ʊ˩
barkanmu	b a˥ r k a˩ n m uː˩
barke	b a˥ ɽ c eː˥
barkono	b a˩ r kʷ oː˩ n oː˥
barna	b a˩ r n aː˩
barni	b a˩ r n iː˥
barno	b a˩ r n o˥
barologi	b a˥ ɽ oː˩ l oː˩ ɟ iː˥
barology	b a˥ ɽ oː˩ l oː˩ ɡ j
barrister	b a˥ r ɪ˥ s t eː˥ r
barshi	b a˥ ɽ ʃ iː˥
barta	b a˥ r t aː˩
bas	b a˥˦ s
basa	b aː˥ s aː˩
basakkwace	b ə˩ s a˥ kʷ ə˥ tʃ eː˩
basasa	b aː˥ s aː˥ s aː˩
baseball	b ə˩ s e˥˦ b a˩ l
bashi	b ə˩ ʃ iː˥
bashin	b ə˩ ʃ ɪ˥˦ ŋ
bashinmu	b ə˩ ʃ ɪ˥ ɲ m uː˩
bashir	b aː˥ ʃ ɪ˩ r
basira	b ə˩ s iː˥ r aː˩
basu	b ə˩ s ɪ˥
basukur	b aː˥ s ɪ˥ kʷ ʊ˩ r
basusuka	b ə˩ s ɪ˥ s ɪ˥ k aː˩
bata	b ə˥ t aː˩
batare	b ə˥ t aː˥ r e˩
batir	b aː˥ t ɪ˩ r
batirin	b aː˥ t ɪ˩ r ɪ˥ ŋ
batta	b a˥ t aː˩
batu	b ə˥ t ɪ˩
batun	b ə˩ t ɪ˥ ŋ
bature	b ə˩ t uː˥ r eː˩
batutuwa	b ə˩ t uː˥ t ʊ˥ w aː˥
batutuwan	b ə˩ t uː˥ t ʊ˥ w a˩ ŋ
bauchi	b aw˩ tʃ iː˩
bauchin	b aw˩ tʃ ɪ˥ ŋ
bauta	b aw˩ t aː˥
bautawa	b aw˩ t aː˥ w aː˥
bawa	b aː˥ w aː˩
bawa	b aː˥ w ə˩
bawai	b aː˥ w aj˩
bawan	b aː˥ w a˥˦ ŋ
bay	b aː˥ j
baya	b aː˥ j aː˥
baya	b aː˥ j ɛ˥
bayan	b aː˥ j ɛ˥ ŋ
bayana	b aː˥ j aː˥ n aː˩
bayanai	b aː˥ j aː˥ n aj˥
bayanan	b aː˥ j aː˥ n a˥˦ ŋ
bayani	b aː˥ j aː˥ n iː˩
bayanin	b aː˥ j aː˩ n ɪ˥ ŋ
bayansa	b aː˥ j aː˥ n s aː˩
bayansu	b aː˥ j aː˥ n s ɪ˩
bayar	b aː˥ j ɛ˥ r
bayarwa	b aː˥ j aː˥ ɽ w aː˥
bayelsa	b aː˥ j eː˥ l s aː˩
bayi	b aː˥ j ɪ˩
bayin	b aː˥ j ɪ˩ ŋ
bayyana	b aː˥ j aː˥ n aː˩
bayyanarsa	b aː˥ j aː˩ n a˩ r aː˩
bayyane	b aː˥ j aː˩ n e˥
bayyanin	b aː˥ j aː˩ n ɪ˥ ŋ
bayyanuwar	b aː˥ j aː˩ n ʊ˥ w a˥ r
baza	b ə˥ z aː˩
bazai	b ə˥ z aj˥
bazan	b ə˥ z a˥˦ ŋ
bazara	b ə˥ z aː˩ r aː˥
bazarar	b ə˥ z aː˩ r a˩ r
bazuwa	b ə˩ z ʊ˥ w aː˥
baƙi	b ə˥ cʼ iː˥
baƙin	b ə˥ cʼ ɪ˥ ŋ
baƙo	b aː˩ kʷʼ o˥
baƙon	b aː˩ kʷʼ oː˥ ŋ
baƙuwa	b aː˩ kʷʼ ʊ˥ w aː˥
bear	b a˥ a˩ r
beckham	b e˥ k a˥˦ m
bedi	b eː˥ d iː˩
begas	b eː˥ ɡ a˩ s
bege	b a˥ ɟ eː˥
begen	b a˥ ɟ eː˥ ŋ
bei	b eː˥ iː˩
beichuan	b a˥ ɪ˥ tʃ uː˥ a˥˦ ŋ
beijing	b a˥ ɪ˥ dʒ ɪ˥ ŋ
beiruit	b a˥ ɪ˥ ɽ ɪ˥ ɪ˥ t
bel	b a˥ l
belgium	b a˥ l ɟ ɪ˩ ʊ˩ ŋ
belina	b a˥ l ɪ˥ n aː˩
bella	b a˥ l aː˩
bello	b a˥ l o˩
ben	b eː˥ ŋ
benaye	b a˥ n ɛ˩ j eː˥
bene	b eː˥ n e˥
benzalkonium	b eː˥ n z a˥ l kʷ oː˩ n iː˥ ʊ˩ ŋ
berlin	b eː˥ ɽ l ɪ˩ ŋ
beth	b a˥ t h
bi	b ɪ˩
bibini	b ɪ˥ b ɪ˥ n iː˥
bici	b ɪ˥ tʃ ɪ˩
bidi'a	b ɪ˥ d ɪ˥ ʔ aː˩
bidiyo	b ɪ˥ d ɪ˥ j oː˥˦
bidiyon	b ɪ˥ d ɪ˥ j ɔ˩ ŋ
bif	b ɪ˥˦ p
bige	b ɪ˥ ɟ e˥
bijiro	b ɪ˥ dʒ ɪ˥ ɽ oː˩
bika	b ɪ˩ k aː˥
biki	b ɪ˩ c iː˥
bikin	b ɪ˥ c ɪ˥ ŋ
bil	b ɪ˥˦ l
biliyan	b ɪ˥ l ɪ˩ j aː˥ ŋ
bilkisu	b ɪ˥ l c ɪ˥ s ɪ˩
bill	b ɪ˥ l
bin	b ɪ˩ ŋ
bincika	b ɪ˥ n tʃ ɪ˥ k aː˩
bincikar	b ɪ˥ n tʃ ɪ˥ k a˩ r
bincike	b ɪ˥ n tʃ ɪ˥ c eː˥
binciken	b ɪ˥ n tʃ ɪ˩ c a˥ ŋ
bincikenka	b ɪ˥ n tʃ ɪ˩ c a˥ ŋ k aː˥
bindi	b ɪ˥ n d iː˩
bindiga	b ɪ˥ n d ɪ˥ ɡ aː˩
bindigar	b ɪ˥ n d ɪ˥ ɡ aː˩ r
bindigogi	b ɪ˥ n d ɪ˥ ɡʷ oː˩ ɟ iː˥
bini	b iː˩ n ɪ˥
binne	b ɪ˥ n e˥
binta	b ɪ˥ n t ə˩
binuwai	b ɪ˥ n ʊ˥ w aj˩
birane	b ɪ˩ r a˥ n e˥
biranen	b ɪ˩ r a˥ n eː˥ ŋ
birbishin	b ɪ˩ r b ɪ˥ ʃ ɪ˥ ŋ
biredi	b ɪ˩ r e˥ d iː˩
biredin	b ɪ˥ ɽ eː˥ d ɪ˥ ŋ
birgediya	b ɪ˩ r ɟ eː˥ d ɪ˥ j aː˩
birgima	b ɪ˥ ɽ ɟ iː˥ m aː˩
biri	b ɪ˩ r iː˥
biris	b ɪ˥ ɽ ɪ˩ s
birjik	b ɪ˩ r dʒ ɪ˥ k
birni	b ɪ˥ r n iː˥
birnin	b ɪ˥ r n ɪ˥ ŋ
birtaniya	b ɪ˩ r t aː˥ n ɪ˥ j ɛ˩
birtaniyya	b ɪ˩ r t aː˥ n ɪ˥ j aː˩
bisa	b ɪ˥ s aː˥
bisani	b ɪ˥ s aː˥ n iː˩
bisashe	b ɪ˥ s ə˥ ʃ e˥
bishiya	b ɪ˥ ʃ ɪ˥ j aː˩
bishiyar	b ɪ˥ ʃ ɪ˥ j ɛ˥ r
bishiyoyi	b ɪ˥ ʃ ɪ˥ j oː˩ j ɪ˥
bishiyoyin	b ɪ˥ ʃ ɪ˥ j oː˩ j ɪ˥ ŋ
bisimilla	b ɪ˩ s ɪ˥ m ɪ˥ l aː˩
bisimillahi	b ɪ˩ s ɪ˥ m ɪ˩ l aː˥ h iː˩
biskit	b ɪ˩ s c ɪ˥ t
bissau	b ɪ˥ s aw˥
bitrus	b ɪ˥ t ɽ ɪ˩ s
bitrusa	b ɪ˥ t ɽ ʊ˥ s aː˩
biya	b ɪ˥ j ɛ˩
biyan	b ɪ˥ j ɛ˩ ŋ
biyar	b ɪ˩ j ɛ˥ r
biyayya	b ɪ˩ j ɛ˥ j aː˩
biyayyaga	b ɪ˩ j ɛ˥ j aː˥ ɡ aː˥
biye	b ɪ˩ j eː˥
biyo	b ɪ˩ j oː˥˦
biyu	b ɪ˥ j ʊ˥
biyun	b ɪ˩ j ʊ˩ ŋ
biza	b iː˥ z aː˩
blair	b l eː˥ r
bo	b oː˩
bob	b oː˥ b
boca	b oː˥ tʃ aː˩
boko	b oː˥ kʷ oː˩
bolar	b oː˩ l a˩ r
bom	b oː˩ ŋ
boma	b oː˩ m ə˩
bomai	b oː˥ m aj˥
boncin	b oː˩ n tʃ ɪ˩ ŋ
bonono	b oː˩ n oː˩ n oː˩
bora	b oː˥ ɽ aː˩
bori	b oː˩ ɽ iː˥
bosniya	b ɔ˥ s n ɪ˥ j ɛ˩
bostom	b ɔ˥ s t a˥˦ ŋ
boston	b ɔ˥ s t a˥ ŋ
bota	b oː˥ t aː˩
botswana	b oː˩ sʼ w aː˥ n aː˩
boyayyen	b oː˩ j ɛ˥ j eː˥ ŋ
boye	b oː˩ j eː˥
boyi	b oː˩ j ɪ˥
boɗoɗo	b oː˩ ɗ oː˩ ɗ oː˩
brandy	b r ə˩ n d j
brass	b r ə˩ s
brawsa	b r ə˩ w s aː˩
brazil	b r ə˩ z ɪ˥˦ l
breed	b r eː˩ d
britaniya	b r ɪ˥ t aː˥ n ɪ˥ j ɛ˩
brooklyn	b r oː˥ oː˥ kʷ l j ŋ
brown	b r oː˥ w ŋ
browsar	b r oː˥ w s a˩ r
bu	b ʊ˩
buda	b ʊ˩ d aː˩
budda	b ʊ˥ d ə˩
buddah	b ʊ˥ d aː˩
buddha	b ʊ˥ d h aː˩
bude	b ʊ˩ d e˩
budurwa	b ʊ˩ d ɪ˥ ɽ w aː˥
budurwar	b ʊ˩ d ɪ˥ ɽ w a˥ r
budurwarsa	b ʊ˩ d ɪ˥ ɽ w a˥ r s aː˥
buduwarsa	b ʊ˩ d ʊ˥ w a˥ r s aː˥
buga	b ʊ˩ ɡ aː˥
bugawa	b ʊ˩ ɡ aː˥ w aː˥
buge	b ʊ˩ ɟ eː˥
bugs	b ʊ˩ ɡʷ s
bugu	b ʊ˩ ɡʷ ʊ˩
bugun	b ʊ˩ ɡʷ ʊ˩ ŋ
buguzunzum	b ʊ˩ ɡʷ ʊ˩ z ɪ˩ n z ɪ˩ m
bukaci	b ʊ˥ k ə˩ tʃ iː˥
bukata	b ʊ˥ k ə˥ t aː˩
bukatan	b ʊ˥ k ə˥ t a˩ ŋ
bukatar	b ʊ˥ k ə˥ t a˩ r
bukatu	b ʊ˥ k ə˥ t ɪ˩
bukatun	b ʊ˥ k ə˩ t ɪ˥ ŋ
bukatunsu	b ʊ˥ k ə˩ t ɪ˩ n s ɪ˩
bukka	b ʊ˥ k k aː˩
bukukuwa	b ʊ˩ kʷ uː˥ kʷ ʊ˥ w aː˥
bukukuwan	b ɪ˩ kʷ ʊ˩ kʷ ʊ˩ w a˥ ŋ
bula	b ʊ˥ l aː˩
bulla	b ʊ˩ l aː˩
bullo	b ʊ˩ l oː˥
bullowa	b ʊ˩ l oː˥ w aː˩
bullowar	b ʊ˩ l oː˥ w a˥ r
bunkasa	b ʊ˩ ŋ k aː˩ s aː˩
bunkasuwa	b ʊ˩ ŋ k aː˩ s ʊ˥ w aː˥
bunkasuwar	b ʊ˩ ŋ k aː˩ s ʊ˥ w a˥ r
bunkasuwarsu	b ʊ˩ ŋ k aː˩ s ʊ˥ w aː˥ ɽ s ɪ˩
bunny	b ʊ˩ ŋ ɲ j
bunƙasa	b ʊ˩ ŋ kʼ ə˥ s aː˥
bunƙasar	b ʊ˩ ŋ kʼ ə˥ s a˩ r
bura	b uː˥ ɽ aː˥
buraguzen	b uː˥ ɽ ə˥ ɡʷ ʊ˩ z eː˩ ŋ
burge	b ʊ˩ r ɟ eː˥
burgewa	b ʊ˩ r ɟ eː˥ w aː˩
buri	b ʊ˩ r iː˩
burin	b ʊ˩ r ɪ˥ ŋ
burina	b ʊ˩ r ɪ˥ n aː˩
burinmu	b ʊ˩ r ɪ˥ n m uː˩
burinsa	b ʊ˩ r ɪ˥ n s aː˩
burinsu	b ʊ˩ r ɪ˥ n s ɪ˩
burinta	b ʊ˩ r ɪ˥ n t aː˩
buroka	b ʊ˩ r oː˥ k aː˩
burtaniya	b ʊ˩ r t aː˥ n ɪ˥ j ɛ˩
burundi	b ʊ˩ r ɪ˩ n d iː˩
burɗunɗun	b ʊ˩ r ɗ ɪ˩ n ɗ ɪ˩ ŋ
bus	b ʊ˩ s
busa	b ʊ˥ s aː˩
busashen	b uː˥ s ə˥ ʃ e˥ ŋ
busawa	b uː˥ s aː˥ w aː˥
bush	b ʊ˥ ʃ
bushara	b ʊ˥ ʃ aː˥ r aː˩
bushe	b uː˥ ʃ eː˩
bushewa	b ʊ˥ ʃ eː˩ w aː˥
business	b ʊ˥ s iː˥ n eː˥ s
buta	b uː˥ t aː˩
bututun	b uː˥ t uː˥ t ɪ˥ ŋ
buwayi	b ʊ˥ w aː˩ j iː˥
buyi	b uː˥ j iː˥
buƙaci	b ʊ˥ kʼ ə˩ tʃ iː˥
buƙata	b ʊ˥ kʼ aː˥ t aː˩
buƙatar	b ʊ˥ kʼ aː˥ t a˩ r
buƙwi	b ʊ˩ kʷʼ iː˥
buɗe	b ʊ˥ ɗ eː˩
buɗi	b ʊ˥ ɗ iː˥
buɗuɗu	b ʊ˥ ɗ ɪ˥ ɗ ɪ˥
ca	tʃ aː˥
ca	tʃ aː˥˦
caca	tʃ aː˩ tʃ aː˩
cadi	tʃ aː˥ d ɪ˩
caja	tʃ aː˥ dʒ aː˩
caji	tʃ aː˥ dʒ ɪ˩
caka	tʃ ə˥ k ə˥
caka	tʃ ə˩ k aː˥
cakawa	tʃ ə˩ k aː˥ w aː˥
cakulan	tʃ aː˥ kʷ ʊ˩ l a˥˦ ŋ
cakulet	tʃ aː˥ kʷ ʊ˩ l eː˥ t
cakuletin	tʃ aː˥ kʷ ʊ˩ l eː˥ t ɪ˥ ŋ
calawa	tʃ aː˥ l aː˥ w aː˥
caleb	tʃ aː˥ l eː˩ b
cali	tʃ aː˥ l iː˥
cali	tʃ aː˩ l ɪ˥
california	tʃ aː˥ l ɪ˩ ɸ oː˥ r n iː˥ aː˩
camerron	tʃ aː˥ m r ɔ˩ ŋ
can	tʃ a˩ ŋ
canada	tʃ ə˥ n ə˥ d aː˩
cancanci	tʃ a˥ n tʃ a˥ n tʃ iː˥
canja	tʃ a˥ n dʒ ə˩
canjawa	tʃ aː˥ n dʒ aː˥ w aː˥
canji	tʃ aː˥ n dʒ iː˥
canka	tʃ a˩ ŋ k aː˥
canko	tʃ a˩ ŋ kʷ oː˥
canza	tʃ a˩ n z aː˩
canzan	tʃ a˩ n z a˥˦ ŋ
canzawa	tʃ a˩ n z aː˥ w aː˥
cao	tʃ o˥
carol	tʃ aː˥ ɽ oː˩ l
carter	tʃ aː˥ r t eː˥ r
casa'in	tʃ ə˩ s ə˩ ʔ ɪ˥ ŋ
castro	tʃ ə˩ s t ɽ oː˩
casu	tʃ ə˩ s ɪ˥
cat	tʃ aː˥ t
cata	tʃ aː˥ t aː˩
cathrine	tʃ aː˥ t h r ɪ˩ n e˥
caɓaɓa	tʃ ə˥ ɓ ə˥ ɓ ə˥
ce	tʃ eː˩
ceci	tʃ eː˥ tʃ iː˥
cek	tʃ eː˩ k
ceto	tʃ eː˩ t o˥
ceton	tʃ eː˩ t a˥ ŋ
cewa	tʃ eː˥ w aː˩
cewar	tʃ eː˥ w a˥ r
chadi	tʃ ə˩ d iː˥
chaja	tʃ a˥ dʒ aː˩
chalie	tʃ ə˩ l ɪ˥ eː˩
champagne	ʃ a˥ m p ə˩ ɡ n e˥
chang	tʃ a˥ ŋ
chen	tʃ eː˥ ŋ
cheng	tʃ eː˥ ŋ
chengdu	tʃ eː˥ ŋ ɡʷ d ɪ˩
cherlie	tʃ eː˥ ɽ l ɪ˥ eː˩
cherry	tʃ eː˥ r j
chess	tʃ eː˥ s
chi	tʃ iː˩
chicago	tʃ ɪ˥ tʃ ə˥ ɡʷ oː˥
chin	tʃ ɪ˥ ŋ
china	tʃ iː˥ n ə˩
chinedu	tʃ iː˥ n eː˥ d ɪ˩
chloride	k l oː˥ r ɪ˥ d e˩
chris	tʃ r ɪ˩ s
chu	tʃ ʊ˩
ci	tʃ ɪ˥
cibi	tʃ iː˥ b iː˩
cibi	tʃ ɪ˥ b iː˥
cibiya	tʃ ɪ˥ b ɪ˥ j ɛ˩
cibiyar	tʃ ɪ˥ b ɪ˩ j ɛ˥ r
cibiyoyi	tʃ ɪ˥ b ɪ˥ j oː˩ j ɪ˥
cibiyoyin	tʃ ɪ˥ b ɪ˥ j oː˩ j ɪ˥ ŋ
cif	tʃ ɪ˥ p
cif	tʃ ɪ˥˦ ɸ
cigaba	tʃ ɪ˥ ɡ aː˩ b ə˥
cigaban	tʃ ɪ˥ ɡ ə˥ b a˩ ŋ
cije	tʃ ɪ˥ dʒ e˩
cika	tʃ ɪ˥ k aː˩
cikakken	tʃ ɪ˥ k aː˩ c eː˥ ŋ
cikakkiyar	tʃ ɪ˥ k aː˩ c ɪ˩ j ɛ˥ r
cikas	tʃ ɪ˥ k a˩ s
cikawa	tʃ ɪ˥ k aː˥ w aː˥
cike	tʃ ɪ˥ c eː˥
ciki	tʃ ɪ˥ c iː˩
ciki	tʃ ɪ˥ c ɪ˥
cikin	tʃ ɪ˥ c ɪ˥ ŋ
cikina	tʃ ɪ˥ c ɪ˥ n aː˩
cikinsa	tʃ ɪ˥ c ɪ˥ n s aː˩
cikinsu	tʃ ɪ˥ c ɪ˥ n s ɪ˩
cikinta	tʃ ɪ˥ c ɪ˥ n t aː˩
cikon	tʃ ɪ˥ c ɔ˩ ŋ
cim	tʃ ɪ˥˦ ŋ
cimma	tʃ ɪ˥ m aː˩
cin	tʃ ɪ˥ ŋ
cincinnati	tʃ ɪ˥ n tʃ ɪ˥ n ə˥ t ɪ˩
cindo	tʃ ɪ˥ n d oː˩
cinikayya	tʃ ɪ˥ n ɪ˥ k ɛ˥ j aː˩
cinikayyar	tʃ ɪ˥ n ɪ˥ k ɛ˥ j ɛ˥ r
ciniki	tʃ ɪ˥ n ɪ˩ c iː˥
cinikin	tʃ ɪ˥ n ɪ˥ c ɪ˥ ŋ
cinikiya	tʃ ɪ˥ n ɪ˥ c ɪ˥ j aː˩
cinye	tʃ ɪ˥ ɲ j eː˥
cir	tʃ ɪ˥˦ r
cirar	tʃ ɪ˥ r a˩ r
circus	tʃ ɪ˥ r tʃ ɪ˩ s
cire	tʃ ɪ˥ r eː˩
ciroma	tʃ ɪ˥ r oː˩ m ə˩
citta	tʃ ɪ˥ t ə˩
citta	tʃ ɪ˩ t ə˥
city	s ɪ˥ t iː˩
ciwo	tʃ iː˥ w oː˩
ciwon	tʃ iː˥ w oː˩ ŋ
ciyar	tʃ ɪ˥ j ɛ˥ r
ciyawa	s ɪ˩ j aː˥ w aː˥
ciyawar	tʃ ɪ˥ j aː˥ w a˥ r
ciyayi	tʃ ɪ˥ j ɛ˩ j iː˥
cizon	tʃ ɪ˥ z oː˥ ŋ
ckin	c ɪ˥ ŋ
classic	k l a˩ s ɪ˥ tʃ
claus	k l aw˩ s
clinton	k l ɪ˥ n t a˥ ŋ
co	tʃ oː˥
coci	tʃ oː˥ tʃ ɪ˩
cocin	kʷ oː˥ tʃ ɪ˩ ŋ
cocinsa	kʷ oː˥ tʃ iː˩ n s aː˩
coi	tʃ o˥ ɪ˥
cokali	tʃ oː˥ k ə˩ l iː˥
collins	kʷ oː˥ l iː˩ n s
colombia	kʷ oː˥ l oː˩ m b iː˥ aː˩
conakry	kʷ oː˥ n aː˥ c r j
cond	tʃ oː˥ n d
confucius	tʃ oː˥ n ɸ ʊ˩ tʃ iː˥ ɪ˩ s
congo	kʷ oː˥ ŋ ɡʷ oː˥
costa	kʷ oː˥ s t aː˩
cousin	kʷ oː˥ ʊ˥ s ɪ˩ ŋ
cross	k ɽ oː˩ s
cuba	tʃ uː˥ b aː˩
cuci	tʃ ɪ˥ tʃ iː˥
cudanyar	tʃ uː˥ d ɛ˥ ɲ j ɛ˥ r
cuku	tʃ ɪ˥ kʷ uː˥
cukwi	tʃ ɪ˥ kʷ iː˥
cult	tʃ uː˥ l t
cuna	tʃ uː˥ n aː˩
cunkushe	tʃ uː˥ n kʷ ʊ˥ ʃ eː˩
cura	tʃ uː˥ ɽ aː˩
cure	tʃ uː˥ ɽ eː˩
curi	tʃ uː˥ ɽ iː˩
cusa	tʃ uː˥ s aː˩
cuta	tʃ uː˥ t aː˩
cutan	tʃ uː˥ t a˩ ŋ
cutar	tʃ uː˥ t a˩ r
cutuka	tʃ uː˥ t ɪ˥ k aː˩
cututtuka	tʃ uː˥ t uː˥ t ɪ˥ k aː˩
cututtukan	tʃ uː˥ t uː˥ t ɪ˥ k a˩ ŋ
cututuka	tʃ uː˥ t uː˥ t ɪ˥ k aː˩
cwai	tʃ w aj˥
da	d aː˩
da'awa	d ə˩ ʔ a˩ w aː˥
da'ira	d aː˥ ʔ ɪ˩ r aː˥
da'kalibar	d ə˩ ʔ k aː˥ l ɪ˩ b a˩ r
daama	d aː˥ m aː˩
daamu	d aː˥ m ʊ˩
dab	d a˩ b
dabam	d ə˥ b a˩ ŋ
daban	d ə˥ b a˩ ŋ
dabara	d ə˥ b ə˩ r aː˥
dabarar	d ə˥ b ə˩ r a˩ r
dabaru	d ə˥ b ə˩ r uː˥
dabarun	d ə˥ b ə˩ r ɪ˥ ŋ
dabba	d a˥ b aː˩
dabbobi	d a˥ b oː˥ b iː˥
dabbobin	d a˥ b oː˥ b ɪ˩ ŋ
dabino	d ə˥ b iː˥ n oː˩
dabo	d ə˥ b oː˩
dabobbi	d aː˩ b oː˥ b ɪ˩
dace	d ə˩ tʃ eː˩
dacewa	d aː˩ tʃ eː˥ w aː˩
dacewar	d aː˩ tʃ eː˥ w a˥ r
dadadden	d ə˥ d ə˥ d eː˩ ŋ
daddale	d a˩ d ə˥ l eː˩
daddare	d a˩ d ə˥ ɽ eː˩
daddawa	d a˩ d ə˥ w aː˥
dade	d ə˩ d e˩
dadewa	d a˩ d eː˥ w aː˩
dadi	d a˩ d iː˥
dadin	d a˩ d ɪ˩ ŋ
dafa	d ə˥ ɸ aː˩
dafawa	d ə˥ ɸ aː˥ w aː˥
dafe	d ə˥ ɸ e˥
daftari	d a˥ ɸ t ə˩ r iː˥
daga	d aː˥ ɡ aː˥
daga	d ə˥ ɡ aː˥
dage	d ə˥ ɟ eː˥
dagiya	d ə˥ ɟ ɪ˩ j aː˥
daguwa	d ə˥ ɟ ʊ˥ w aː˥
dahir	d aː˥ h ɪ˩ r
dai	d aj˥
daida	d aj˥ d aː˩
daidai	d aj˥ d aj˥
daidaici	d aj˥ d aj˥ tʃ iː˥
daidaita	d aj˥ d aj˥ t ə˥
daidaitawa	d aj˥ d aj˥ t aː˥ w aː˥
daidaito	d aj˥ d aj˥ t o˥
daidaiton	d aj˥ d aj˥ t a˥ ŋ
daidaituwa	d aj˥ d aj˥ t ʊ˥ w aː˥
daidaiwuwa	d aj˥ d aj˥ w ʊ˥ w aː˥
daily	d aj˥ l j
daimon	d aj˥ m ɔ˩ ŋ
daina	d aj˥ n aː˩
daji	d a˥ dʒ iː˥
dajin	d aː˥ dʒ ɪ˩ ŋ
daka	d ə˥ k aː˥
dakalin	d ə˥ k aː˥ l ɪ˩ ŋ
dakar	d ə˥ k a˩ r
dakaru	d ə˥ k a˩ r uː˥
dakarun	d ə˥ k a˩ r ɪ˩ ŋ
dakata	d ə˥ k ə˥ t aː˩
dakatar	d ə˥ k ə˥ t a˩ r
dake	d ə˩ c eː˥
daki	d aː˥ c iː˩
dakile	d aː˥ c ɪ˩ l eː˩
dakin	d aː˥ c ɪ˩ ŋ
dakinsa	d aː˥ c ɪ˩ n s aː˩
dakon	d ə˥ kʷ oː˩ ŋ
dakta	d ə˥ k t aː˩
dakuma	d aː˥ kʷ ʊ˩ m aː˥
dakuna	d aː˥ kʷ ʊ˩ n aː˥
dakunan	d ə˥ kʷ uː˩ n a˥˦ ŋ
dala	d aː˩ l ə˥
dala	d ə˥ l aː˩
dalai	d ə˥ l aj˥
dalar	d ə˥ l a˩ r
dalibai	d aː˥ l ɪ˩ b aj˥
daliban	d aː˥ l ɪ˩ b a˩ ŋ
dalibi	d aː˥ l ɪ˩ b iː˥
dalibta	d aː˥ l ɪ˩ b t aː˩
dalilai	d ə˩ l iː˥ l aj˥
dalilan	d ə˩ l iː˥ l a˥˦ ŋ
dalili	d ə˩ l iː˥ l iː˩
dalilin	d ə˩ l iː˥ l ɪ˩ ŋ
dallar	d a˩ l a˩ r
dalma	d a˩ l m aː˥
daloli	d aː˥ l oː˩ l iː˥
dam	d a˩ ŋ
dama	d ə˩ m aː˥
damagaram	d ə˩ m ə˥ ɡ ə˩ r a˥ ŋ
daman	d ə˩ m a˩ ŋ
damar	d ə˩ m a˩ r
damara	d ə˩ m ə˩ r aː˥
damaskas	d ə˩ m ə˩ s k a˩ s
dambe	d a˥ m b e˥
dambu	d a˥ m b uː˥
dame	d a˥ m eː˩
damisa	d aː˩ m ɪ˥ s aː˩
damshi	d a˥ m ʃ iː˥
damu	d aː˥ m ʊ˩
damun	d a˥ m ʊ˩ ŋ
damuwa	d a˥ m ʊ˥ w aː˥
damuwan	d a˥ m ʊ˩ w a˥ ŋ
damuwar	d a˥ m ʊ˥ w a˥ r
damuwarsu	d a˥ m ʊ˩ w aː˥ ɽ s ɪ˩
damuwarta	d a˥ m ʊ˩ w a˥ r t aː˩
damƙe	d a˥ m cʼ eː˩
dan	d a˩ ŋ
danana	d ə˥ n ə˥ n ə˥
danda	d a˩ n d ə˥
dandali	d a˥ n d ə˩ l iː˥
dandalin	d a˥ n d a˩ l ɪ˩ ŋ
dandamalin	d a˥ n d ə˩ m aː˥ l ɪ˩ ŋ
dandana	d a˩ n d ə˥ n ə˥
dandano	d a˩ n d ə˥ n o˥
danfulani	d aː˥ n ɸ ʊ˩ l aː˥ n iː˩
danga	d a˥ ŋ ɡ aː˥
dangane	d a˥ ŋ ɡ ə˥ n e˥
danganta	d a˥ ŋ ɡ a˥ n t aː˩
dangantaka	d a˥ ŋ ɡ a˥ n t ə˥ k aː˩
dangantakar	d a˥ ŋ ɡ a˥ n t ə˥ k a˩ r
dangantakarsu	d a˥ ŋ ɡ a˥ n t ə˥ k a˩ r uː˩
dangi	d a˩ ŋ ɡʷ iː˩
dangin	d ə˥ ɛ˥ ɲ ɟ ɪ˩ ŋ
dangogi	d a˩ ŋ ɡʷ oː˩ ɟ iː˥
dani	d aː˥ n iː˩
daniel	d aː˥ n ɪ˥ a˥ l
danja	d a˥ n dʒ ə˩
danjita	d a˥ n dʒ ɪ˥ t ə˩
danka	d a˩ ŋ k aː˥
dankali	d a˩ ŋ k ə˥ l iː˩
dankalin	d a˩ ŋ k ə˥ l ɪ˩ ŋ
dankon	d a˩ ŋ kʷ oː˥ ŋ
danna	d a˥ n aː˩
danne	d a˥ n e˥
dansa	d a˥ n s ə˩
dansandan	d a˥ n s a˥ n d a˩ ŋ
danshin	d aː˥ n ʃ ɪ˥ ŋ
dao	d a˥ o˥
daolang	d ə˥ oː˩ l a˥ ŋ
dara	d aː˥ r aː˩
daraja	d ə˥ r ə˥ dʒ aː˩
darajanta	d ə˥ r ə˥ dʒ a˥ n t aː˩
darajar	d ə˥ r ə˥ dʒ a˥ r
darajarsu	d ə˥ r ə˥ dʒ aː˩ ɽ s ɪ˩
daraktan	d ə˥ r ə˥ k t a˩ ŋ
daram	d ə˥ ɽ a˩ m
darasi	d ə˥ r ə˩ s iː˥
darasin	d ə˥ r ə˩ s ɪ˩ ŋ
dare	d ə˥ ɽ eː˩
darekta	d a˥ r e˥ k t aː˩
daren	d ə˩ ɽ eː˥ ŋ
darfur	d a˥ r ɸ ʊ˩ r
dari	d ə˥ ɽ iː˩
darikar	d ə˩ r ɪ˥ k a˩ r
dariya	d ə˩ r ɪ˥ j ɛ˩
darma	d a˥ r m aː˩
darni	d a˩ r n iː˥
daruruwa	d ə˥ ɽ ɪ˩ ɽ ʊ˥ w aː˥
dasa	d ə˥ s aː˥
dashbod	d ə˩ ʃ b oː˥ d
dashen	d ə˥ ʃ e˥ ŋ
dashi	d ə˩ ʃ iː˥
dasu	d ə˩ s ɪ˥
data	d ə˥ t aː˩
datarwa	d a˥ t ə˩ ɽ w aː˥
dattawa	d a˥ t aː˥ w aː˥
dattawan	d a˥ t aː˥ w a˥˦ ŋ
datti	d a˩ t ɪ˥
dattijai	d a˥ t iː˥ dʒ aj˥
dattijo	d a˥ t iː˥ dʒ o˩
dau	d aw˩
dauda	d aw˥ d aː˩
dauka	d aw˩ k aː˩
daukacin	d aw˩ k aː˩ tʃ ɪ˥ ŋ
daukaka	d aw˩ k ə˥ k aː˩
daukakar	d aw˩ k ə˥ k a˩ r
daukan	d aw˩ k a˩ ŋ
daukar	d aw˩ k a˩ r
dauke	d aw˩ c eː˥
dauki	d aw˩ c iː˥
daula	d aw˥ l aː˩
daular	d aw˥ l a˩ r
dauloli	d aw˥ l oː˩ l iː˥
daulolin	d aw˥ l oː˩ l ɪ˩ ŋ
daura	d aw˩ ɽ aː˥
daure	d aw˥ ɽ eː˥
dauri	d aw˥ ɽ iː˥
dauɗa	d aw˩ ɗ aː˩
dawa	d aː˥ w aː˩
dawa	d ə˥ w ə˩
dawakai	d ə˥ w ə˥ k aj˥
dawaki	d ə˥ w aː˩ c iː˥
dawakin	d ə˥ w aː˩ c ɪ˥ ŋ
dawo	d ə˥ w oː˩
dawowa	d ə˥ w oː˥ w aː˩
dawowata	d ə˥ w oː˥ w ə˥ t aː˩
day	d aː˥ j
daya	d aː˥ j aː˥
daya'	d aː˥ j aː˥ ʔ
dayan	d aː˥ j ɛ˥ ŋ
dayasa	d aː˥ j aː˥ s aː˩
dayawa	d aː˥ j aː˥ w aː˥
dazuzzuka	d ə˩ z ʊ˥ z ɪ˥ k aː˩
daƙashi	d ə˥ kʼ ə˩ ʃ iː˥
daƙiƙa	d ə˩ cʼ iː˥ kʼ aː˩
daƙiƙi	d ə˩ cʼ iː˥ cʼ iː˩
daɓen	d aː˥ ɓ e˩ ŋ
daɗe	d a˥ ɗ eː˥
daɗi	d a˥ ɗ iː˥
daɗin	d aː˥ ɗ ɪ˩ ŋ
de	d e˩
debo	d eː˩ b oː˥
delhi	d eː˩ l h iː˩
delta	d eː˩ l t aː˩
demokradiya	d eː˩ m oː˥ kʷ r aː˥ d ɪ˩ j aː˥
demokuradiyya	d eː˩ m o˩ kʷ ʊ˩ ɽ ə˩ d ɪ˥ j aː˩
demukuradiya	d eː˥ m uː˩ kʷ ʊ˩ ɽ ə˩ d ɪ˥ j aː˩
dena	d eː˥ n aː˩
di	d iː˥
di'o	d iː˥ ʔ oː˩
diana	d ɪ˥ aː˥ n aː˩
diary	d ɪ˥ a˥ r j
didier	d ɪ˥ d ɪ˥ eː˥ r
diego	d ɪ˥ eː˥ ɡʷ o˩
diflomasiyya	d ɪ˩ ɸ l oː˩ m ə˩ s ɪ˥ j aː˩
diga	d ɪ˥ ɡ aː˩
digiri	d ɪ˩ ɟ ɪ˩ r iː˥
digo	d ɪ˥ ɡʷ oː˩
digon	d ɪ˥ ɡʷ oː˩ ŋ
dila	d ɪ˥ l aː˩
dilan	d ɪ˥ l a˥˦ ŋ
dillancin	d ɪ˥ l a˥ n tʃ ɪ˩ ŋ
dilnar	d ɪ˥ l n a˩ r
dimbin	d ɪ˥ m b ɪ˩ ŋ
dimi	d ɪ˩ m iː˥
dimokuraɗiyya	d ɪ˩ m o˩ kʷ ʊ˩ ɽ ə˩ ɗ ɪ˥ j aː˩
din	d ɪ˩ ŋ
dina	d ɪ˥ n aː˩
dinari	d iː˥ n aː˥ r iː˩
ding	d ɪ˥ ŋ
dinga	d ɪ˩ ŋ ɡ aː˥
dinka	d ɪ˩ ŋ k aː˥
dinke	d ɪ˥ ɲ c eː˥
dinkin	d ɪ˥ ɲ c ɪ˥ ŋ
dinkuwar	d ɪ˩ ŋ kʷ ʊ˥ w a˥ r
dinta	d ɪ˥ n t aː˩
diplomasiya	d ɪ˥ p l oː˩ m ə˩ s ɪ˥ j aː˩
diplomasiyya	d ɪ˥ p l oː˩ m ə˩ s ɪ˥ j aː˩
direba	d ɪ˩ r e˥ b aː˩
direban	d ɪ˩ r e˥ b a˩ ŋ
direktan	d ɪ˩ r e˥ k t a˩ ŋ
disamba	d ɪ˩ s a˥ m b aː˩
diwani	d iː˥ w aː˥ n iː˩
diya	d ɪ˥ j aː˩
diyya	d ɪ˥ j aː˩
dj	d iː˥ dʒ eː˩
djibo	dʒ ɪ˩ b oː˥
dodanni	d oː˥ d a˥ n iː˩
dodo	d oː˥ d oː˩
dodon	d oː˥ d oː˩ ŋ
dogara	d oː˩ ɡ ə˥ ɽ aː˩
dogara	d oː˩ ɡ ə˥ ɽ ə˩
dogarai	d oː˩ ɡ ə˩ ɽ aj˥
dogari	d oː˩ ɡ ə˥ ɽ iː˩
dogaro	d oː˩ ɡ ə˥ ɽ oː˩
dogaye	d oː˩ ɡ aː˩ j eː˥
dogayen	d oː˩ ɡ aː˩ j eː˥ ŋ
dogo	d oː˥ ɡʷ oː˥
dogo	d oː˥ ɡʷ o˥
dogon	d oː˥ ɡʷ oː˥ ŋ
doguwar	d oː˥ ɡʷ ʊ˥ w a˥ r
doha	d oː˥ h aː˩
doka	d oː˥ k aː˩
dokar	d ɔ˥ k a˩ r
dokarsa	d ɔ˥ k a˩ r aː˩
doke	d oː˥ c eː˥
doki	d oː˥ c iː˩
dokin	d oː˥ c ɪ˥ ŋ
dokina	d oː˥ c ɪ˥ n aː˩
dokoki	d oː˩ kʷ oː˥ c iː˩
dokokin	d oː˩ kʷ oː˥ c ɪ˥ ŋ
dokta	d ɔ˥ k t aː˩
dolar	d oː˩ l a˩ r
dole	d oː˩ l eː˩
domin	d oː˩ m ɪ˥ ŋ
don	d oː˥ ŋ
donald	d oː˥ n aː˥ l d
dong	d oː˥ ŋ
dora	d oː˩ ɽ aː˩
dorewa	d oː˩ ɽ eː˥ w aː˥
dorina	d oː˩ ɽ ɪ˥ n aː˥
dorothy	d oː˩ ɽ oː˥ t h j
dos	d oː˩ s
doshi	d oː˥ ʃ iː˥
dososo	d oː˩ s oː˩ s oː˩
downtown	d oː˥ w n t oː˥ w ŋ
dragon	d ɽ ə˥ ɡʷ oː˥ ŋ
dragon'	d ɽ ə˥ ɡʷ oː˥ ŋ ʔ
drogba	d ɽ oː˥ ɡʷ b aː˩
du	d ɪ˩
du'a'i	d ɪ˥ ʔ aː˥ ʔ iː˩
duanwu	d uː˥ m w ʊ˥
duba	d uː˥ b aː˩
dubai	d ɪ˩ b aj˥
duban	d uː˥ b a˩ ŋ
dubbai	d uː˥ b aj˥
dubban	d uː˥ b a˩ ŋ
dubi	d uː˥ b iː˥
dubu	d ɪ˥ b uː˥
dubugoma	d uː˥ b ʊ˩ ɡʷ oː˩ m ə˩
dudduba	d uː˥ d ɪ˥ b aː˩
dudu	d uː˥ d ɪ˩
duhu	d uː˥ h ʊ˩
duhun	d uː˥ h ʊ˩ ŋ
duk	d ɪ˥ k
duka	d uː˥ k aː˩
dukan	d uː˥ k a˩ ŋ
dukansu	d uː˥ k aː˩ n s ɪ˩
dukiya	d uː˥ c ɪ˩ j aː˥
dukiyar	d uː˥ c ɪ˩ j ɛ˥ r
dukiyoyin	d uː˥ c ɪ˩ j oː˩ j ɪ˥ ŋ
dukka	d uː˥ k k aː˩
dukkan	d uː˥ k k a˩ ŋ
dukkanin	d uː˥ k k aː˩ n ɪ˥ ŋ
dukkaninsu	d uː˥ k k a˩ n iː˥ n s ɪ˩
dukkanmu	d uː˥ k k a˩ ŋ m uː˩
dukkansu	d uː˥ k k a˩ n s ɪ˩
dukufa	d ɪ˩ kʷ ʊ˥ ɸ aː˥
dukuku	d ɪ˩ kʷ ʊ˩ kʷ ʊ˩
duma	d ɪ˥ m aː˥
duma	d ɪ˥ m aː˩
dumi	d ɪ˥ m iː˥
dumɓu	d ɪ˥ m ɓ uː˥
duna	d uː˥ n aː˩
duniya	d uː˥ n ɪ˥ j aː˩
duniya'	d uː˥ n ɪ˥ j aː˥ ʔ
duniyar	d uː˥ n ɪ˥ j ɛ˥ r
dunkulallen	d ɪ˩ ŋ kʷ ʊ˩ l a˥˦ l eː˩ ŋ
dunƙule	d uː˥ n kʷʼ uː˥ l eː˩
duri	d uː˥ ɽ iː˩
duros	d ɪ˩ r a˥˦ s
durowar	d ɪ˩ r oː˥ w a˥ r
durƙusarwa	d ɪ˩ r kʷʼ ʊ˥ s a˥ ɽ w aː˥
dusar	d uː˥ s a˩ r
dutch	d uː˥ tʃ
dutse	d uː˥ sʼ eː˩
dutse	d uː˥ sʼ e˩
dutsen	d uː˥ sʼ eː˩ ŋ
dutsuna	d uː˥ sʼ uː˥ n aː˩
duwatsu	d ʊ˥ w ə˥ sʼ uː˥
duwatsun	d ʊ˥ w ə˥ sʼ ɪ˩ ŋ
dynamite	d j n aː˥ m ɪ˥ t e˥
e	ʔ eː˩
eagles	ʔ ɛ˥ ɡʷ l eː˩ s
edita	ʔ ɛ˥ d ɪ˥ t ə˩
editan	ʔ ɛ˥ d ɪ˥ t a˩ ŋ
eh	e˥ ʃ
eka	ʔ eː˥ k aː˩
el	ʔ ɛ˥ l
el'e	ʔ ɛ˥ l ʔ eː˥˦
elaine	ʔ ɛ˥ l aj˥ n e˥
ellen	ʔ ɛ˥ l eː˩ ŋ
email	ʔ ɛ˥ m ɪ˥˦ l
emei	ʔ ɛ˥ m iː˩
emti	ʔ ɛ˥ m t iː˩
en'e	ʔ ɛ˥ ŋ ʔ eː˩
english	ʔ ɛ˥ ŋ ɡʷ l iː˥ ʃ
enlai	ʔ ɛ˥ n l aj˥
erhu	ʔ ɛ˥ ɽ h uː˩
eritrea	ʔ ɛ˥ ɽ ɪ˥ t ɽ eː˥ aː˩
ethiopia	ʔ ɛ˥ t h iː˥ oː˥ p ɪ˩ aː˩
europe	ʔ ɛ˥ ʊ˥˦ r oː˥ p eː˥
fa	ɸ aː˥
fa'ida	ɸ aː˥ ʔ ɪ˥ d aː˩
fabrairu	ɸ a˩ b r aj˥ r ɪ˩
face	ɸ ə˩ tʃ eː˩
fada	ɸ ə˥ d aː˩
fadakar	ɸ ə˩ d ə˥ k a˩ r
fadar	ɸ ə˥ d ə˩ r
fadarsa	ɸ ə˥ d ə˩ ɽ s aː˥
fadawa	ɸ ə˥ d aː˥ w aː˥
fadi	ɸ aː˥ d iː˩
fadin	ɸ aː˩ d ɪ˥˦ ŋ
fado	ɸ ə˥ d o˥
fafaroma	ɸ ə˥ ɸ a˩ ɽ oː˩ m ə˩
fage	ɸ ə˥ ɟ eː˥
fagen	ɸ ə˥ ɟ eː˥ ŋ
fahami	ɸ ə˥ h a˩ m iː˥
fahari	ɸ ə˥ h a˩ r iː˥
fahimce	ɸ aː˥ h ɪ˩ m tʃ eː˩
fahimci	ɸ aː˥ h ɪ˩ m tʃ iː˥
fahimta	ɸ aː˥ h ɪ˩ m t aː˩
fahimtar	ɸ aː˥ h ɪ˩ m t a˩ r
fahimtarta	ɸ aː˥ h ɪ˩ m t a˥ r t aː˩
faifan	ɸ aj˥˦ ɸ a˥˦ ŋ
falastinawa	ɸ a˥ l a˩ s t ɪ˥ n aː˥ w aː˥
falmata	ɸ a˥ l m aː˥ t aː˩
falmatatu	ɸ a˥ l m ə˥ t ə˥ t ɪ˩
falo	ɸ aː˥ l oː˩
falsafa	ɸ a˥ l s ə˥ ɸ aː˩
fam	ɸ a˥˦ ŋ
fama	ɸ aː˥ m aː˩
fan	ɸ a˥ ŋ
fangali	ɸ a˥ ŋ ɡ ə˥ l iː˥
fanke	ɸ ɛ˩ ɲ c eː˥
fanni	ɸ a˥ n iː˩
fannin	ɸ a˥ n ɪ˥ ŋ
fanning	ɸ a˥ n ɪ˥ ŋ
fannoni	ɸ a˥ n oː˥ n iː˩
fannonin	ɸ a˥ n oː˥ n ɪ˥ ŋ
fansa	ɸ a˥ n s ə˩
fansho	ɸ a˥ n s h oː˥
fante	ɸ a˥ n t e˥
fanti	ɸ a˥ n t iː˩
fara	ɸ ə˥ r aː˩
fara'a	ɸ ə˥ r ə˥ ʔ aː˩
farali	ɸ ə˥ r ə˩ l iː˥
faransa	ɸ ə˩ r a˥ n s ə˩
faransanci	ɸ ə˥ r a˥ n s a˥ n tʃ iː˥
faranta	ɸ ə˥ r a˥ n t aː˩
farar	ɸ ə˥ r a˩ r
fararen	ɸ ə˥ r ə˩ ɽ eː˥ ŋ
fararren	ɸ aː˥ ɽ a˥ r eː˩ ŋ
farashi	ɸ ə˥ r aː˥ ʃ iː˩
farashin	ɸ ə˥ r ə˩ ʃ ɪ˥˦ ŋ
farashinsu	ɸ ə˥ r aː˥ ʃ iː˩ n s ɪ˩
farauta	ɸ ə˩ r aw˥ t aː˩
farawa	ɸ ə˥ r aː˥ w aː˥
farce	ɸ a˥ ɽ tʃ eː˩
faredi	ɸ aː˥ ɽ eː˥ d iː˩
farfado	ɸ ə˩ r ɸ ə˥ d o˥
farfadowa	ɸ ə˩ r ɸ ə˥ d oː˥ w aː˩
farfaganda	ɸ ə˩ r ɸ ə˥ ɡ a˥ n d ə˩
farfajiya	ɸ ə˩ r ɸ aː˥ dʒ ɪ˩ j aː˥
farfajiyar	ɸ ə˩ r ɸ aː˥ dʒ ɪ˩ j ɛ˥ r
farfesan	ɸ ə˩ r ɸ ɛ˥ s a˩ ŋ
fargabar	ɸ ə˩ r ɡ ə˥ b a˩ r
fari	ɸ aː˥ ɽ ɪ˩
fari	ɸ ə˥ ɽ iː˥
farilla	ɸ ə˩ r ɪ˥ l aː˩
farin	ɸ ə˩ r ɪ˥ ŋ
farisa	ɸ aː˥ r ɪ˥ s ə˩
farisanci	ɸ aː˥ r ɪ˥ s a˥ n tʃ iː˥
farka	ɸ a˥ r k aː˩
farkar	ɸ a˥ r k a˩ r
farke	ɸ aː˥ ɽ c eː˥
farko	ɸ a˩ r kʷ oː˩
farkon	ɸ a˩ r kʷ oː˩ ŋ
farmaki	ɸ a˥ r m aː˩ c iː˥
faro	ɸ ə˥ r o˩
fartanya	ɸ a˥ r t ɛ˥ ɲ j aː˩
faru	ɸ ə˩ r uː˥
faruku	ɸ aː˩ r ɪ˥ kʷ ʊ˩
faruwa	ɸ a˥ ɽ ʊ˥ w aː˥
faruwane	ɸ a˥ ɽ ʊ˥ w a˩ n e˥
faruƙu	ɸ aː˩ r ɪ˥ kʷʼ ʊ˩
fasa	ɸ aː˥ s aː˩
fasa'ofis	ɸ ə˥ s ə˩ ʔ oː˥ ɸ ɪ˩ s
fasaha	ɸ ə˥ s ə˩ h aː˥
fasahar	ɸ ə˥ s ə˩ h a˩ r
fasaharsu	ɸ ə˥ s ə˩ h a˥ ɽ uː˥
fasahohi	ɸ ə˥ s ə˩ h oː˥ h iː˩
fasahohin	ɸ ə˥ s ə˩ h oː˥ h ɪ˥ ŋ
fasali	ɸ ə˥ s ə˩ l iː˥
fasalin	ɸ ə˥ s ə˩ l ɪ˩ ŋ
fasfo	ɸ a˩ s ɸ o˥
fashe	ɸ ə˥ ʃ e˥
fashewa	ɸ ə˩ ʃ eː˩ w aː˥
fashi	ɸ ə˩ ʃ iː˥
fashin	ɸ ə˩ ə˩ ʃ ɪ˥˦ ŋ
fashon	ɸ aː˥ s h oː˥ ŋ
fasifik	ɸ aː˥ s ɪ˥ ɸ ɪ˥ k
fasihin	ɸ aː˥ s iː˥ h ɪ˥ ŋ
fasinja	ɸ aː˥ s ɪ˥ n dʒ ə˩
fasinjoji	ɸ aː˥ s ɪ˥ n dʒ ɔ˩ dʒ iː˥
fasiƙi	ɸ aː˥ s ɪ˩ cʼ iː˥
fassara	ɸ aː˥ s aː˥ r aː˩
fasta	ɸ a˩ s t aː˩
fat	ɸ a˥ t
fata	ɸ ə˥ t aː˩
fatakwal	ɸ ə˥ t aː˥ kʷ a˩ l
fatalwa	ɸ ə˥ t l w aː˩
fatan	ɸ ə˥ t a˩ ŋ
fatanmu	ɸ ə˥ t a˩ n m uː˩
fatanya	ɸ ə˥ t ɛ˥ ɲ j aː˩
fatar	ɸ ə˥ t a˩ r
fatarauta	ɸ ə˥ t ə˩ ɽ aw˥ t aː˩
fatau	ɸ ə˥ t aw˥
fataucin	ɸ ə˥ t aw˥ tʃ ɪ˩ ŋ
father	ɸ ə˥ t h eː˥ r
fati	ɸ ə˥ t ɪ˩
fatin	ɸ ə˥ t ɪ˩ ŋ
fatsa	ɸ ə˥ sʼ ə˥
fatsi	ɸ ə˥ sʼ iː˥
fau	ɸ aw˥
fayu	ɸ aː˥ j uː˩
faƙiri	ɸ ə˩ cʼ iː˥ r iː˩
faɗa	ɸ ə˥ ɗ aː˩
faɗansa	ɸ aː˥ ɗ a˥ n s ə˩
faɗar	ɸ aː˥ ɗ ə˩ r
faɗawa	ɸ aː˥ ɗ aː˥ w aː˥
faɗaɗa	ɸ aː˥ ɗ ə˥ ɗ aː˩
faɗi	ɸ aː˥ ɗ iː˥
faɗimatu	ɸ aː˥ ɗ ɪ˩ m ə˥ t ɪ˩
faɗin	ɸ aː˥ ɗ ɪ˩ ŋ
faɗo	ɸ aː˥ ɗ o˩
faɗuwa	ɸ aː˥ ɗ ʊ˥ w aː˥
feda	ɸ eː˥ d aː˩
federer	ɸ eː˥ d eː˩ ɽ eː˩ r
fei	ɸ ɛ˥ iː˩
feng	ɸ ɛ˥ ŋ
fengyang	ɸ ɛ˥ ŋ ɡ j ɛ˥ ŋ
fengyun	ɸ ɛ˥ ŋ ɡ j ʊ˩ ŋ
fensil	ɸ ɛ˥ n s ɪ˩ l
fensir	ɸ ɛ˥ n s ɪ˩ r
fentin	ɸ eː˥ n t ɪ˥ ŋ
feral	ɸ eː˥ r a˩ l
ferguson	ɸ eː˥ r ɡʷ ʊ˥ s oː˥ ŋ
fernando	ɸ eː˥ r n a˩ n d oː˩
fes	ɸ ɛ˥ s
festus	ɸ ɛ˥ s t ɪ˩ s
fetal	ɸ eː˩ t a˥ l
fetur	ɸ eː˩ t uː˥ r
fi	ɸ iː˥
fi'ili	ɸ ɪ˥ ʔ ɪ˩ l iː˥
fiano	ɸ ɪ˩ ə˥ n o˥
fice	ɸ ɪ˥ tʃ eː˩
ficewa	ɸ ɪ˥ tʃ eː˥ w aː˩
fici	ɸ ɪ˥ tʃ iː˥
fida'u	ɸ ɪ˩ d aː˥ ʔ uː˩
fiffiko	ɸ ɪ˩ ɸ ɪ˩ kʷ oː˥
fifiko	ɸ ɪ˩ ɸ ɪ˩ kʷ oː˥
fijo	ɸ ɪ˩ dʒ oː˥˦
fikafikai	ɸ ɪ˩ k aː˥ ɸ ɪ˩ k aj˥
fil	ɸ ɪ˥ l
filafili	ɸ ɪ˥ l ə˩ ɸ ɪ˥ l iː˥
filas	ɸ ɪ˩ l a˥˦ s
filato	ɸ ɪ˩ l aː˩ t o˥
filaye	ɸ ɪ˩ l aː˩ j eː˥
filayen	ɸ ɪ˩ l aː˩ j eː˥ ŋ
fili	ɸ iː˥ l iː˥
filim	ɸ ɪ˥ l ɪ˩ m
filin	ɸ ɪ˥ l ɪ˩ ŋ
film	ɸ ɪ˩ l ŋ
filogi	ɸ ɪ˩ l oː˩ ɟ iː˥
fim	ɸ ɪ˩ m
fin	ɸ ɪ˩ ŋ
fina	ɸ ɪ˥ n aː˩
finafinai	ɸ ɪ˩ n aː˥ ɸ ɪ˥ n aj˥
finafinan	ɸ ɪ˩ n aː˥ ɸ ɪ˥ n a˥˦ ŋ
finai	ɸ ɪ˩ n aj˥
finan	ɸ ɪ˩ n a˥˦ ŋ
financial	ɸ ɪ˩ n a˥ n tʃ ɪ˥ a˥˦ l
finland	ɸ ɪ˩ n l a˩ n d
firamare	ɸ ɪ˥ r aː˥ m ə˩ r eː˩
firaministan	ɸ ɪ˩ r aː˥ m ɪ˩ n ɪ˥ s t a˩ ŋ
firayi	ɸ ɪ˥ r aː˥ j ɪ˩
firayim	ɸ ɪ˥ r aː˥ j ɪ˩ m
firayin	ɸ ɪ˥ r aː˥ j ɪ˩ ŋ
firgici	ɸ ɪ˥ r aː˥ ɡ ɪ˥ tʃ iː˥
firgita	ɸ ɪ˩ r ɟ ɪ˩ sʼ aː˩
firji	ɸ ɪ˩ ɽ dʒ iː˥
fis	ɸ ɪ˥˦ s
fita	ɸ ɪ˩ t aː˥
fitacciyar	ɸ ɪ˩ t ə˥ tʃ ɪ˩ j ɛ˥ r
fitar	ɸ ɪ˩ t a˩ r
fitarwa	ɸ ɪ˩ t a˥ ɽ w aː˥
fitila	ɸ ɪ˩ t ɪ˥ l aː˩
fitilar	ɸ ɪ˩ t ɪ˥ l aː˩ r
fitilu	ɸ ɪ˩ t ɪ˥ l uː˥
fitilun	ɸ ɪ˩ t ɪ˥ l ɪ˩ ŋ
fitina	ɸ ɪ˩ t ɪ˥ n aː˩
fito	ɸ ɪ˩ t o˥
fitowa	ɸ ɪ˩ t oː˥ w aː˩
fitowan	ɸ ɪ˩ t oː˥ w a˥˦ ŋ
fitowar	ɸ ɪ˩ t oː˥ w a˥ r
fitowarsa	ɸ ɪ˩ t oː˥ w a˥ r s aː˥
fitsari	ɸ ɪ˩ sʼ ɽ iː˥
fiye	ɸ ɪ˩ j eː˥
fiƙihu	ɸ ɪ˥ cʼ ɪ˥ h ʊ˩
flash	ɸ l ə˩ ʃ
florida	ɸ l oː˩ ɽ iː˥ d aː˩
fom	ɸ a˥˦ ŋ
fos	ɸ a˥˦ s
francis	ɸ r a˥ n tʃ ɪ˩ s
fu	ɸ ʊ˩
fujian	ɸ ʊ˩ dʒ ɪ˥ a˥˦ ŋ
funkaso	ɸ ʊ˩ ŋ k aː˩ s oː˥
funtua	ɸ ʊ˥ n t uː˥ aː˩
funtuwa	ɸ ʊ˩ n t ʊ˥ w ə˩
fura	ɸ ʊ˥ ɽ aː˥
furani	ɸ ʊ˩ r a˥ n iː˩
furanni	ɸ ʊ˩ r a˥ n iː˩
furannin	ɸ ʊ˩ r a˥ n ɪ˥ ŋ
fure	ɸ ʊ˩ ɽ eː˥
furofesa	ɸ ʊ˥ ɽ oː˩ ɸ ɛ˥ s aː˥
fursunoni	ɸ ʊ˥ ɽ s ɪ˩ n oː˥ n iː˩
furta	ɸ ʊ˩ r t aː˩
furucin	ɸ ʊ˥ ɽ ɪ˥ tʃ ɪ˩ ŋ
fururu	ɸ ʊ˥ ɽ ɪ˥ ɽ ɪ˥
fusata	ɸ ʊ˩ s aː˥ t aː˩
fusatattun	ɸ ʊ˥ s a˩ t a˩ t ɪ˥ ŋ
fushi	ɸ ʊ˥ ʃ iː˥
fushinta	ɸ ʊ˥ ʃ ɪ˥ n t aː˩
fuska	ɸ ʊ˩ s k aː˩
fuskance	ɸ ʊ˩ s k a˥ n tʃ eː˩
fuskanci	ɸ ʊ˩ s k a˥ n tʃ iː˥
fuskanta	ɸ ʊ˩ s k a˩ n t aː˥
fuskantar	ɸ ʊ˩ s k a˩ n t a˩ r
fuskar	ɸ ʊ˩ s k ə˥ r
fuskarku	ɸ ʊ˩ s k a˩ r kʷ ʊ˩
fuskarsa	ɸ ʊ˩ s k a˩ r aː˩
fuskokin	ɸ ʊ˥ s kʷ oː˥ c ɪ˥ ŋ
fuskokinsu	ɸ ʊ˥ s kʷ oː˥ c iː˥ n s ɪ˩
fyaɗe	ɸ j aː˥ ɗ eː˩
ga	ɡ aː˥
gaba	ɡ ə˥ b aː˩
gabaci	ɡ ə˥ b ə˩ tʃ iː˥
gabacin	ɡ aː˩ b aː˩ tʃ ɪ˥ ŋ
gaban	ɡ ə˥ b a˩ ŋ
gabannin	ɡ ə˥ b a˩ n ɪ˥ ŋ
gabansa	ɡ ə˥ b a˩ n s aː˩
gabansu	ɡ ə˥ b a˩ n s ɪ˩
gabar	ɡ ə˥ b a˩ r
gabas	ɡ ə˥ b a˩ s
gabashin	ɡ ə˥ b ə˩ ʃ ɪ˥˦ ŋ
gabata	ɡ ə˥ b a˩ t aː˩
gabatar	ɡ ə˥ b a˩ t a˩ r
gabatarwa	ɡ aː˩ b aː˥ t a˥ ɽ w aː˥
gabatarwar	ɡ ə˥ b a˩ t a˩ r w a˥ r
gabaɗaya	ɡ ə˥ b ə˩ ɗ ɛ˥ j aː˩
gabobi	ɡ ə˥ b oː˥ b iː˥
gabobin	ɡ ə˥ b oː˥ b ɪ˩ ŋ
gabon	ɡ ə˥ b ɔ˩ ŋ
gada	ɡ ə˥ d aː˩
gada	ɡ ə˩ d aː˥
gadar	ɡ ə˩ d a˥˦ r
gadara	ɡ ə˩ d aː˥ r aː˩
gadi	ɡ ə˩ d iː˥
gadin	ɡ ə˥ d ɪ˩ ŋ
gado	ɡ ə˥ d oː˥
gadoji	ɡ ə˥ d oː˩ dʒ iː˥
gadon	ɡ ə˥ d oː˩ ŋ
gadu	ɡ ə˩ d uː˥
gafara	ɡ aː˥ ɸ ə˥ r aː˩
gagai	ɡ ə˥ ɡ aj˩
gagarau	ɡ aː˩ ɡ ə˩ ɽ aw˥
gagarumin	ɡ aː˩ ɡ ə˩ ɽ ɪ˥ m ɪ˥ ŋ
gaggarumin	ɡ aː˩ ɡ ə˩ ɽ ɪ˥ m ɪ˥ ŋ
gaggauta	ɡ aː˩ ɡ aw˥ t aː˩
gaggawa	ɡ aː˩ ɡ aː˥ w aː˥
gahawa	ɡ ə˥ h a˥ w aː˩
gai	ɡ aj˥
gaibi	ɡ aj˥ b ɪ˩
gaida	ɡ aj˥ d aː˩
gaira	ɡ aj˥ r ə˩
gaisuwa	ɡ aj˥ s ʊ˥ w aː˥
gaiwa	ɡ aj˥˦ w aː˥
gajere	ɡ ə˩ dʒ eː˥ ɽ eː˥
gajere	ɡ ə˩ dʒ eː˥ ɽ e˥
gajeren	ɡ aː˥ dʒ eː˥ r eː˩ ŋ
gajeriya	ɡ ə˩ dʒ eː˥ r ɪ˥ j aː˩
gajeru	ɡ ə˩ dʒ eː˥ ɽ uː˥
gaji	ɡ aː˥ dʒ iː˩
gajimare	ɡ aː˥ dʒ ɪ˩ m ə˩ r eː˩
gajiya	ɡ aː˥ dʒ ɪ˩ j aː˥
gajiyar	ɡ aː˥ dʒ ɪ˩ j ɛ˥ r
galaba	ɡ ə˩ l aː˥ b aː˩
galadima	ɡ ə˩ l aː˩ d iː˥ m aː˩
galala	ɡ aː˩ l aː˩ l aː˩
galau	ɡ ə˩ l aw˥
galibi	ɡ aː˥ l ɪ˩ b iː˥
galibin	ɡ aː˥ l ɪ˩ b ɪ˩ ŋ
gam	ɡ a˥˦ ŋ
gama	ɡ ə˥ m aː˩
gamayyar	ɡ aː˩ m ɛ˩ j ɛ˥ r
game	ɡ ə˥ m eː˩
gameda	ɡ ə˥ m eː˥ d aː˩
gami	ɡ aː˥ m iː˩
gamsar	ɡ a˩ m s a˩ r
gamsu	ɡ a˩ m s ɪ˩
gamsuwa	ɡ a˩ m s ʊ˥ w aː˥
gamu	ɡ aː˥ m ʊ˩
gamuwa	ɡ ə˥ m ʊ˥ w aː˥
gan	ɡ a˩ ŋ
gana	ɡ aː˥ n ə˩
ganau	ɡ ə˩ n aw˥
ganawa	ɡ ə˩ n aː˥ w aː˥
ganawar	ɡ ə˩ n w a˥ r
gandu	ɡ a˥ n d uː˥
gandun	ɡ a˥ n d ɪ˥ ŋ
gane	ɡ ə˩ n e˥
ganga	ɡ a˥ ŋ ɡ aː˥
gangan	ɡ a˥ ŋ ɡ a˥˦ ŋ
gangarar	ɡ a˥ ŋ ɡ ə˩ r a˩ r
gangariya	ɡ a˥ ŋ ɡ ə˩ r ɪ˥ j ɛ˩
gangaro	ɡ a˥ ŋ ɡ ə˥ ɽ oː˩
gani	ɡ ə˩ n iː˥
ganima	ɡ ə˩ n iː˥ m aː˩
ganin	ɡ aː˩ n ɪ˥ ŋ
ganina	ɡ ə˩ n iː˥ n ə˩
ganinsa	ɡ ə˩ n iː˥ n s aː˩
ganinsu	ɡ ə˩ n iː˥ n s ɪ˩
ganki	ɡ ɛ˥ ɲ c iː˩
ganni	ɡ a˥ n iː˩
gano	ɡ ə˩ n oː˥˦
ganshi	ɡ ə˩ n ʃ iː˥
gansu	ɡ ə˩ n s ɪ˩
ganuwa	ɡ ə˩ n ʊ˥ w aː˥
ganuwar	ɡ ə˩ n ʊ˥ w a˥ r
ganyaye	ɡ ɛ˥ ɲ j ɛ˩ j eː˥
ganyayen	ɡ ɛ˥ ɲ j aː˩ j eː˥ ŋ
ganyayyaki	ɡ ɛ˥ ɲ j ɛ˩ j aː˩ c iː˥
ganyayyakin	ɡ ɛ˥ ɲ j ɛ˥ j aː˥ c ɪ˩ ŋ
ganye	ɡ ɛ˥ ɲ j eː˥
ganyen	ɡ ɛ˥ ɲ j eː˥ ŋ
gara	ɡ ə˩ ɽ ə˩
gardama	ɡ a˩ r d aː˥ m aː˩
gare	ɡ ə˥ ɽ eː˩
gareka	ɡ a˩ ɽ eː˥ k aː˩
gargadi	ɡ a˩ ɽ ɡ aː˩ d iː˩
gargadin	ɡ a˩ ɽ ɡ aː˩ d ɪ˥˦ ŋ
gargajiga	ɡ a˩ ɽ ɡ aː˩ dʒ iː˥ ɡ aː˩
gargajiya	ɡ a˩ ɽ ɡ aː˥ dʒ ɪ˩ j aː˥
gargajiyar	ɡ a˩ ɽ ɡ aː˥ dʒ ɪ˩ j ɛ˥ r
gargaɗe	ɡ a˩ ɽ ɡ aː˥ ɗ eː˩
gargaɗi	ɡ a˩ ɽ ɡ aː˥ ɗ iː˩
gari	ɡ ə˩ r iː˥
garin	ɡ ə˩ ɽ ɪ˥ ŋ
garinmu	ɡ ə˩ r iː˥ n m uː˩
garinsu	ɡ ə˩ r iː˥ n s ɪ˩
garki	ɡ a˩ ɽ c ɪ˥
garkuwa	ɡ a˩ ɽ kʷ ʊ˥ w aː˥
garu	ɡ aː˩ r uː˥
garun	ɡ ə˩ ɽ ɪ˥ ŋ
garuruwa	ɡ ə˩ ɽ ɪ˥ ɽ ʊ˥ w aː˥
garwashi	ɡ a˥ ɽ w aː˥ ʃ iː˥
garzaya	ɡ a˩ ɽ z ɛ˥ j aː˩
gas	ɡ a˥ s
gasa	ɡ aː˥ s aː˩
gasannin	ɡ ə˥ s a˥ n ɪ˥ ŋ
gasar	ɡ ə˥ s a˩ r
gasassun	ɡ aː˥ s aː˥ s ɪ˩ ŋ
gashi	ɡ ə˩ ʃ iː˥
gashin	ɡ ə˩ ʃ ɪ˥˦ ŋ
gashinki	ɡ ə˩ ʃ ɪ˥ ɲ c iː˩
gashinku	ɡ ə˩ ʃ ɪ˥˦ ŋ kʷ ʊ˩
gaskata	ɡ ə˥ s k ə˥ t aː˩
gaske	ɡ s c eː˩
gaskiya	ɡ ə˩ s c ɪ˥ j aː˩
gaskiyane	ɡ ə˩ s c ɪ˩ j aː˥ n e˥
gaskiyar	ɡ ə˩ s c ɪ˩ j ɛ˥ r
gasu	ɡ ə˩ s ɪ˥
gatanci	ɡ aː˩ t a˥ n tʃ iː˥
gatar	ɡ aː˩ t a˩ r
gatari	ɡ aː˩ t ə˥ ɽ iː˥
gaula	ɡ aw˥ l aː˥
gawa	ɡ aː˥ w aː˥
gawar	ɡ ə˥ w a˥ r
gaya	ɡ ɛ˥ j aː˩
gayawa	ɡ aː˩ j aː˥ w aː˥
gayya	ɡ ɛ˥ j aː˩
gayyace	ɡ ɛ˥ j aː˩ tʃ eː˩
gayyaci	ɡ ɛ˥ j aː˩ tʃ iː˥
gayyatar	ɡ ɛ˥ j ɛ˥ t a˩ r
gaz	ɡ ə˩ z
gaza	ɡ ə˩ z aː˩
gazet	ɡ ə˩ z a˥ t
gaɓar	ɡ a˥ ɓ a˩ r
gaɗa	ɡ ə˥ ɗ aː˩
gefe	ɟ eː˥ ɸ eː˩
gefen	ɟ eː˥ ɸ ɛ˥ ŋ
gefuna	ɟ eː˥ ɸ ʊ˩ n aː˥
gefunan	ɟ eː˥ ɸ uː˩ n a˥˦ ŋ
geliang	ɟ eː˥ l ɪ˩ a˥ ŋ
gemu	ɟ eː˥ m uː˩
gemunsa	ɟ eː˥ m uː˩ n s aː˩
georege	ɟ eː˥ oː˥ r a˥ ɟ eː˥
george	ɟ eː˥ oː˥ r ɟ eː˥
georgia	ɟ eː˥ oː˥ r ɟ iː˥ aː˩
germany	ɟ eː˥ ɽ m ɛ˥ ɲ j
gero	ɟ eː˥ ɽ oː˩
ghana	ɡʷ h aː˥ n aː˩
gicciyenka	ɟ ɪ˥ tʃ ɪ˩ j eː˥ ŋ k aː˥
gida	ɟ iː˥ d aː˩
gidaje	ɟ ɪ˩ d aː˥ dʒ e˩
gidajen	ɟ ɪ˩ d aː˥ dʒ eː˥ ŋ
gidajensu	ɟ ɪ˩ d aː˥ dʒ ɛ˥ n s ɪ˩
gidan	ɟ ɪ˩ d a˥˦ ŋ
gidana	ɟ ɪ˩ d aː˥ n aː˩
gidanka	ɟ ɪ˩ d a˥ ŋ k aː˥
gidanki	ɟ ɪ˩ d ɛ˥ ɲ c iː˩
gidansa	ɟ ɪ˩ d a˥ n s ə˩
gidanta	ɟ ɪ˩ d a˥ n t aː˩
gig	ɟ ɪ˩ ɟ
giginyu	ɟ ɪ˩ ɟ ɪ˩ ɲ j ʊ˥
gilashi	ɟ ɪ˩ l ə˩ ʃ iː˥
gilashin	ɟ ɪ˩ l ə˩ ʃ ɪ˥˦ ŋ
gilbert	ɟ ɪ˩ l b eː˥ r t
gimbiya	ɟ ɪ˥ m b ɪ˩ j aː˥
gina	ɟ ɪ˥ n aː˩
ginawa	ɟ ɪ˥ n aː˥ w aː˥
gindin	ɟ ɪ˥ n d ɪ˥ ŋ
gine	ɟ ɪ˩ n e˥
gini	ɟ ɪ˥ n iː˥
ginin	ɟ ɪ˥ n ɪ˥ ŋ
ginshiki	ɟ ɪ˥ n ʃ ɪ˩ c iː˥
ginshiƙin	ɟ ɪ˥ n s h ɪ˥ cʼ ɪ˥ ŋ
girbi	ɟ ɪ˥ ɽ b iː˥
girbin	ɟ ɪ˥ ɽ b ɪ˩ ŋ
girgiza	ɟ ɪ˥ ɽ ɟ iː˥ z aː˩
girgizar	ɟ ɪ˥ ɽ ɟ iː˥ z a˩ r
giris	ɟ ɪ˩ r ɪ˥˦ s
girka	ɟ ɪ˥ ɽ k aː˥
girke	ɟ ɪ˥ ɽ c eː˥
girki	ɟ ɪ˥ ɽ c ɪ˥
girma	ɟ ɪ˩ r m aː˩
girmama	ɟ ɪ˩ r m aː˩ m ə˥
girmamawa	ɟ ɪ˩ r m aː˩ m aː˥ w aː˥
girman	ɟ ɪ˥ ɽ m a˩ ŋ
girmanku	ɟ ɪ˩ r m a˩ ŋ kʷ ʊ˩
girmanta	ɟ ɪ˩ r m a˥ n t aː˩
girme	ɟ ɪ˩ r m eː˩
gitta	ɟ ɪ˥ t aː˩
giwa	ɟ iː˥ w aː˥
giwar	ɟ iː˥ w a˥ r
giya	ɟ ɪ˥ j aː˩
giyar	ɟ ɪ˩ j ɛ˥ r
gizo	ɟ ɪ˥ z oː˥
goba	ɡʷ oː˥ b aː˩
gobarar	ɡʷ oː˥ b ə˩ r a˩ r
gobe	ɡʷ oː˩ b e˩
gobir	ɡʷ oː˩ b ɪ˥ r
gode	ɡʷ oː˥ d e˩
godewa	ɡʷ oː˥ d eː˥ w aː˩
godiya	ɡʷ oː˥ d ɪ˥ j aː˩
godiyar	ɡʷ oː˥ d ɪ˥ j ɛ˥ r
godiyarta	ɡʷ oː˥ d ɪ˥ j ɛ˥ r t aː˩
goerge	ɡʷ oː˩ eː˥ r ɟ eː˥
goge	ɡʷ oː˩ ɟ eː˥
gogewa	ɡʷ oː˩ ɟ eː˥ w aː˩
golf	ɡʷ oː˩ l p
goma	ɡʷ oː˥ m ə˩
gomai	ɡʷ oː˥ m aj˥
gomiya	ɡʷ oː˩ m ɪ˥ j aː˥
gona	ɡʷ oː˥ n aː˥
gonaki	ɡʷ oː˩ n aː˥ c iː˩
gonakin	ɡʷ oː˥ n aː˥ c ɪ˩ ŋ
gonarsa	ɡʷ oː˩ n a˩ r aː˩
gong	ɡʷ oː˩ ŋ
goodluck	ɡʷ oː˩ oː˥ d l ɪ˥ k
google	ɡʷ oː˩ oː˥ ɡʷ l eː˩
gora	ɡʷ oː˥ r aː˩
gordon	ɡʷ oː˥ r d oː˩ ŋ
goro	ɡʷ oː˥ r o˩
gosulo	ɡʷ oː˩ s ɪ˩ l oː˩
goyawa	ɡʷ oː˩ j aː˥ w aː˥
goyi	ɡʷ oː˩ j ɪ˥
goyon	ɡʷ oː˩ j ɔ˩ ŋ
goɓe	ɡʷ oː˩ ɓ e˩
grace	ɡʷ r ə˩ tʃ eː˩
greece	ɡʷ ɽ eː˥ eː˥ tʃ eː˩
gu	ɡʷ ʊ˩
guanghui	ɡʷ ʊ˩ ŋ ɡʷ h uː˥ iː˩
guardian	ɡʷ ʊ˩ a˩ r d ɪ˥ a˥˦ ŋ
guba	ɡʷ ʊ˥ b aː˩
gubar	ɡʷ ʊ˥ b a˩ r
guda	ɡʷ ʊ˥ d aː˩
gudana	ɡʷ ʊ˥ d ə˥ n ə˥
gudanar	ɡʷ ʊ˥ d ə˥ n a˩ r
gudanarwa	ɡʷ ʊ˥ d ə˥ n ə˥ ɽ w aː˥
gudanarwar	ɡʷ ʊ˥ d ə˥ n a˩ r w a˥ r
gudawa	ɡʷ ʊ˥ d ə˥ w aː˥
guddummuwa	ɡʷ ʊ˥ d ɪ˥ m ʊ˥ w aː˥
gudu	ɡʷ ʊ˥ d ɪ˩
guduma	ɡʷ ʊ˩ d ɪ˥ m aː˩
gudummawa	ɡʷ ʊ˩ d ɪ˥ m aː˥ w aː˥
gudummowa	ɡʷ ʊ˩ d ɪ˥ m oː˥ w aː˩
gudummowar	ɡʷ ʊ˩ d ɪ˥ m oː˥ w a˥ r
gudumuwa	ɡʷ ʊ˩ d ɪ˥ m ʊ˥ w aː˥
gudun	ɡʷ ʊ˥ d ɪ˩ ŋ
guduwa	ɡʷ ʊ˥ d ʊ˥ w aː˥
guguwa	ɡʷ ʊ˩ ɡʷ ʊ˥ w aː˩
gui	ɡʷ ʊ˩ iː˥
guifang	ɡʷ ʊ˩ iː˥ ɸ a˥ ŋ
guilin	ɡʷ ʊ˩ iː˥ l ɪ˩ ŋ
guinea	ɡʷ ʊ˩ ɪ˩ n e˥ aː˩
guiwa	ɡʷ ʊ˩ iː˥ w aː˩
guiwar	ɡʷ ʊ˩ iː˥ w a˥ r
guiwarsu	ɡʷ ʊ˩ iː˥ w aː˥ ɽ s ɪ˩
guiyang	ɡʷ ʊ˩ iː˥ j ɛ˥ ŋ
guje	ɡʷ ʊ˩ dʒ e˩
gujewa	ɡʷ ʊ˩ dʒ eː˥ w aː˩
guji	ɡʷ ʊ˩ dʒ iː˥
gula	ɡʷ ʊ˥ l aː˩
gulbi	ɡʷ ʊ˥ l b iː˥
gulbin	ɡʷ ʊ˥ l b ɪ˩ ŋ
gum	ɡʷ ʊ˩ m
guma	ɡʷ ʊ˥ m aː˩
gumaka	ɡʷ ʊ˥ m ə˥ k aː˩
gumal	ɡʷ ʊ˥ m a˩ l
gumel	ɡʷ ʊ˥ m a˥ l
gumi	ɡʷ ʊ˥ m iː˥
gumurzu	ɡʷ ʊ˥ m ʊ˩ r z ɪ˩
gumurzun	ɡʷ ʊ˥ m ʊ˩ r z ɪ˩ ŋ
gun	ɡʷ ʊ˩ ŋ
guna	ɡʷ ʊ˥ n aː˩
gunagunin	ɡʷ ʊ˥ n ə˥ ɡʷ ʊ˩ n ɪ˥ ŋ
gunda	ɡʷ ʊ˥ n d aː˩
gundiri	ɡʷ ʊ˥ n d ɪ˩ r iː˥
gunduma	ɡʷ ʊ˥ n d ɪ˥ m aː˩
gundumar	ɡʷ ʊ˥ n d ɪ˥ m a˩ r
gundumomi	ɡʷ ʊ˥ n d ɪ˥ m oː˥ m iː˥
gundura	ɡʷ ʊ˥ n d uː˥ r aː˩
gungun	ɡʷ ʊ˩ ŋ ɡʷ ʊ˩ ŋ
gunki	ɡʷ ʊ˥ ɲ c iː˩
guntun	ɡʷ ʊ˥ n t ɪ˥ ŋ
gunus	ɡʷ ʊ˩ n ɪ˩ s
gunya	ɡʷ ʊ˥ ɲ j aː˥
guraban	ɡʷ ʊ˩ r ə˩ b a˩ ŋ
guraben	ɡʷ ʊ˩ r ə˩ b eː˥ ŋ
gurasa	ɡʷ ʊ˩ r aː˥ s aː˩
gurbata	ɡʷ ʊ˩ r b aː˥ t aː˩
gurbin	ɡʷ ʊ˩ r b ɪ˩ ŋ
gurfanar	ɡʷ ʊ˩ r ɸ ə˥ n a˩ r
gurguzu	ɡʷ ʊ˩ r ɡʷ ʊ˩ z ɪ˩
gurnet	ɡʷ ʊ˩ r n a˥ t
guru	ɡʷ uː˥ r uː˥
gurɓataccen	ɡʷ ʊ˩ r ɓ ə˥ t ə˥ tʃ eː˩ ŋ
gusa	ɡʷ ʊ˥ s aː˩
gusau	ɡʷ ʊ˩ s aw˥
gusum	ɡʷ ʊ˥ s ɪ˩ ŋ
gutsira	ɡʷ uː˥ sʼ ɪ˥ r aː˥
gutsura	ɡʷ uː˥ sʼ uː˥ r aː˩
gwabza	ɡʷ a˥ b z aː˩
gwada	ɡʷ aː˥ d aː˩
gwadawa	ɡʷ aː˥ d ə˥ w aː˩
gwaggo	ɡʷ a˥ ɡʷ ɡʷ o˩
gwagwarmaya	ɡʷ a˥ ɡʷ a˥ r m aː˩ j aː˥
gwagwarmayar	ɡʷ a˥ ɡʷ a˥ r m aː˩ j ɛ˥ r
gwaiba	ɡʷ aj˥ b aː˩
gwaje	ɡʷ a˥ dʒ e˩
gwaji	ɡʷ a˥ dʒ iː˥
gwajin	ɡʷ aː˥ dʒ ɪ˩ ŋ
gwajinta	ɡʷ a˥ dʒ ɪ˥ n t aː˩
gwal	ɡʷ a˥˦ l
gwalkwas	ɡʷ a˥ l kʷ a˩ s
gwamantin	ɡʷ aː˥ m ə˩ n t ɪ˥ ŋ
gwame	ɡʷ a˥ m eː˩
gwamna	ɡʷ a˥ m n aː˩
gwamnan	ɡʷ a˥ m n a˩ ŋ
gwamnati	ɡʷ a˥ m n ə˥ t ɪ˩
gwamnatin	ɡʷ a˥ m n ə˥ t ɪ˩ ŋ
gwamnatinta	ɡʷ a˥ m n ə˥ t ɪ˥ n t aː˩
gwamnatoci	ɡʷ a˥ m n ə˥ t oː˥ tʃ ɪ˩
gwamnatocin	ɡʷ a˥ m n ə˥ t oː˥ tʃ ɪ˩ ŋ
gwanda	ɡʷ a˥ n d aː˩
gwandu	ɡʷ a˥ n d ɪ˥
gwangwanaye	ɡʷ a˥ ŋ ɡʷ aː˥ n aː˩ j eː˥
gwangwani	ɡʷ a˥ ŋ ɡʷ ə˥ n iː˥
gwani	ɡʷ aː˥ n iː˩
gwaninta	ɡʷ aː˥ n ɪ˥ n t aː˩
gwanintarsa	ɡʷ aː˥ n ɪ˥ n t ə˩ ɽ s aː˥
gwanjo	ɡʷ a˥ n dʒ ɔ˩
gwaza	ɡʷ aː˥ z aː˥
gwiwa	ɡʷ iː˥ w aː˩
gwiwar	ɡʷ iː˥ w a˥ r
gyara	ɡʷ j aː˥ r aː˩
gyare	ɡʷ j aː˥ ɽ eː˩
gyaru	ɡʷ j aː˥ ɽ uː˥
gyaɗa	ɡʷ j aː˥ ɗ aː˩
haba	h a˥ b aː˩
habaka	h a˥ b ə˥ k aː˥
habar	h a˥ b a˩ r
habasha	h a˥ b ə˥ ʃ ə˩
habbaka	h a˥ b ə˥ k aː˩
habiba	h a˥ b iː˥ b aː˩
habibu	h a˥ b ɪ˩ b ʊ˩
habibua	h a˥ b ɪ˩ b uː˥ aː˩
habibuson	h a˥ b ɪ˩ b ʊ˥ s oː˥ ŋ
hada	h aː˥ d aː˩
hadadden	h aː˥ d ə˥ d eː˩ ŋ
hadadiyyar	h a˩ d ə˩ d ɪ˥ j ɛ˥ r
hadahadar	h a˩ d ə˩ h aː˥ d aː˩ r
hadari	h a˩ d ə˩ r iː˥
hadarin	h a˩ d ə˩ r ɪ˥ ŋ
hadda	h a˥ d aː˩
haddasa	h a˩ d ə˥ s aː˥
haddi	h a˥ d iː˩
haddin	h a˥ d ɪ˩ ŋ
hade	h a˩ d e˩
hadin	h a˩ d ɪ˩ ŋ
hadisi	h a˩ d iː˥ s iː˩
hadiye	h a˩ d iː˥ j eː˥
hadiza	h a˩ d iː˥ z aː˩
hadizaam	h a˩ d iː˥ z a˥˦ ŋ
hadizatu	h a˩ d iː˥ z ə˥ t ɪ˩
hadu	h a˩ d ɪ˩
haduwa	h a˩ d ʊ˥ w aː˥
haduwar	h a˩ d ʊ˥ w a˥ r
haduwarmu	h a˩ d ʊ˥ w a˥ r m uː˩
hafizu	h aː˥ ɸ ɪ˥ z ɪ˩
hafsat	h a˩ ɸ s ə˥ t
hafsatu	h a˩ ɸ s ə˥ t ɪ˩
hagu	h aː˥ ɡʷ ʊ˩
hai	h aj˥
haifar	h aj˥ ɸ a˩ r
haifarwa	h aj˥ ɸ a˩ ɽ w aː˥
haife	h aj˥ ɸ eː˩
haifi	h aj˥ ɸ iː˥
haihuwa	h aj˥ h ʊ˥ w aː˥
haihuwar	h aj˥ h ʊ˥ w a˥ r
haihuwarku	h aj˥ h ʊ˥ w a˥ r kʷ ʊ˩
haihuwarsa	h aj˥ h ʊ˥ w a˥ r s aː˥
haikali	h aj˥ k ə˩ l iː˥
haikalin	h aj˥ k aː˥ l ɪ˩ ŋ
haila	h aj˥ l aː˩
hainan	h aj˥ n a˥˦ ŋ
hairan	h aj˥ r a˩ ŋ
haiti	h a˥ aj˥ t iː˩
haja	h aː˥ dʒ aː˩
haji	h a˥ dʒ ɪ˩
hajji	h a˥ dʒ ɪ˩
haka	h aː˥ k aː˥
hakan	h a˥ k a˩ ŋ
hakanan	h a˥ k ə˥ n a˩ ŋ
hakar	h a˥ k a˩ r
hakika	h a˥ c ɪ˥ k aː˩
hakikanan	h a˥ c ɪ˥ k ə˥ n a˩ ŋ
hakikanin	h a˥ c ɪ˥ k aː˩ n ɪ˥ ŋ
hakimi	h aː˥ c ɪ˩ m iː˥
hakiya	h a˥ c ɪ˥ j aː˩
hakkan	h a˥ k k a˩ ŋ
hakki	h a˥ c iː˩
hakkin	h a˥ c ɪ˥ ŋ
hakkinsu	h a˥ c iː˥ n s ɪ˩
hakkinta	h a˥ c ɪ˥ n t aː˩
hakkokin	h a˥ c oː˥ c ɪ˥ ŋ
hakkokinsu	h a˥ c oː˥ c iː˥ n s ɪ˩
hako	h aː˥ kʷ oː˥
hakoran	h aː˥ kʷ oː˥ r a˩ ŋ
hakuri	h aː˥ kʷ ʊ˩ ɽ iː˥
halaka	h a˥ l ə˩ k aː˥
halaka	h a˩ l ə˥ k ə˩
halakar	h a˩ l ə˥ k a˩ r
halal	h a˩ l a˥˦ l
halama	h a˩ l aː˥ m aː˩
halarci	h a˩ l a˥ ɽ tʃ iː˥
halartar	h a˩ l a˥ r t ɛ˥ r
halatta	h a˩ l a˩ t aː˥
halayen	h a˩ l aː˩ j eː˥ ŋ
halayya	h a˩ l ɛ˩ j aː˩
halayyar	h a˩ l ɛ˩ j ɛ˥ r
halayyarsa	h a˩ l ɛ˩ j aː˥ ɽ s aː˥
hali	h aː˥ l iː˥
halilu	h a˩ l iː˥ l ɪ˩
halima	h a˩ l iː˥ m ə˩
halin	h aː˥ l ɪ˩ ŋ
halinsa	h a˥ l ɪ˥ n s aː˩
halitta	h a˥ l ɪ˥ t aː˩
halittar	h a˥ l ɪ˥ t a˩ r
halittu	h a˥ l ɪ˥ t ɪ˩
halittun	h a˥ l ɪ˥ t ɪ˥ ŋ
hallaka	h a˩ l aː˥ k aː˥
hallelujah	h a˩ l eː˥ l uː˥ dʒ aː˩
halwa	h a˥ l w aː˩
hama	h a˥ m aː˩
hamada	h a˩ m aː˥ d aː˩
hamadar	h a˩ m aː˥ d aː˩ r
hamas	h a˥ m ə˩ s
hamayya	h a˩ m ɛ˥ j aː˩
hambarar	h a˩ m b ə˩ r a˩ r
hamburar	h a˩ m b ʊ˥˦ r a˩ r
hamdala	h a˥ m d ə˥ l aː˩
hamid	h a˩ m ɪ˥˦ d
hamidu	h a˥ m iː˥ d ɪ˩
hamila	h a˩ m iː˥ l aː˩
hamsatu	h a˩ m s ə˥ t ɪ˩
hamsin	h a˩ m s ɪ˥ ŋ
han	h a˩ ŋ
hana	h aː˥ n aː˩
hanayen	h aː˥ n aː˩ j eː˥ ŋ
hanci	h a˥ n tʃ iː˩
hanci	h a˥ n tʃ ɪ˥
hancin	h a˥ n tʃ ɪ˩ ŋ
hange	h ɛ˥ ɲ ɟ eː˥
hangen	h ɛ˥ ɲ ɟ eː˥ ŋ
hango	h a˥ ŋ ɡʷ oː˥
hangum	h a˩ ŋ ɡʷ ʊ˥ ŋ
hanhai	h a˩ ŋ h aj˥
hani	h a˥ n iː˩
hani'an	h aː˥ n ɪ˥ ʔ a˩ ŋ
hankaka	h a˩ ŋ k ə˥ k aː˩
hankali	h a˩ ŋ k ə˥ l iː˩
hankalin	h a˩ ŋ k ə˥ l ɪ˩ ŋ
hankalina	h a˩ ŋ k ə˥ l ɪ˥ n aː˩
hankalinka	h a˩ ŋ k ə˥ l ɪ˩ ŋ k aː˥
hankalinku	h a˩ ŋ k ə˥ l ɪ˩ ŋ kʷ ʊ˩
hankalinsa	h a˩ ŋ k ə˥ l iː˩ n s aː˩
hankula	h a˩ ŋ kʷ uː˥ l aː˩
hankulan	h a˩ ŋ kʷ ʊ˩ l a˥˦ ŋ
hankulansu	h a˩ ŋ kʷ ʊ˩ l aː˥ n s ɪ˩
hannaye	h a˥ n aː˩ j eː˥
hannayenka	h a˥ n aː˩ j eː˥ ŋ k aː˥
hannu	h a˥ n ɪ˩
hannun	h a˥ n ɪ˩ ŋ
hannuna	h a˥ n ɪ˩ n aː˩
hannunka	h a˥ n ɪ˩ ŋ k aː˥
hannunsa	h a˥ n ɪ˩ n s aː˩
hannunsu	h a˥ n ɪ˩ n s ɪ˩
hannunta	h a˥ n ɪ˩ n t aː˥
hannuwa	h a˥ n ʊ˥ w aː˥
hannuwanku	h a˥ n ɪ˩ w a˩ ŋ kʷ ʊ˩
hannuwansu	h a˥ n ɪ˩ w ə˩ n s ɪ˩
hanta	h a˥ n t aː˩
hanya	h ɛ˥ ɲ j aː˩
hanyar	h ɛ˥ ɲ j ɛ˥ r
hanyarmu	h ɛ˥ ɲ j aː˥ ɽ m uː˩
hanyarsa	h ɛ˥ ɲ j aː˥ ɽ s aː˥
hanyoyi	h ɛ˥ ɲ j oː˩ j ɪ˥
hanyoyin	h ɛ˥ ɲ j oː˩ j ɪ˥ ŋ
hanzari	h a˩ n z ə˩ r iː˥
haorar	h a˥ oː˥ r a˩ r
har	h a˥ r
haraba	h a˥ r ə˩ b aː˥
harabar	h a˥ r ə˩ b a˩ r
harafi	h a˥ r ə˩ ɸ iː˥
haraji	h a˩ r aː˥ dʒ iː˩
harajin	h a˩ r aː˥ dʒ ɪ˩ ŋ
haram	h a˩ r a˥˦ ŋ
haramta	h a˩ r aː˥ m t aː˩
haramun	h a˩ r aː˥ m ʊ˩ ŋ
harare	h a˩ r aː˥ ɽ eː˩
harba	h a˥ ɽ b aː˩
harbe	h a˩ r b e˩
harbi	h a˩ r b iː˥
harbin	h a˩ r b ɪ˩ ŋ
harbo	h a˩ r b oː˥
hare	h a˩ r eː˩
haren	h a˩ r eː˩ ŋ
hargitsi	h a˩ r ɟ ɪ˩ sʼ iː˥
hari	h a˩ r iː˩
harin	h a˩ r ɪ˥ ŋ
harkan	h a˥ r k a˩ ŋ
harkar	h a˥ r k a˩ r
harkoki	h a˩ r kʷ oː˩ c iː˩
harkokin	h a˩ r kʷ oː˩ c ɪ˥ ŋ
harkokinsa	h a˩ r kʷ oː˩ c ɪ˥ n s aː˩
harkokinsu	h a˩ r kʷ oː˩ c ɪ˥ n s ɪ˩
harma	h a˥ r m aː˩
harsashi	h a˩ r s aː˥ ʃ iː˩
harsashin	h a˩ r s aː˥ ʃ ɪ˥˦ ŋ
harshe	h a˥ ɽ ʃ e˩
harshen	h a˥ ɽ ʃ e˩ ŋ
harsunan	h a˩ r uː˩ n a˥˦ ŋ
haruffa	h a˥ r uː˥ ɸ aː˩
haruna	h a˥ r uː˥ n ə˩
hary	h a˩ r j
haryanzu	h a˩ r j ɛ˥ ɲ z ɪ˩
haryy	h a˩ r j
harzuwa	h a˩ r z ʊ˥ w aː˥
hasa	h a˥ s aː˩
hasada	h a˥ s ə˩ d aː˥˦
hasafi	h a˥ s ə˩ ɸ iː˥
hasan	h a˥ s a˩ ŋ
hasana	h a˥ s ə˩ n aː˥
hasara	h a˩ s aː˥ r aː˩
hasashe	h a˥ s ə˩ ə˥ ʃ e˥
hasashen	h a˥ s ə˥ ʃ e˥ ŋ
haska	h a˥ s k aː˩
haskaka	h a˥ s k ə˥ k aː˩
haske	h a˥ s c eː˩
hasken	h a˥ s c eː˩ ŋ
hassan	h a˥ s a˩ ŋ
hassana	h a˥ s aː˥ n aː˩
hasumiya	h a˥ s ɪ˩ m ɪ˥ j aː˩
hasumiyar	h a˥ s ɪ˩ m ɪ˥ j ɛ˥ r
hatasarin	h a˥ t ə˩ s ə˩ ɽ ɪ˥ ŋ
hatimi	h aː˥ t ɪ˩ m iː˥
hatsari	h aː˥ sʼ ɽ iː˥
hatsarin	h aː˥ sʼ ɽ ɪ˥ ŋ
hatsarinan	h aː˥ sʼ ɽ iː˥ n a˥˦ ŋ
hatsi	h aː˥ sʼ iː˥
hatta	h a˩ t aː˥
hau	h aw˥˦
hauhawar	h aw˩ h aː˥ w a˥ r
hauka	h aw˩ k aː˩
haukace	h aw˩ k aː˩ tʃ eː˩
haura	h aw˥ r aː˩
hausa	h aw˥ s ə˥
hausawa	h aw˥ s aː˥ w aː˥
haushi	h aw˩ ʃ iː˥
hauwa	h aw˩ w ə˥
hauwatu	h aw˩ w ə˥ t ɪ˩
hauwatutu	h aw˩ w ə˥ t ɪ˥ t ɪ˥
hawa	h a˩ w aː˥
hawa'i	h a˩ w aː˥ ʔ iː˥
hawan	h a˩ w a˥˦ ŋ
hawaye	h a˩ w aː˩ j eː˥
hawayensu	h a˩ w aː˩ j eː˥ n s ɪ˩
hawk	h a˩ w k
hayaki	h ɛ˥ j aː˩ c iː˥
hayakin	h ɛ˥ j aː˥ c ɪ˩ ŋ
hayaniya	h ɛ˥ j aː˥ n ɪ˥ j ɛ˩
hayaniyar	h ɛ˥ j aː˥ n ɪ˩ j ɛ˥ r
hayar	h ɛ˥ j ɛ˥ r
hayaƙin	h ɛ˥ j aː˩ cʼ ɪ˥ ŋ
hayyaci	h ɛ˥ j aː˩ tʃ iː˥
hayyacinsa	h ɛ˥ j aː˩ tʃ iː˥ n s aː˩
hayyacinta	h ɛ˥ j aː˩ tʃ ɪ˥ n t aː˩
haziƙi	h aː˥ z ɪ˩ cʼ iː˥
hazo	h a˥ z oː˥
haƙa	h a˥ kʼ aː˩
haƙarƙai	h a˥ kʼ a˩ ɽ kʼ aj˥
haƙiƙa	h a˥ cʼ iː˥ kʼ aː˩
haƙoransu	h a˩ kʷʼ oː˥ r a˥ n s ɪ˩
haƙura	h a˩ kʷʼ ʊ˩ ɽ ə˩
haƙurau	h a˩ kʷʼ ʊ˩ ɽ aw˥
haƙuri	h a˩ kʷʼ ʊ˩ ɽ iː˥
haƙurin	h a˩ kʷʼ ʊ˩ r ɪ˥ ŋ
haƙurinta	h a˩ kʷʼ ʊ˩ r ɪ˥ n t aː˩
haɓa	h a˥ ɓ aː˩
haɓakar	h a˥ ɓ ə˥ k a˩ r
haɓe	h aː˥ ɓ e˩
haɓɓoje	h a˥ ɓ oː˥ dʒ e˩
haɗa	h a˥ ɗ ə˩
haɗaka	h a˥ ɗ ə˩ k aː˥
haɗakar	h a˥ ɗ ə˩ k a˩ r
haɗari	h a˥ ɗ ə˩ r iː˥
haɗarin	h a˥ ɗ ə˩ r ɪ˥ ŋ
haɗawa	h a˥ ɗ aː˥ w aː˥
haɗe	h a˥ ɗ eː˥
haɗeja	h a˥ ɗ eː˥ dʒ ə˩
haɗi	h a˥ ɗ iː˥
haɗin	h a˥ ɗ ɪ˥ ŋ
haɗu	h a˥ ɗ ɪ˥
haɗuwa	h a˥ ɗ ʊ˥ w aː˥
haɗuwar	h a˥ ɗ ʊ˥ w a˥ r
hebei	h eː˥ b eː˥ iː˩
hedkwatar	h eː˥ d kʷ ə˥ t a˩ r
hei	h eː˥ iː˩
helan	h eː˥ l a˥˦ ŋ
hello	h eː˥ l oː˥
henan	h eː˥ n a˥˦ ŋ
heng	h eː˥ ŋ
hercules	h eː˥ ɽ tʃ ɪ˥ l eː˩ s
heshun	h eː˥ ʃ ɪ˥ ŋ
hi	h iː˩
hidima	h ɪ˥ d ɪ˥ m aː˥
hidimar	h ɪ˥ d ɪ˥ m a˩ r
hidimomi	h ɪ˥ d ɪ˥ m oː˥ m iː˥
hijabi	h ɪ˩ dʒ aː˥ b iː˩
hijira	h ɪ˥ dʒ ɪ˥ r aː˥
hijirar	h ɪ˥ dʒ ɪ˥ r a˩ r
hikaya	h ɪ˩ k aː˥ j aː˩
hikima	h ɪ˥ c ɪ˥ m aː˩
hikimar	h ɪ˥ c ɪ˥ m a˩ r
himma	h ɪ˥ m aː˩
himmantar	h ɪ˥ m a˩ n t a˩ r
himmantu	h ɪ˥ m a˩ n t ɪ˩
himmantuwa	h ɪ˥ m a˩ n t ʊ˥ w aː˥
himmar	h ɪ˥ m a˩ r
hira	h ɪ˥ r aː˩
hirar	h ɪ˥ r a˩ r
hisabi	h ɪ˩ s aː˥ b iː˩
hizbullah	h ɪ˥ z b ʊ˩ l aː˩
hoda	h oː˥ d aː˩
holand	h oː˥ l a˩ n d
hole	h oː˥ l eː˩
holo	h oː˥ l oː˩
homan	h oː˥ m a˩ ŋ
hong	h oː˥ ŋ
hongkong	h oː˥ ŋ kʷ oː˩ ŋ
hood	h oː˥ oː˥ d
horar	h oː˥ r a˩ r
hori	h oː˥ r iː˩
horo	h oː˥ r o˩
hosni	h oː˥ n iː˩
hotel	h oː˥ t eː˥ l
hoto	h oː˥ t o˥
hoton	h oː˥ t a˥ ŋ
hotona	h oː˥ t oː˥ n aː˥
hotonka	h oː˥ t a˥ ŋ k aː˥
hotuna	h oː˥ t ɪ˩ n aː˩
hotunan	h oː˥ t uː˩ n a˥˦ ŋ
hou	h oː˥ uː˩
house	h oː˥ uː˩ e˩
htu	h t ɪ˩
hu	h ʊ˩
hua	h ʊ˥ aː˩
huabei	h ʊ˥ b eː˥ iː˩
huali	h ʊ˥ ə˩ l iː˥
huang	h uː˥ a˥ ŋ
hubbare	h ʊ˥ b aː˥ r e˩
hubbaren	h ʊ˥ b aː˥ r e˩ ŋ
hubei	h ʊ˥ b eː˥ iː˩
huce	h ʊ˥ tʃ eː˩
huda	h ʊ˥ d ə˩
hudu	h ʊ˥ d ɪ˩
hugo	h ʊ˥ ɡʷ oː˥
huhu	h uː˥ h uː˩
huhu	h uː˩ h uː˥
hui	h ʊ˥ iː˩
hujjar	h ʊ˥ dʒ a˥ r
hukuma	h ʊ˩ kʷ uː˥ m aː˩
hukumar	h ʊ˩ kʷ uː˥ m a˩ r
hukumomi	h ʊ˩ kʷ uː˥ m oː˥ m iː˥
hukumomin	h ʊ˩ kʷ uː˥ m oː˥ m ɪ˥ ŋ
hukunci	h ʊ˩ kʷ uː˥ n tʃ iː˥
hukuncin	h ʊ˩ kʷ uː˥ n tʃ ɪ˩ ŋ
hukunta	h ʊ˩ kʷ uː˥ n t aː˥
hula	h uː˩ l aː˥
hular	h uː˥ l a˩ r
hularsa	h uː˥ l a˩ r aː˩
huldar	h ʊ˥ l d a˥˦ r
hull	h ʊ˥ l
hulɗa	h ʊ˥ l ɗ aː˩
hulɗar	h ʊ˥ l ɗ ɛ˥ r
humushi	h ʊ˥ m uː˩ ʃ iː˥
humusi	h ʊ˥ m uː˩ s iː˥
hunan	h uː˩ n a˥˦ ŋ
hunkuncin	h uː˥ n kʷ uː˥ n tʃ ɪ˩ ŋ
hunt	h ʊ˥ n t
huntu	h ʊ˥ n t uː˥
hunturu	h ʊ˥ n t uː˥ r uː˥
hura	h uː˥ ɽ aː˩
hurawa	h uː˥ ɽ aː˥ w aː˥
hure	h uː˥ r eː˩
hurumin	h ʊ˥ ɽ ɪ˥ m ɪ˥ ŋ
husaina	h ʊ˥ s aj˩ n aː˥
husaini	h ʊ˩ s aj˥ n ɪ˩
husein	h ʊ˩ s e˥˦ ɪ˩ ŋ
huseini	h ʊ˩ s e˥˦ ɪ˩ n iː˥
hussaini	h ʊ˩ s aj˥ n ɪ˩
husufi	h ʊ˩ s uː˥ ɸ iː˩
huta	h uː˥ t aː˩
hutawa	h uː˥ t aː˥ w aː˥
hutsu	h uː˥ sʼ uː˥
hutu	h uː˥ t uː˥
hutu'	h uː˥ t ɪ˩ ʔ
hutun	h uː˥ t ɪ˥ ŋ
hutunsa	h uː˥ t uː˥ n s aː˩
huɗu	h ʊ˥ ɗ ɪ˥
huɗuba	h ʊ˥ ɗ ɪ˥ b aː˩
huɗun	h ʊ˥ ɗ ɪ˥ ŋ
ibada	ʔ ɪ˩ b aː˥ d aː˩
ibadan	ʔ ɪ˩ b aː˥ d a˥˦ ŋ
ibilis	ʔ ɪ˩ b ɪ˩ l ɪ˥˦ s
ibilisai	ʔ ɪ˩ b ɪ˩ l ɪ˥˦ s aj˥
iblis	ʔ ɪ˩ b l ɪ˥˦ s
ibrahim	ʔ ɪ˩ b r aː˥ h ɪ˩ ŋ
ibrahima	ʔ ɪ˩ b r aː˥ h ɪ˥ m aː˩
ibrahims	ʔ ɪ˩ b r aː˥ h ɪ˩ m s
ibrahimu	ʔ ɪ˩ b r aː˥ h ɪ˩ m uː˩
ice	ʔ ɪ˥ tʃ eː˩
idan	ʔ ɪ˩ d a˥˦ ŋ
idanu	ʔ ɪ˩ d aː˥ n ɪ˩
idanunta	ʔ ɪ˩ d aː˥ n ɪ˩ n t aː˥
idanuwa	ʔ ɪ˩ d aː˥ n ʊ˥ w aː˥
idda	ʔ ɪ˥ d aː˩
iddi	ʔ ɪ˥ d iː˩
idi	ʔ iː˥ d iː˩
ido	ʔ ɪ˥ d oː˩
idoji	ʔ ɪ˥ d oː˩ dʒ iː˥
idon	ʔ ɪ˥ d oː˩ ŋ
idonta	ʔ ɪ˥ d oː˩ n t aː˥
idris	ʔ ɪ˥ d ɽ ɪ˩ s
igiyar	ʔ ɪ˩ ɟ ɪ˩ j ɛ˥ r
igwa	ʔ ɪ˥ ɡʷ aː˥
ihu	ʔ ɪ˥ h ʊ˩
ihun	ʔ ɪ˥ h ʊ˩ ŋ
ijara	ʔ ɪ˩ dʒ aː˥ r aː˩
ikirarin	ʔ ɪ˥ c ɪ˥ r aː˥ ɽ ɪ˥ ŋ
ikko	ʔ ɪ˩ kʷ o˥
iko	ʔ ɪ˩ kʷ oː˥
ikon	ʔ ɪ˩ kʷ oː˩ ŋ
ikonsu	ʔ ɪ˩ kʷ oː˩ n s ɪ˩
ila	ʔ ɪ˥ l aː˩
ilimi	ʔ ɪ˥ l ɪ˩ m iː˥
ilimin	ʔ ɪ˥ l ɪ˩ m ɪ˥ ŋ
illa	ʔ ɪ˥ l aː˥
illa	ʔ ɪ˥ l aː˩
illar	ʔ ɪ˥ l a˩ r
illolin	ʔ ɪ˥ l oː˩ l ɪ˩ ŋ
ilmi	ʔ ɪ˥ l m iː˩
ilmi	ʔ ɪ˥˦ l m iː˥
ilmin	ʔ ɪ˥ l m ɪ˥ ŋ
imam	ʔ iː˥ m a˥˦ ŋ
imamus	ʔ iː˥ m aː˥ m ʊ˩ s
imani	ʔ iː˥ m aː˥ n iː˩
in	ʔ ɪ˩ ŋ
ina	ʔ ɪ˥ n aː˩
inabi	ʔ ɪ˥ n ə˩ b iː˥
inci	ʔ ɪ˥ n tʃ iː˥
inda	ʔ ɪ˥ n d aː˩
india	ʔ ɪ˥ n d ɪ˥ aː˩
indiya	ʔ ɪ˥ n d ɪ˥ j ɛ˩
indiyawa	ʔ ɪ˥ n d ɪ˥ j aː˥ w aː˥
indonesia	ʔ ɪ˥ n d oː˩ n eː˥ s ɪ˩ aː˩
indonisiya	ʔ ɪ˥ n d oː˩ n ɪ˥ s ɪ˥ j aː˩
inganci	ʔ ɪ˩ ŋ ɡ a˥ n tʃ iː˥
ingancin	ʔ ɪ˩ ŋ ɡ a˥ n tʃ ɪ˩ ŋ
ingancinsu	ʔ ɪ˩ ŋ ɡ a˥ n tʃ iː˩ n s ɪ˩
inganta	ʔ ɪ˩ ŋ ɡ a˥ n t aː˩
ingantaccen	ʔ ɪ˩ ŋ ɡ a˥ n t ə˥ tʃ eː˩ ŋ
ingantacciyar	ʔ ɪ˩ ŋ ɡ a˥ n t ə˥ tʃ ɪ˩ j ɛ˥ r
ingantawa	ʔ ɪ˩ ŋ ɡ a˥ n t aː˥ w aː˥
ingantuwa	ʔ ɪ˩ ŋ ɡ a˥ n t ʊ˥ w aː˥
ingarma	ʔ ɪ˩ ŋ ɡ a˥ r m aː˩
ingila	ʔ iː˥ ɲ ɟ ɪ˩ l ə˩
ingilishi	ʔ ɪ˥ ɲ ɟ ɪ˩ l iː˥ ʃ iː˩
ingiza	ʔ ɪ˥ ɲ ɟ iː˥ z aː˩
inji	ʔ ɪ˥ n dʒ iː˥
injin	ʔ ɪ˥ n dʒ ɪ˩ ŋ
injiniya	ʔ ɪ˥ n dʒ ɪ˥ n ɪ˥ j ɛ˩
injiniyan	ʔ ɪ˥ n dʒ ɪ˥ n ɪ˥ j ɛ˩ ŋ
injuna	ʔ ɪ˥ n dʒ uː˥ n aː˩
injunan	ʔ ɪ˥ n dʒ uː˩ n a˥˦ ŋ
inna	ʔ ɪ˥ n ə˩
inshora	ʔ ɪ˥ n s h oː˥ r aː˩
inshorar	ʔ ɪ˥ n s h oː˥ r a˩ r
intabiyu	ʔ ɪ˥ n t ə˩ b ɪ˥ j ʊ˥
intanet	ʔ ɪ˥ n t ə˩ n a˥ t
internet	ʔ ɪ˥ n t eː˥ r n a˥ t
inuwar	ʔ ɪ˥ n ʊ˥ w a˥ r
iraki	ʔ ɪ˩ r aː˥˦ c iː˥
iran	ʔ ɪ˩ r a˩ ŋ
iraniyawa	ʔ ɪ˩ r aː˥ n ɪ˩ j aː˥ w aː˥
iraƙ	ʔ ɪ˩ r a˥˦ kʼ
iraƙi	ʔ ɪ˩ r aː˥˦ cʼ ɪ˩
iri	ʔ ɪ˩ r iː˥
irin	ʔ ɪ˥ ɽ ɪ˥ ŋ
irinsa	ʔ ɪ˥ ɽ ɪ˥ n s aː˩
irinsu	ʔ ɪ˥ ɽ ɪ˥ n s ɪ˩
irinta	ʔ ɪ˥ ɽ ɪ˥ n t aː˩
irna	ʔ ɪ˩ r n aː˩
isa	ʔ iː˥ s aː˥
isashen	ʔ ɪ˩ s ə˥ ʃ e˥ ŋ
isasshe	ʔ ɪ˥ s ə˩ ə˥ ʃ e˥
isasshen	ʔ ɪ˩ s aː˥ s ə˩ ʃ eː˩ ŋ
isassun	ʔ ɪ˩ s aː˥ s ɪ˩ ŋ
isha	ʔ iː˩ ʃ aː˥
ishaku	ʔ ɪ˩ ʃ aː˥ kʷ ʊ˩
ishakua	ʔ ɪ˩ ʃ aː˥ kʷ ʊ˩ aː˩
ishara	ʔ ɪ˩ ʃ aː˥ r aː˩
ishe	ʔ ɪ˥ ʃ eː˩
ishi	ʔ ɪ˥ ʃ iː˥
isiyaku	ʔ ɪ˥ s ɪ˥ j aː˥ kʷ ʊ˩
iska	ʔ ɪ˥ s k aː˩
iskar	ʔ ɪ˥ s k a˩ r
islama	ʔ ɪ˩ s l aː˥ m aː˩
isma'ilu	ʔ ɪ˩ s m aː˥ ʔ iː˥ l ɪ˩
iso	ʔ ɪ˩ s oː˥
isowa	ʔ ɪ˩ s oː˥ w aː˩
isowar	ʔ ɪ˩ s oː˥ w a˥ r
isra'ila	ʔ ɪ˩ s r aː˥ ʔ iː˥ l ə˩
israela	ʔ ɪ˩ s r eː˥ l ə˩
istihara	ʔ ɪ˥ s t ɪ˩ h aː˥ r aː˩
isƙandariya	ʔ ɪ˩ s kʼ a˥ n d ə˩ r ɪ˥ j ɛ˩
ita	ʔ ɪ˥ t ə˥
itace	ʔ ɪ˥ t ə˥ tʃ eː˩
itacen	ʔ ɪ˥ t ə˥ tʃ eː˩ ŋ
itaciya	ʔ ɪ˥ t ə˥ tʃ ɪ˩ j aː˥
italiya	ʔ ɪ˩ t aː˥ l ɪ˥ j ɛ˩
italy	ʔ ɪ˥ t ə˥ l j
itama	ʔ ɪ˥ t ə˥ m ə˩
itatuwa	ʔ ɪ˥ t ə˥ t ʊ˥ w aː˥
itatuwan	ʔ ɪ˥ t ə˥ t ʊ˥ w a˩ ŋ
iya	ʔ ɪ˩ j aː˥
iyaka	ʔ ɪ˩ j aː˥ k aː˥
iyakacin	ʔ ɪ˩ j aː˥ k aː˩ tʃ ɪ˥ ŋ
iyakar	ʔ ɪ˩ j ə˥ k a˩ r
iyakokin	ʔ ɪ˩ j aː˥ kʷ oː˥ c ɪ˥ ŋ
iyalai	ʔ ɪ˩ j aː˥ l aj˥
iyalaina	ʔ ɪ˩ j aː˥ l aj˥ n aː˩
iyalan	ʔ ɪ˩ j aː˥ l a˩ ŋ
iyalanka	ʔ ɪ˩ j aː˥ l a˥ ŋ k aː˥
iyalansa	ʔ ɪ˩ j aː˥ l a˥ n s ə˩
iyalansu	ʔ ɪ˩ j aː˥ l aː˥ n s ɪ˩
iyali	ʔ ɪ˩ j aː˥ l iː˩
iyalin	ʔ ɪ˩ j aː˥ l ɪ˩ ŋ
iyalinsa	ʔ ɪ˩ j aː˥ l ɪ˩ n s aː˩
iyawa	ʔ ɪ˩ j aː˥ w aː˥
iyaye	ʔ ɪ˩ j aː˩ j eː˥
iyayen	ʔ ɪ˩ j aː˩ j eː˥ ŋ
iyayena	ʔ ɪ˩ j aː˩ j eː˥ n aː˩
iyayensa	ʔ ɪ˩ j aː˩ j eː˥ n s aː˩
iyayensu	ʔ ɪ˩ j aː˩ j eː˥ n s ɪ˩
iyo	ʔ ɪ˩ j oː˥˦
izifi	ʔ ɪ˥ z ɪ˩ ɸ iː˥
izini	ʔ ɪ˥ z ɪ˩ n iː˥
izinin	ʔ ɪ˥ z ɪ˩ n ɪ˥ ŋ
izni	ʔ ɪ˥ z n iː˩
iznin	ʔ ɪ˥ z n ɪ˥ ŋ
ja	dʒ aː˥
jabu	dʒ ə˥ b ʊ˩
jace	dʒ aː˩ tʃ eː˥
jack	dʒ ə˩ k
jackie	dʒ aː˩ c ɪ˥ eː˩
jadawali	dʒ ə˥ d ə˥ w ə˩ l iː˥
jaddada	dʒ a˥ d ə˩ d aː˩
jafa'i	dʒ ə˩ ɸ aː˥ ʔ iː˩
jafananci	dʒ ə˩ ɸ aː˥ n a˥ n tʃ iː˥
jagora	dʒ aː˩ ɡʷ oː˩ ɽ aː˩
jagoran	dʒ aː˩ ɡʷ oː˥ r a˩ ŋ
jagoranci	dʒ aː˩ ɡʷ oː˥ r a˥ n tʃ iː˥
jagorancin	dʒ aː˩ ɡʷ oː˥ r a˥ n tʃ ɪ˩ ŋ
jagorantar	dʒ aː˩ ɡʷ oː˥ r a˩ n t a˩ r
jagorar	dʒ aː˩ ɡʷ oː˥ r a˩ r
jahadi	dʒ ə˩ h aː˥ d iː˩
jahannama	dʒ ə˩ h a˥ n aː˥ m aː˩
jahar	dʒ ə˩ h a˩ r
jahilci	dʒ aː˥ h ɪ˩ l tʃ iː˥
jahili	dʒ aː˥ h ɪ˩ l iː˥
jahun	dʒ aː˥ h ʊ˩ ŋ
jaje	dʒ aː˥ dʒ e˩
jajibirin	dʒ aː˥ dʒ ɪ˩ b ɪ˩ r ɪ˥ ŋ
jaka	dʒ ə˩ k aː˥
jakada	dʒ ə˩ k aː˥ d aː˩
jakadan	dʒ ə˩ k aː˩ d a˥˦ ŋ
jakadanci	dʒ ə˩ k aː˩ d a˥ n tʃ iː˥
jakadancin	dʒ ə˩ k aː˩ d a˥ n tʃ ɪ˩ ŋ
jakadar	dʒ ə˩ k aː˥ d aː˩ r
jakadiyar	dʒ ə˩ k aː˥ d ɪ˩ j ɛ˥ r
jakar	dʒ ə˩ k a˩ r
jakarta	dʒ ə˩ k a˩ r t aː˩
jaket	dʒ aː˩ c a˥ t
jaki	dʒ aː˩ c iː˥
jakson	dʒ ə˩ k s oː˥ ŋ
jakunansu	dʒ aː˥ kʷ ʊ˩ n aː˥ n s ɪ˩
jalal	dʒ aː˩ l a˥˦ l
jalala	dʒ aː˩ l aː˩ l aː˩
jalalu	dʒ aː˩ l aː˩ l ɪ˩
jam'i	dʒ a˥ m ʔ iː˩
jam'iyya	dʒ a˩ m ʔ ɪ˥ j aː˩
jam'iyyar	dʒ a˩ m ʔ ɪ˥ j ɛ˥ r
jama	dʒ aː˥ m aː˩
jama'a	dʒ ə˩ m ə˥ ʔ a˩
jama'a'	dʒ ə˩ m ə˥ ʔ aː˥ ʔ
jama'an	dʒ ə˩ m ə˥ ʔ a˩ ŋ
jama'ar	dʒ ə˩ m ə˥ ʔ a˩ r
jama'arsu	dʒ ə˩ m ə˥ ʔ a˩ r uː˩
jamani	dʒ aː˥ m ə˩ n iː˥
jamhuriya	dʒ a˩ m h uː˥ r ɪ˥ j aː˩
jamhuriyar	dʒ a˩ m h uː˥ r ɪ˥ j ɛ˥ r
jami	dʒ aː˥ m iː˩
jami'a	dʒ aː˥ m ɪ˥ ʔ aː˩
jami'a	dʒ aː˥ m ɪ˩ ʔ aː˥
jami'an	dʒ aː˥ m ɪ˩ ʔ a˩ ŋ
jami'i	dʒ aː˥ m ɪ˩ ʔ iː˥
jami'in	dʒ aː˥ m ɪ˩ ʔ ɪ˥ ŋ
jami'oi	dʒ aː˥ m ɪ˩ ʔ o˥ ɪ˥
jamilah	dʒ aː˥ m ɪ˩ l aː˩
jamiya	dʒ aː˥ m ɪ˥ j aː˩
jamus	dʒ aː˥ m ʊ˩ s
jamusanci	dʒ aː˥ m ʊ˥ s a˥ n tʃ iː˥
jamusawa	dʒ aː˥ m ʊ˩ s aː˥ w aː˥
jamusin	dʒ aː˥ m ʊ˩ s ɪ˩ ŋ
jan	dʒ a˥ ŋ
jana'iza	dʒ ə˩ n aː˥ ʔ ɪ˥ z aː˩
jana'izar	dʒ ə˩ n aː˥ ʔ ɪ˥ z aː˩ r
janaba	dʒ ə˩ n ə˥ b aː˩
janairu	dʒ ə˩ n aj˥ r ɪ˩
janar	dʒ ə˥ n a˩ r
janareton	dʒ ə˩ n ə˥ ɽ eː˩ t a˥ ŋ
janbaki	dʒ ə˩ n b aː˩ c iː˥
jane	dʒ ə˥ n e˥
jannati	dʒ a˥ n ə˥ t ɪ˩
janye	dʒ ə˩ ɛ˥ ɲ j eː˥
janyewa	dʒ ə˩ ɛ˥ ɲ j eː˥ w aː˩
janyo	dʒ ə˩ n j oː˥˦
japan	dʒ ə˩ p a˥˦ ŋ
japanawa	dʒ ə˩ p ə˩ n aː˥ w aː˥
jar	dʒ a˥ r
jaraba	dʒ aː˩ r ə˩ b aː˥
jarabawa	dʒ aː˩ r ə˩ b aː˥ w aː˥
jarabawan	dʒ aː˩ r ə˩ b aː˥ w a˥˦ ŋ
jarabawar	dʒ aː˩ r ə˩ b aː˥ w a˥ r
jari	dʒ ə˩ r iː˥
jarida	dʒ ə˩ r iː˥ d aː˩
jaridan	dʒ ə˩ r iː˥ d a˩ ŋ
jaridar	dʒ ə˩ r iː˥ d a˩ r
jaridu	dʒ ə˩ r iː˥ d ɪ˩
jaridun	dʒ ə˩ r iː˥ d ɪ˩ ŋ
jariminmu	dʒ ə˩ r iː˥ m iː˥ n m uː˩
jarin	dʒ aː˥ ɽ ɪ˥ ŋ
jarirai	dʒ ə˩ r iː˥ r aj˥
jariri	dʒ ə˩ r iː˥ r iː˩
jaririn	dʒ ə˩ r iː˥ r ɪ˥ ŋ
jarraba	dʒ a˥ r ə˩ b aː˥˦
jarrabawa	dʒ a˥ r ə˩ b aː˥˦ w aː˥
jarrabawar	dʒ a˥ r ə˩ b aː˥˦ w a˥ r
jarumai	dʒ aː˩ r ɪ˥ m aj˥
jarumai'	dʒ aː˩ r ɪ˥ m aj˥ ʔ
jaruman	dʒ aː˩ r ɪ˥ m a˩ ŋ
jarumi	dʒ aː˩ r ɪ˥ m iː˥
jarumin	dʒ aː˩ r ɪ˥ m ɪ˥ ŋ
jarumta	dʒ aː˩ r ɪ˥ m t aː˩
jaruntaka	dʒ aː˩ r ɪ˥ n t ə˥ k aː˩
jatau	dʒ aː˩ t aw˥
jauro	dʒ aw˥ ɽ oː˩
jauroa	dʒ aw˥ ɽ oː˩ aː˩
jaurou	dʒ aw˥ ɽ oː˩ uː˩
jawabi	dʒ ə˩ w aː˥ b iː˩
jawabin	dʒ ə˩ w aː˥ b ɪ˩ ŋ
jawad	dʒ ə˩ w aː˥ d
jawo	dʒ ə˩ w oː˩
jawowa	dʒ ə˩ w oː˥ w aː˩
jawur	dʒ aː˩ w ʊ˥ r
jaza'i	dʒ ə˩ z aː˥ ʔ iː˩
jazur	dʒ aː˩ z ɪ˥ r
je	dʒ eː˩
jean	dʒ eː˩ a˥˦ ŋ
jeep	dʒ eː˩ eː˥ p
jefa	dʒ eː˩ ɸ aː˩
jeff	dʒ eː˩ ɸ
jefi	dʒ eː˩ ɸ iː˥
jega	dʒ eː˩ ɡ ə˥
jejin	dʒ eː˥ dʒ ɪ˩ ŋ
jeka	dʒ eː˩ k aː˩
jere	dʒ eː˩ ɽ eː˩
jerin	dʒ eː˥ r ɪ˥ ŋ
jersey	dʒ eː˩ ɽ s e˥˦ j
jeru	dʒ eː˩ ɽ uː˥
ji	dʒ ɪ˩
jia	dʒ ɪ˥ aː˩
jiabao	dʒ ɪ˥ ə˥ b ə˩ o˥
jianchao	dʒ ɪ˥ a˥ n tʃ o˥
jiang	dʒ ɪ˥ a˥ ŋ
jiangsu	dʒ ɪ˥ a˥ ŋ ɡʷ s ɪ˩
jiaozi	dʒ ɪ˥ oː˥ z iː˥
jibge	dʒ ɪ˩ b ɟ eː˥
jibi	dʒ ɪ˩ b iː˥
jibirilu	dʒ ɪ˩ b ɪ˩ r iː˥ l ɪ˩
jibiya	dʒ ɪ˥ b ɪ˥ j ɛ˩
jidali	dʒ ɪ˩ d aː˥ l iː˩
jiechi	dʒ ɪ˥ eː˥ tʃ iː˩
jif	dʒ ɪ˥˦ ɸ
jigawa	dʒ ɪ˥ ɡ aː˥ w aː˥
jigilar	dʒ ɪ˩ ɟ ɪ˩ l a˩ r
jigo	dʒ ɪ˥ ɡʷ oː˩
jiha	dʒ ɪ˩ h aː˥
jihadi	dʒ ɪ˩ h aː˥ d iː˩
jihar	dʒ ɪ˩ h a˩ r
jihohi	dʒ ɪ˩ h oː˥ h iː˩
jihohin	dʒ ɪ˩ h oː˥ h ɪ˥ ŋ
jijiyoyin	dʒ ɪ˥ dʒ ɪ˩ j oː˩ j ɪ˥ ŋ
jika	dʒ ɪ˥ k ə˩
jikan	dʒ ɪ˥ k a˩ ŋ
jikar	dʒ ɪ˥ k a˩ r
jiki	dʒ ɪ˩ c iː˥
jikin	dʒ ɪ˥ c ɪ˥ ŋ
jikina	dʒ ɪ˥ c ɪ˥ n aː˩
jikinsa	dʒ ɪ˥ c ɪ˥ n s aː˩
jiku	dʒ ɪ˥ kʷ ʊ˩
jilin	dʒ ɪ˥ l ɪ˩ ŋ
jim	dʒ ɪ˥ ŋ
jima	dʒ ɪ˩ m aː˥
jima'i	dʒ ɪ˩ m aː˥ ʔ iː˩
jimawa	dʒ ɪ˩ m aː˥ w aː˥
jimilla	dʒ ɪ˩ m ɪ˥ l aː˩
jimina	dʒ ɪ˩ m ɪ˥ n aː˥
jimla	dʒ ɪ˥ m l aː˩
jimlar	dʒ ɪ˥ m l aː˩ r
jimɓirɓir	dʒ ɪ˩ m ɓ ɪ˩ r ɓ ɪ˩ r
jin	dʒ ɪ˥ ŋ
jina	dʒ ɪ˥ n aː˩
jing	dʒ ɪ˥ ŋ
jini	dʒ ɪ˥ n iː˥
jinin	dʒ ɪ˥ n ɪ˥ ŋ
jinkiri	dʒ ɪ˥ ɲ c ɪ˩ r iː˥
jinkirta	dʒ ɪ˥ ɲ c ɪ˥ r t aː˩
jinsi	dʒ ɪ˥ n s iː˩
jintao	dʒ ɪ˥ n t ə˩ o˥
jira	dʒ ɪ˥ r aː˥
jirage	dʒ ɪ˥ r ə˥ ɟ eː˥
jiragen	dʒ ɪ˥ r ə˥ ɟ eː˥ ŋ
jiran	dʒ ɪ˥ r a˩ ŋ
jiranmu	dʒ ɪ˥ r a˩ n m uː˩
jiransu	dʒ ɪ˥ r a˥ n s ɪ˩
jirgi	dʒ ɪ˥ ɽ ɟ iː˥
jirgin	dʒ ɪ˥ ɽ ɟ ɪ˩ ŋ
jirkitar	dʒ ɪ˥ ɽ c ɪ˥ t a˩ r
jituwa	dʒ ɪ˥ t ʊ˥ w aː˥
jituwar	dʒ ɪ˥ t ʊ˥ w a˥ r
jiu	dʒ ɪ˩ uː˩
jiya	dʒ ɪ˩ j aː˥
jiyya	dʒ ɪ˥ j aː˩
jiyyan	dʒ ɪ˥ j ŋ
joan	dʒ a˩ a˥ ŋ
joe	dʒ a˩ eː˩
john	dʒ aː˩ ŋ
johnson	dʒ ʊ˩ h n s ɔ˩ ŋ
jonathan	dʒ a˩ n ə˥ t h a˥˦ ŋ
jones	dʒ a˩ n eː˥ s
jordan	dʒ a˩ r d a˥˦ ŋ
jos	dʒ a˩ s
jugum	dʒ ɪ˩ ɡʷ ʊ˥ m
juma'a	dʒ ɪ˥ m ə˥ ʔ aː˩
jumblatt	dʒ ɪ˥ m b l aː˩ t
jumhuriyar	dʒ ɪ˥ m h uː˥ r ɪ˥ j ɛ˥ r
jumma'a	dʒ ɪ˥ m ə˥ ʔ aː˩
jummai	dʒ ɪ˥ m aj˥
jummaiamu	dʒ ɪ˥ m aj˥ aː˥ m ʊ˩
jun	dʒ ɪ˥ ŋ
juna	dʒ ʊ˩ n aː˥
juna'	dʒ ʊ˩ n aː˥ ʔ
junansu	dʒ ʊ˩ n aː˥ n s ɪ˩
jundullah	dʒ ʊ˩ n d ɪ˩ l aː˩
junichiro	dʒ ʊ˩ n ɪ˥ tʃ ɪ˥ ɽ oː˩
jure	dʒ ɪ˥ ɽ eː˥
jurewa	dʒ ɪ˥ ɽ eː˥ w aː˥
juwa	dʒ ʊ˩ w aː˥
juya	dʒ ɪ˥ j aː˩
juyi	dʒ ɪ˥ j iː˥
juyin	dʒ ɪ˥ j ɪ˩ ŋ
juyo	dʒ ɪ˥ j oː˥˦
juzu'i	dʒ ɪ˥ z ɪ˩ ʔ iː˥
ka	k aː˩
ka'ida	k aː˥ ʔ ɪ˥ d aː˩
ka'idar	k aː˥ ʔ ɪ˥ d aː˩ r
ka'idodi	k aː˥ ʔ ɪ˥ d oː˩ d iː˩
ka'idoji	k aː˥ ʔ ɪ˥ d oː˩ dʒ iː˥
ka'idojin	k aː˥ ʔ ɪ˥ d oː˩ dʒ ɪ˩ ŋ
kabaran	k ə˥ b ə˩ r a˥˦ ŋ
kabari	k ə˥ b ə˩ r iː˥
kabarin	k ə˥ b ə˩ r ɪ˥ ŋ
kaberuka	k ə˩ b eː˥ ɽ ɪ˥ k aː˩
kabet	k ə˩ b eː˥ t
kabewa	k ə˩ b eː˥ w aː˩
kabila	k ə˩ b iː˥ l aː˩
kabilanci	k ə˩ b iː˥ l a˥ n tʃ iː˥
kabilar	k ə˩ b iː˥ l a˩ r
kabilu	k ə˩ b iː˥ l ɪ˩
kabilun	k ə˩ b iː˥ l ɪ˩ ŋ
kaburbura	k ə˩ b ʊ˩ r b uː˥ ɽ aː˩
kaburburan	k ə˩ b ʊ˩ r b ʊ˩ r a˩ ŋ
kaca	k ə˥ tʃ aː˩
kacal	k ə˥ tʃ a˩ l
kace	k ə˥ tʃ eː˩
kaciya	k aː˩ tʃ ɪ˥ j aː˩
kacokan	k ə˥ tʃ oː˥ k a˩ ŋ
kada	k ə˥ d aː˥
kadada	k ə˥ d aː˥ d aː˩
kadai	k ə˥ d aj˥
kadaici	k ə˥ d aj˥ tʃ iː˥
kadan	k aː˩ d a˥˦ ŋ
kadari	k ə˥ d ə˩ r iː˥
kaddamar	k a˥ d ə˩ m a˩ r
kaduna	k ə˩ d uː˥ n ə˥
kaf	k a˥ p
kafa	k ə˥ ɸ aː˥
kafa	k ə˥ ɸ aː˩
kafada	k aː˩ ɸ ə˥ d aː˩
kafadar	k ə˥ ɸ aː˥ d aː˩ r
kafafen	k ə˥ ɸ aː˥ ɸ ɛ˥ ŋ
kafafu	k ə˥ ɸ aː˥ ɸ ʊ˩
kafafunsa	k ə˥ ɸ aː˥ ɸ ʊ˩ n s aː˩
kafafuwana	k ə˥ ɸ aː˥ ɸ ʊ˩ w aː˥ n aː˩
kafar	k ə˥ ɸ a˩ r
kafarsa	k ə˥ ɸ a˩ r aː˩
kafaɗa	k aː˩ ɸ ə˥ ɗ aː˩
kafaɗar	k aː˩ ɸ ə˥ ɗ aː˩ r
kafe	k ə˥ ɸ eː˩
kafin	k aː˩ ɸ ɪ˩ ŋ
kafirce	k aː˥ ɸ ɪ˩ r tʃ eː˩
kafiri	k aː˥ ɸ ɪ˩ r iː˥
kafofin	k ə˥ ɸ oː˥ ɸ ɪ˩ ŋ
kaftin	k aː˩ ɸ t ɪ˩ ŋ
kafu	k aː˥ ɸ ʊ˩
kafuor	k aː˥ ɸ ʊ˩ oː˥ r
kafur	k aː˥ ɸ ʊ˩ r
kafuwar	k aː˥ ɸ ʊ˩ w a˥ r
kaga	k aː˥ ɡ aː˥
kagaggen	k ə˩ ɡ ə˩ ɡ ɟ eː˥ ŋ
kagame	k ə˥ ɡ a˥ m eː˩
kago	k ə˥ ɡʷ oː˥
kahonsu	k aː˥ h oː˩ n s ɪ˩
kahonta	k aː˥ h oː˩ n t aː˥
kahuhu	k ə˥ h ʊ˥ h ʊ˥
kai	k aj˥
kaidi	k aj˥ d iː˩
kaidojin	k aj˥ d oː˥ dʒ ɪ˩ ŋ
kaifi	k aj˥ ɸ iː˥
kaigama	k aj˥ ɡ ə˥ m ə˩
kaimi	k aj˥ m iː˥
kaina	k aj˥ n aː˩
kaini	k aj˥ n ɪ˩
kairo	k aj˥ r ɔ˩
kaita	k aj˥ t ə˥
kaiwa	k aj˥ w aː˥
kaji	k a˥ dʒ iː˥
kajin	k aː˥ dʒ ɪ˩ ŋ
kaka	k aː˩ k aː˥
kaka	k aː˩ k ə˥
kakaki	k aː˩ k aː˩ c iː˥
kakakin	k aː˩ k aː˥ c ɪ˩ ŋ
kakan	k aː˩ k a˩ ŋ
kakana	k aː˩ k aː˥ n aː˩
kakanin	k aː˩ k aː˩ n ɪ˥ ŋ
kakar	k aː˩ k a˩ r
kake	k ə˩ c eː˥
kala	k ə˩ l aː˥
kalami	k ə˩ l aː˥ m iː˩
kalandar	k ə˩ l a˩ n d a˥˦ r
kalar	k ə˩ l a˩ r
kalilan	k ə˩ l iː˥ l a˥˦ ŋ
kalimar	k ə˩ l iː˥ m a˩ r
kalla	k a˥ l aː˩
kalle	k a˥ l eː˥
kalleni	k a˥ l eː˥ n iː˩
kalli	k a˥ l iː˥
kallo	k a˥ l oː˥
kallon	k a˥ l ɔ˩ ŋ
kalma	k a˥ l m aː˩
kalmar	k a˥ l m ə˥ r
kalmomi	k a˥ l m oː˥ m iː˥
kalmomin	k a˥ l m oː˥ m ɪ˥ ŋ
kalmomini	k a˥ l m oː˥ m iː˥ n iː˩
kaltibeta	k a˥ l t ɪ˩ b eː˥ t aː˩
kalubalantar	k a˥ l uː˥ b ə˩ l a˩ n t a˩ r
kalubale	k a˥ l uː˥ b ə˩ l e˥
kalubalen	k a˥ l uː˥ b ə˩ l e˥ ŋ
kam	k a˥ m
kama	k aː˥ m aː˩
kamala	k ə˩ m aː˥ l aː˩
kaman	k a˥ m a˩ ŋ
kamannin	k a˥ m a˥ n ɪ˥ ŋ
kamar	k a˥ m ə˩ r
kamarsu	k a˥ m a˥ ɽ uː˥
kamaru	k ə˩ m ə˩ r ɪ˥
kamasho	k aː˥ m ə˩ ʃ o˥
kamata	k a˥ m ə˥ t aː˩
kamaya	k a˥ m aː˩ j aː˥
kambi	k a˥ m b iː˥
kambun	k a˥ m b ʊ˩ ŋ
kame	k a˥ m eː˩
kamewa	k a˥ m eː˥ w aː˩
kamfani	k a˥ m ɸ a˩ n iː˥
kamfanin	k a˥ m ɸ aː˩ n ɪ˥ ŋ
kamfaninmu	k a˥ m ɸ a˩ n iː˥ n m uː˩
kamfannonin	k a˥ m ɸ aː˩ n oː˥ n ɪ˥ ŋ
kamfanonin	k a˥ m ɸ aː˩ n oː˥ n ɪ˥ ŋ
kamfanunuwa	k a˥ m ɸ aː˩ n ɪ˩ n ʊ˥ w aː˥
kamfas	k a˥ m ɸ a˩ s
kamili	k aː˥ m ɪ˩ l iː˥
kammala	k a˥ m ə˩ l aː˥
kammalawa	k a˥ m ə˩ l aː˥ w aː˥
kammar	k a˥ m a˩ r
kampala	k a˥ m p ə˩ l aː˩
kamshi	k a˥ m ʃ iː˥
kamshin	k a˥ m ʃ ɪ˥ ŋ
kamu	k aː˥ m ʊ˩
kamun	k aː˥ m ʊ˩ ŋ
kamuwa	k a˥ m ʊ˥ w aː˥
kan	k a˩ ŋ
kana	k ə˥ n ə˥
kanada	k ə˥ n ə˥ d aː˩
kanal	k ə˥ n a˩ l
kanana	k ə˥ n ə˥ n ə˥
kananan	k ə˥ n ə˥ n a˩ ŋ
kanar	k ə˥ n a˩ r
kandu	k a˥ n d uː˥
kangiya	k ɛ˥ ɲ ɟ ɪ˩ j aː˥
kango	k a˥ ŋ ɡʷ oː˥
kanka	k a˥ ŋ k aː˥
kankama	k a˥ ŋ k aː˥ m aː˩
kankara	k a˥ ŋ k aː˥ r aː˩
kankare	k a˥ ŋ k aː˥ r e˩
kanki	k ə˥ n c iː˩
kankiya	k ə˥ n c ɪ˥ j aː˩
kanku	k a˩ ŋ kʷ ʊ˩
kanmu	k a˩ n m uː˩
kanne	k a˥ n eː˩
kano	k ə˥ n oː˩
kansa	k a˥ n s ə˩
kansar	k a˥ n s a˩ r
kanshi	k ə˥ n ʃ iː˥
kansu	k a˥ n s ɪ˩
kanta	k a˥ n t aː˥
kanta	k a˥ n t aː˩
kantarki	k a˥ n t aː˥ ɽ c ɪ˥
kanti	k a˩ n t iː˥
kantin	k a˥ n t ɪ˥ ŋ
kantuna	k a˥ n t ɪ˩ n aː˩
kanumfari	k ə˩ n ɪ˥ m ɸ ə˩ r iː˥
kanun	k ə˩ n ɪ˥ ŋ
kar	k a˥ r
kara	k ə˩ r aː˥
karafa	k ə˩ r aː˥ ɸ aː˩
karagar	k ə˥ r ə˩ ɡ ə˩ r
karahiya	k ə˩ r aː˥ h ɪ˥ j aː˩
karaji	k ə˩ r aː˥ dʒ iː˩
karama	k ə˩ r aː˥ m aː˩
karamar	k ə˩ r aː˥ m ə˩ r
karamcin	k ə˩ r aː˥ m tʃ ɪ˩ ŋ
karami	k ə˩ r aː˥ m iː˩
karamin	k ə˩ r aː˥ m ɪ˩ ŋ
karan	k ə˥ r a˩ ŋ
karanci	k ə˩ r a˥ n tʃ iː˥
karancin	k ə˥ r a˥ n tʃ ɪ˩ ŋ
karanta	k ə˥ r a˩ n t aː˥
karantawa	k ə˩ r a˥ n t aː˥ w aː˥
karar	k ə˥ r a˩ r
kararrawa	k ə˩ r a˥ r a˩ w aː˥
karasa	k ə˩ r aː˥ s aː˩
karate	k ə˩ r aː˥ t e˥
karatu	k ə˥ r ə˥ t ɪ˩
karatun	k ə˩ r aː˥ t ɪ˥ ŋ
karatuna	k ə˩ r aː˥ t ɪ˩ n aː˩
karawa	k ə˩ r aː˥ w aː˥
karba	k a˥ ɽ b aː˩
karbar	k a˥ ɽ b a˩ r
karbe	k a˥ r b e˩
karbi	k a˥ r b iː˥
karbuwa	k a˥ r b ʊ˥ w aː˥
kare	k ə˩ ɽ eː˥
karen	k a˥ ɽ eː˥ ŋ
karensa	k ə˩ ɽ eː˥ n s aː˩
karewa	k ə˩ ɽ eː˥ w aː˥
karfafa	k a˥ r ɸ aː˥
karfafawa	k a˥ r ɸ aː˥ w aː˥
karfe	k a˥ r ɸ eː˩
karfi	k a˥ ɽ ɸ iː˥
karfin	k a˥ r ɸ ɪ˩ ŋ
karfinsu	k a˥ r ɸ ɪ˥ n s ɪ˩
karfinta	k a˥ r ɸ ɪ˥ n t aː˩
kari	k ə˩ r iː˥
karimi	k ə˩ r iː˥ m iː˩
karin	k ə˩ r ɪ˥ ŋ
kariya	k ə˩ r ɪ˥ j ɛ˩
kariyar	k ə˩ r ɪ˥ j ɛ˥ r
karkanda	k a˥ r k a˩ n d ə˩
karkara	k a˥ r k ə˩ ɽ ə˩
karkarar	k a˥ r k ə˥ r a˩ r
karkashin	k a˥ r k ə˩ ʃ ɪ˥˦ ŋ
karkato	k a˥ r k ə˥ t o˥
karku	k a˥ r kʷ ʊ˩
karni	k a˥ r n iː˩
karnin	k a˥ r n ɪ˥ ŋ
karnuka	k a˥ r n ɪ˥ k aː˩
karnukan	k a˥ r n ɪ˥ k a˩ ŋ
karnukansu	k a˥ r n uː˥ k aː˩ n s ɪ˩
karo	k aː˥ ɽ oː˩
karon	k a˥ r ɔ˩ ŋ
karshe	k a˥ ɽ ʃ e˩
karshen	k a˥ ɽ ʃ e˩ ŋ
karshenta	k a˥ ɽ ʃ e˩ n t aː˥
karta	k a˥ r t aː˩
karu	k ə˩ r uː˥
karuwa	k aː˥ r ʊ˩ w ə˩
karuwar	k a˥ ɽ ʊ˥ w a˥ r
karya	k a˥ ɽ j aː˥
karyata	k a˥ ɽ j aː˥ t aː˩
karye	k a˥ r j eː˥
karɓa	k a˥ r ɓ ə˥
karɓan	k a˥ r ɓ a˩ ŋ
karɓar	k a˥ r ɓ a˩ r
karɓeta	k a˥ r ɓ eː˩ t aː˩
karɓi	k a˥ r ɓ ɪ˩
kasa	k aː˥ s aː˩
kasahen	k ə˥ s ə˩ h eː˥ ŋ
kasaita	k ə˥ s aj˥ t ə˥
kasaitaccen	k ə˥ s aj˥ t ə˥ tʃ eː˩ ŋ
kasala	k ə˥ s ə˩ l aː˩
kasan	k aː˥ s a˩ ŋ
kasance	k ə˥ s a˥ n tʃ eː˩
kasancewa	k ə˥ s a˥ n tʃ eː˥ w aː˩
kasancewarsa	k ə˥ s a˥ n tʃ eː˥ w a˥ r s aː˥
kasar	k aː˥ s a˩ r
kasarmu	k ə˥ s ə˩ r m uː˩
kasarsa	k aː˥ s a˩ r aː˩
kasarsu	k aː˥ s a˩ r uː˩
kasarta	k ə˥ s a˥ r t aː˩
kasashe	k ə˥ s ə˩ ə˥ ʃ e˥
kasashen	k ə˥ s ə˩ ʃ eː˩ ŋ
kasat	k aː˥ s a˩ t
kashashen	k ə˥ ʃ ə˥ ʃ e˥ ŋ
kashe	k ə˥ ʃ e˥
kashegari	k ə˥ ʃ eː˩ ɡ ə˩ r iː˥
kashenin	k ə˥ ʃ eː˩ n ɪ˥ ŋ
kashewa	k ə˩ ʃ eː˩ w aː˥
kashi	k ə˩ ʃ iː˥
kashin	k ə˩ ʃ ɪ˥˦ ŋ
kasko	k a˥ s kʷ oː˥
kassim	k ə˥ s ə˩ s ɪ˩ m
kasu	k ə˩ s ɪ˥
kasuwa	k aː˩ s ʊ˥ w aː˥
kasuwan	k aː˩ s ʊ˥ w a˩ ŋ
kasuwanci	k aː˩ s ʊ˥ w a˥ n tʃ iː˥
kasuwancin	k aː˩ s ʊ˥ w a˥ n tʃ ɪ˩ ŋ
kasuwancinsa	k aː˩ s ʊ˥ w a˥ n tʃ iː˩ n s aː˩
kasuwanni	k aː˩ s ʊ˥ w a˥ n iː˩
kasuwannin	k aː˩ s ʊ˥ w a˥ n ɪ˥ ŋ
kasuwar	k aː˩ s ʊ˥ w a˥ r
katagum	k ə˥ t aː˥ ɡʷ ʊ˩ ŋ
katako	k ə˥ t aː˥ kʷ oː˩
katanga	k ə˥ t a˩ ŋ ɡ aː˥
katangar	k aː˥ t a˥ ŋ ɡ a˥ r
kathy	k aː˥ t h j
kati	k aː˥ t iː˩
katibi	k aː˥ t ɪ˩ b iː˥
katifa	k ə˩ t iː˥ ɸ aː˩
katin	k aː˥ t ɪ˩ ŋ
katolika	k aː˥ t oː˩ l ɪ˩ k aː˥
katon	k aː˥ t a˥ ŋ
katsahan	k ə˩ sʼ ə˥ h a˩ ŋ
katsina	k ə˩ sʼ ɪ˥ n ə˩
katunan	k aː˩ t uː˩ n a˥˦ ŋ
kau	k aw˥
kauce	k aw˥ tʃ eː˩
kaucewa	k aw˥ tʃ eː˥ w aː˩
kauci	k aw˥ tʃ iː˩
kauda	k aw˥ d aː˩
kauna	k aw˥ n aː˩
kaunar	k aw˥ n a˩ r
kaunarsa	k aw˥ n a˩ r aː˩
kaunarsu	k aw˥ n a˩ r uː˩
kaura	k aw˥ r aː˩
kaurar	k aw˥ r a˩ r
kauri	k aw˥ ɽ iː˥
kaushi	k aw˥ ʃ iː˥
kauye	k aw˥ j eː˩
kauyensa	k aw˥ j eː˩ n s aː˩
kauyuka	k aw˥ j uː˥ k aː˩
kauyukan	k aw˥ j uː˥ k a˩ ŋ
kawa	k aː˥ w aː˥
kawai	k ə˥ w aj˩
kawance	k ə˥ w a˥ n tʃ eː˩
kawancen	k ə˥ w a˥ n tʃ eː˩ ŋ
kawar	k ə˥ w a˥ r
kawo	k aː˩ w oː˩
kawowa	k aː˩ w oː˥ w aː˩
kawu	k aː˥ w ʊ˩
kawu	k aː˩ w ʊ˥
kawuna	k aː˥ w ʊ˩ n aː˥
kaya	k aː˩ j aː˥
kayan	k aː˩ j ŋ
kayana	k aː˩ j aː˥ n aː˩
kayansa	k aː˩ j aː˥ n s aː˩
kayatar	k aː˩ j aː˥ t a˩ r
kayatarwa	k aː˩ j aː˥ t a˥ ɽ w aː˥
kayayyaki	k aː˩ j ɛ˥ j aː˩ c iː˥
kayayyakin	k aː˩ j ɛ˥ j aː˥ c ɪ˩ ŋ
kayayyakinsu	k aː˩ j ɛ˥ j aː˥ c ɪ˩ n s ɪ˩
kayi	k aː˩ j iː˥
kayyadde	k aː˩ j d e˩
kayyade	k aː˩ j d eː˩
kaza	k aː˩ z aː˥
kazaf	k ə˥ z a˩ ɸ
kazak	k ə˥ z ə˥ k
kazalika	k aː˩ z aː˥ l ɪ˩ k aː˥
kazamin	k ə˩ z aː˥ m ɪ˩ ŋ
kazaure	k ə˩ z aw˥ ɽ e˥
kaɗa	k ə˥ ɗ aː˩
kaɗai	k ə˥ ɗ aj˥
kaɗaitaka	k ə˥ ɗ aj˥ t ə˥ k aː˩
kaɗan	k ə˥ ɗ a˥˦ ŋ
kaɗanya	k ə˥ ɗ ɛ˥ ɲ j aː˩
kaɗawa	k ə˥ ɗ aː˥ w aː˥
kaɗo	k aː˥ ɗ o˩
ke	c eː˥
kebe	c eː˥ b e˩
kek	c eː˥ k
keke	c eː˥ c eː˥
keken	c eː˥ c eː˥ ŋ
kekuna	c eː˥ kʷ ʊ˩ n aː˥
kekunan	c eː˥ c uː˩ n a˥˦ ŋ
ken	c eː˥ ŋ
kenan	c eː˥ n a˥˦ ŋ
kenya	c eː˥ ɲ j aː˩
kera	c eː˥ ɽ aː˩
keso	c eː˥ s oː˩
ketaifu	c eː˥ t aj˥˦ ɸ ʊ˩
ketare	c eː˥ t aː˥ r e˩
kewa	c eː˥ w aː˩
kewar	c eː˥ w a˥ r
kewarka	c eː˥ w a˥ r k aː˩
kewaya	c eː˥ w ɛ˥ j aː˩
kewaye	c eː˥ w aː˩ j eː˥
kewayen	c eː˥ w aː˩ j eː˥ ŋ
kewayensa	c eː˥ w aː˩ j eː˥ n s aː˩
keɓancewa	c eː˥ ɓ a˥ n tʃ eː˥ w aː˩
keɓe	c eː˥ ɓ e˩
khalifat	kʷ h a˥ l ɪ˩ ɸ a˥ t
khartoum	kʷ h a˥ r t oː˩ ʊ˩ ŋ
ki	c iː˥
kibiya	c ɪ˥ b ɪ˥ j aː˩
kibiya	c ɪ˥ b ɪ˥ j ɛ˩
kibiyar	c ɪ˥ b ɪ˥ j ɛ˥ r
kibiyoyi	c ɪ˥ b ɪ˥ j oː˩ j ɪ˥
kida	c iː˥ d aː˩
kidan	c ɪ˩ d a˥˦ ŋ
kidayar	c ɪ˩ d aː˥ j ɛ˥ r
kide	c ɪ˥ d e˩
kifa	c ɪ˥ ɸ aː˩
kifaye	c ɪ˥ ɸ aː˩ j eː˥
kife	c ɪ˥ ɸ eː˩
kifi	c iː˥ ɸ iː˥
kifin	c ɪ˥ ɸ ɪ˩ ŋ
kika	c ɪ˥ k aː˩
kike	c ɪ˥ c eː˥
kila	c ɪ˩ l ə˩
kili	c ɪ˩ l iː˥˦
kilishi	c ɪ˥ l ɪ˩ ʃ iː˥
kilo	c ɪ˩ l oː˩
kilomita	c ɪ˩ l oː˩ m ɪ˥ t ə˩
kima	c ɪ˥ m aː˩
kimanin	c ɪ˥ m aː˩ n ɪ˥ ŋ
kimantawa	c ɪ˥ m a˥ n t aː˥ w aː˥
kimiyya	c ɪ˥ m ɪ˥ j aː˩
kimiyyar	c ɪ˥ m ɪ˥ j ɛ˥ r
kimsa	c ɪ˥ m s aː˩
kin	c ɪ˥ ŋ
kina	c ɪ˥ n aː˩
kindirmo	c ɪ˩ n d ɪ˩ r m oː˥
king	c ɪ˥ ŋ
kinshasha	c ɪ˥ n s h ə˥ ʃ ə˩
kira	c ɪ˥ r aː˥
kiran	c ɪ˥ r a˩ ŋ
kirana	c ɪ˥ r aː˥ n aː˩
kiransa	c ɪ˥ r a˥ n s ə˩
kiranshi	c ɪ˥ r a˥ n s h iː˩
kiransu	c ɪ˥ r a˥ n s ɪ˩
kiranta	c ɪ˥ r a˥ n t aː˩
kirar	c ɪ˥ r a˩ r
kirari	c ɪ˥ r ə˩ r iː˥
kirga	c ɪ˥ r ɡ aː˥
kirgiz	c ɪ˥ ɽ ɟ iː˥ z
kirista	c ɪ˥ r ɪ˥ s t aː˩
kirji	c ɪ˩ ɽ dʒ iː˥
kirjin	c ɪ˩ ɽ dʒ ɪ˩ ŋ
kirjina	c ɪ˩ ɽ dʒ ɪ˥ n aː˩
kirjinka	c ɪ˩ ɽ dʒ ɪ˩ ŋ k aː˥
kirki	c ɪ˥ ɽ c ɪ˥
kirkirar	c ɪ˥ ɽ c ɪ˥ r a˩ r
kirkiro	c ɪ˥ ɽ c ɪ˥ ɽ oː˩
kirsimati	c ɪ˥ r s ɪ˩ m ə˥ t ɪ˩
kirsimeti	c ɪ˥ r s ɪ˩ m a˥ t iː˩
kirtani	c ɪ˥ r t aː˥ n iː˩
kirtif	c ɪ˩ ɽ t ɪ˥ p
kisa	c ɪ˥ s aː˩
kisan	c ɪ˥ s a˩ ŋ
kishi	c ɪ˥ ʃ iː˥
kishin	c ɪ˥ ʃ ɪ˥ ŋ
kishirwa	c ɪ˥ ʃ ɪ˥ ɽ w aː˥
kissa	c ɪ˥ s ə˩
kissar	c ɪ˥ s a˩ r
kitty	c ɪ˥ t iː˩
kiwo	c iː˥ w oː˩
kiwon	c iː˥ w oː˩ ŋ
kiyama	c ɪ˩ j aː˥ m aː˩
kiyaye	c ɪ˩ j aː˩ j eː˥
kiɗa	c ɪ˥ ɗ aː˩
kiɗan	c ɪ˥ ɗ a˥˦ ŋ
ko	kʷ oː˥
kocin	kʷ oː˥ tʃ ɪ˩ ŋ
koda	kʷ oː˥ d aː˩
kodayake	kʷ oː˥ d aː˩ j ɛ˥ c eː˥
kofa	kʷ oː˥ ɸ aː˩
kofar	kʷ oː˥ ɸ a˩ r
kofi	kʷ oː˥ ɸ iː˩
kofi	kʷ oː˩ ɸ iː˥
kofin	kʷ oː˥ ɸ ɪ˩ ŋ
kofofin	kʷ oː˥ ɸ oː˥ ɸ ɪ˩ ŋ
kofur	kʷ oː˥ ɸ ʊ˩ r
kogi	kʷ oː˩ ɟ iː˥
kogin	kʷ oː˩ ɟ ɪ˩ ŋ
kogo	kʷ oː˥ ɡʷ o˥
kogon	kʷ oː˩ ɟ ɔ˩ ŋ
koguna	kʷ oː˥ ɡʷ ʊ˩ n aː˥
kogunan	kʷ oː˩ ɟ uː˩ n a˥˦ ŋ
kohin	kʷ oː˥ h ɪ˥ ŋ
koka	kʷ oː˥ k aː˩
kokari	kʷ oː˥ k ə˩ r iː˥
kokarin	kʷ oː˥ k ə˩ ɽ ɪ˥ ŋ
kokarinmu	kʷ oː˥ k ə˩ r iː˥ n m uː˩
kokarinsa	kʷ oː˥ k ə˩ r iː˥ n s aː˩
kokarinsu	kʷ oː˥ k ə˩ r iː˥ n s ɪ˩
kokarinta	kʷ oː˥ k ə˩ r iː˥ n t aː˥
kokawa	kʷ oː˥ k aː˥ w aː˥
koken	kʷ oː˥ c eː˥ ŋ
koko	kʷ oː˥ kʷ o˥
koko	kʷ oː˩ kʷ oː˥
kokuma	kʷ oː˥ kʷ uː˥ m aː˩
kolejin	kʷ oː˥ l eː˥ dʒ ɪ˩ ŋ
kolejoji	kʷ oː˥ l eː˥ dʒ ɔ˩ dʒ iː˥
kolera	kʷ oː˥ l eː˩ r aː˩
koli	kʷ oː˥ l iː˥
kolin	kʷ oː˥ l ɪ˩ ŋ
kolo	kʷ oː˥ l oː˥
koma	kʷ oː˥ m aː˥
komai	kʷ oː˥ m aj˥
komawa	kʷ oː˥ m aː˥ w aː˥
kome	kʷ oː˥ m eː˩
komfuta	kʷ oː˥ m ɸ uː˥ t aː˩
komi	kʷ oː˥ m iː˥
komo	kʷ oː˥ m oː˥
komowa	kʷ oː˥ m oː˥ w aː˩
konannen	kʷ oː˩ n a˥ n eː˩ ŋ
kone	kʷ oː˩ n e˥
kong	kʷ oː˥ ŋ
konni	kʷ oː˩ n iː˩
korafi	kʷ oː˥ r ə˩ ɸ iː˥
korar	kʷ oː˥ r a˩ r
kore	kʷ oː˥ r eː˩
korea	kʷ oː˩ ɽ eː˥ aː˩
koren	kʷ oː˩ ɽ eː˥ ŋ
kori	kʷ oː˥ r iː˩
koriya	kʷ oː˥ r ɪ˥ j aː˩
kos	kʷ a˥˦ s
koshin	kʷ oː˥ ʃ ɪ˥ ŋ
kotu	kʷ oː˥ t ɪ˩
kotun	kʷ oː˥ t ɪ˩ ŋ
kowa	kʷ oː˥ w aː˩
kowace	kʷ oː˥ w aː˩ tʃ eː˩
kowai	kʷ oː˥ w aj˩
kowande	kʷ oː˥ w aː˥ n d e˩
kowane	kʷ oː˥ w aː˥ n e˥
kowanen	kʷ oː˥ w aː˥ n eː˥ ŋ
kowanensu	kʷ oː˥ w aː˥ n ɛ˥ n s ɪ˩
kowani	kʷ oː˥ w aː˥ n iː˩
kowanne	kʷ oː˥ w aː˥ n e˥
koya	kʷ oː˩ j aː˩
koyar	kʷ oː˩ j ɛ˥ r
koyarwa	kʷ oː˩ j ɛ˩ ɽ w aː˥
koyaushe	kʷ oː˩ j aw˥ ʃ eː˩
koyawa	kʷ oː˩ j aː˥ w aː˥
koyaya	kʷ oː˩ j ɛ˥ j aː˩
koyi	kʷ oː˩ j ɪ˥
koyo	kʷ oː˩ j oː˥˦
koyon	kʷ oː˩ j ɔ˩ ŋ
ku	kʷ ʊ˩
kubbi	kʷ ʊ˥ b ɪ˩
kubutar	kʷ ʊ˥ b uː˥ t a˩ r
kucaki	kʷ ʊ˩ tʃ aː˥ c iː˥
kudade	kʷ ʊ˥ d ə˩ d e˩
kudaden	kʷ ʊ˥ d ə˥ d eː˩ ŋ
kudadenta	kʷ ʊ˥ d ə˥ d eː˩ n t aː˥
kudaje	kʷ ʊ˥ d aː˥ dʒ e˩
kudancin	kʷ ʊ˥ d a˥ n tʃ ɪ˩ ŋ
kuddin	kʷ ʊ˥ d ɪ˩ ŋ
kudi	kʷ ʊ˥ d iː˩
kudin	kʷ ʊ˥ d ɪ˩ ŋ
kudinta	kʷ ʊ˥ d ɪ˥ n t aː˩
kudu	kʷ ʊ˥ d ɪ˩
kuduri	kʷ ʊ˥ d ɪ˩ r iː˥
kudurin	kʷ ʊ˥ d ɪ˩ r ɪ˥ ŋ
kufai	kʷ ʊ˥ ɸ aj˥
kuge	kʷ ʊ˩ ɟ eː˥
kujera	kʷ ʊ˩ dʒ eː˥ r aː˩
kujerar	kʷ ʊ˩ dʒ eː˥ r a˩ r
kuka	kʷ ʊ˥ k aː˩
kukan	kʷ ʊ˥ k a˩ ŋ
kuke	kʷ uː˥ c eː˥
kukis	kʷ uː˥ kʷ ɪ˥˦ s
kukuma	kʷ uː˥ kʷ uː˥ m aː˩
kula	kʷ ʊ˥ l aː˩
kulawa	kʷ ʊ˥ l aː˥ w aː˥
kulawar	kʷ ʊ˥ l aː˥ w a˥ r
kuliyoyi	kʷ ʊ˥ l ɪ˩ j oː˥˦ j iː˥
kulla	kʷ ʊ˥ l ə˩
kulle	kʷ ʊ˥ l eː˥
kullewa	kʷ ʊ˥ l eː˥ w aː˩
kullum	kʷ ʊ˥ l ɪ˥ ŋ
kullun	kʷ ʊ˥ l ɪ˥ ŋ
kuma	kʷ uː˥ m aː˩
kumallo	kʷ ʊ˩ m a˥ l oː˥
kumama	kʷ ʊ˩ m aː˥ m aː˥
kumbura	kʷ uː˥ m b uː˥ ɽ aː˩
kumsa	kʷ ʊ˩ m s aː˩
kun	kʷ ʊ˥ ŋ
kuna	kʷ ʊ˩ n aː˥
kunama	kʷ ʊ˩ n aː˥ m aː˩
kunar	kʷ ʊ˩ n aː˥ r
kunci	kʷ uː˥ n tʃ iː˥
kundin	kʷ ʊ˥ n d ɪ˩ ŋ
kungiya	kʷ ʊ˥ ɲ ɟ ɪ˩ j aː˥
kungiyar	kʷ ʊ˥ ɲ ɟ ɪ˩ j ɛ˥ r
kungiyoyi	kʷ ʊ˥ ɲ ɟ ɪ˩ j oː˥˦ j iː˥
kungiyoyin	kʷ ʊ˥ ɲ ɟ ɪ˩ j oː˩ j ɪ˥ ŋ
kungurmin	kʷ ʊ˥ ŋ ɡʷ ʊ˥ ɽ m ɪ˥ ŋ
kuni	kʷ ʊ˩ n iː˥˦
kunkuru	kʷ ʊ˥ ŋ kʷ ʊ˩ ɽ uː˥
kunlun	kʷ ʊ˥ n l ɪ˩ ŋ
kunna	kʷ ʊ˥ n aː˩
kunne	kʷ ʊ˥ n e˥
kunne	kʷ ʊ˥˦ n eː˥
kunnen	kʷ ʊ˥˦ n eː˥ ŋ
kunnuwa	kʷ ʊ˥ n ʊ˥ w aː˥
kunnuwan	kʷ ʊ˥ n ʊ˩ w a˥ ŋ
kunshe	kʷ ʊ˥ n ʃ eː˩
kunshi	kʷ ʊ˥ n ʃ iː˥
kunun	kʷ ʊ˩ n ɪ˩ ŋ
kunya	kʷ ʊ˥ ɲ j aː˥
kunya	kʷ ʊ˥ ɲ j aː˩
kura	kʷ uː˥ ɽ ə˥
kurai	kʷ ʊ˩ ɽ aj˥
kurakurai	kʷ ʊ˩ ɽ ə˩ kʷ ʊ˩ ɽ aj˥
kurakuran	kʷ ʊ˩ ɽ ə˩ kʷ ʊ˩ r a˩ ŋ
kurar	kʷ ʊ˩ ɽ r
kurciya	kʷ ʊ˥ ɽ tʃ ɪ˥ j aː˩
kuri'un	kʷ ʊ˩ ɽ ɪ˥ ʔ ʊ˩ ŋ
kurkuku	kʷ ʊ˥˦ r kʷ ʊ˥ kʷ uː˩
kurma	kʷ ʊ˥ ɽ m aː˥
kurmi	kʷ ʊ˥ ɽ m iː˩
kuruciya	kʷ ʊ˥ ɽ ɪ˥ tʃ ɪ˩ j aː˥
kurum	kʷ ʊ˩ ɽ ɪ˥ m
kururuwa	kʷ ʊ˥ ɽ ɪ˥ ɽ ʊ˥ w aː˥
kurwa	kʷ ʊ˩ ɽ w aː˥
kusa	kʷ ʊ˥ s ə˥
kusan	kʷ ʊ˥ s a˩ ŋ
kusantowar	kʷ ʊ˥ s a˥ n t oː˥ w a˥ r
kusheyin	kʷ ʊ˥ ʃ eː˩ j ɪ˩ ŋ
kuskure	kʷ ʊ˥ s kʷ ʊ˩ ɽ eː˥
kuskuren	kʷ ʊ˥ s kʷ ʊ˩ ɽ eː˥ ŋ
kuskus	kʷ ʊ˥ s kʷ ʊ˩ s
kusurwa	kʷ ʊ˥ s ɪ˩ ɽ w aː˥
kuwa	kʷ ʊ˥ w aː˥
kuwait	kʷ ʊ˥ w aj˩ t
kuzari	kʷ ʊ˩ z ə˩ r iː˥
kuzarin	kʷ ʊ˩ z ə˩ r ɪ˥ ŋ
kuɓewa	kʷ ʊ˥ ɓ eː˩ w aː˥
kuɗaɗe	kʷ ʊ˥ ɗ ə˩ ɗ eː˥
kuɗi	kʷ ʊ˥ ɗ iː˥
kuɗin	kʷ ʊ˥ ɗ ɪ˥ ŋ
kuɗinka	kʷ ʊ˥ ɗ ɪ˩ ŋ k aː˥
kuɗinsa	kʷ ʊ˥ ɗ iː˥ n s aː˩
kwa	kʷ aː˩
kwabar	kʷ ə˥ b a˩ r
kwabo	kʷ ə˥ b oː˩
kwabon	kʷ ə˥ b ɔ˩ ŋ
kwace	kʷ ə˥ tʃ eː˩
kwadago	kʷ ə˥ d ə˥ ɡʷ oː˥
kwado	kʷ aː˩ d oː˥
kwafi	kʷ aː˥ ɸ iː˩
kwafin	kʷ aː˩ ɸ ɪ˩ ŋ
kwai	kʷ aj˥
kwaikwayo	kʷ aj˩ kʷ aː˩ j oː˥˦
kwaikwayon	kʷ aj˩ kʷ aː˩ j ɔ˩ ŋ
kwakwa	kʷ ə˥ kʷ aː˩
kwakwalwa	kʷ ə˥ kʷ l w aː˩
kwal	kʷ a˥˦ l
kwala	kʷ ə˥ l aː˩
kwalaben	kʷ ə˥ l ə˩ b eː˥ ŋ
kwalban	kʷ ə˥ l b a˩ ŋ
kwalbar	kʷ ə˥ l b a˩ r
kwale	kʷ ə˥ l eː˩
kwaleji	kʷ ə˥ l eː˥ dʒ iː˥
kwalejin	kʷ ə˥ l eː˥ dʒ ɪ˩ ŋ
kwalejinsu	kʷ ə˥ l eː˥ dʒ ɪ˥ n s ɪ˩
kwalekwale	kʷ ə˩ l e˥ kʷ ə˩ l e˥
kwalen	kʷ ə˥ l eː˩ ŋ
kwalin	kʷ ə˥ l ɪ˩ ŋ
kwallan	kʷ ə˥ l a˥˦ ŋ
kwalliya	kʷ ə˥ l ɪ˥ j aː˩
kwallo	kʷ ə˥ l oː˥
kwallon	kʷ ə˥ l oː˥ ŋ
kwallonshi	kʷ ə˥ l oː˥ n ʃ iː˥
kwamandan	kʷ a˩ m a˥ n d a˩ ŋ
kwamfiyuta	kʷ a˩ m ɸ ɪ˩ j uː˥ t aː˩
kwamfuta	kʷ a˩ m ɸ uː˥ t aː˩
kwamfutar	kʷ a˩ m ɸ uː˥ t a˩ r
kwamfutoci	kʷ a˩ m ɸ uː˥ t oː˥ tʃ ɪ˩
kwamfutocin	kʷ a˩ m ɸ uː˥ t oː˥ tʃ ɪ˩ ŋ
kwamfyuta	kʷ a˩ m ɸ j uː˥ t aː˩
kwaminis	kʷ a˩ m iː˥ n ɪ˥˦ s
kwamishinar	kʷ aː˥ m ɪ˩ ʃ ɪ˥ n a˩ r
kwamitin	kʷ aː˥ m ɪ˩ t ɪ˥ ŋ
kwamitocin	kʷ aː˥ m ɪ˩ t oː˥ tʃ ɪ˩ ŋ
kwana	kʷ aː˥ n aː˩
kwanaki	kʷ aː˥ n aː˥ c iː˩
kwanakin	kʷ aː˥ n aː˥ c ɪ˩ ŋ
kwanan	kʷ ə˥ n a˩ ŋ
kwanar	kʷ ə˥ n a˩ r
kwanatar	kʷ aː˥ n ə˥ t a˩ r
kwance	kʷ a˥ n tʃ eː˩
kwanciya	kʷ a˥ n tʃ ɪ˩ j aː˥
kwanciyar	kʷ a˥ n tʃ ɪ˩ j ɛ˥ r
kwando	kʷ a˥ n d oː˩
kwandon	kʷ a˥ n d oː˩ ŋ
kwangila	kʷ aː˥ ɛ˥ ɲ ɟ ɪ˩ l ə˩
kwangilar	kʷ aː˥ ɛ˥ ɲ ɟ ɪ˩ l a˩ r
kwango	kʷ a˥ ŋ ɡʷ o˩
kwano	kʷ aː˥ n oː˩
kwanon	kʷ aː˥ n oː˩ ŋ
kwanta	kʷ a˥ n t aː˩
kwantar	kʷ a˩ n t a˩ r
kwanuka	kʷ aː˥ n ɪ˥ k aː˩
kwanyar	kʷ aː˥ ɛ˥ ɲ j ɛ˥ r
kwara	kʷ aː˥ ɽ ə˩
kwarai	kʷ ə˥ r aj˥
kwaram	kʷ ə˥ ɽ a˩ m
kwararowar	kʷ ə˥ r ə˩ r oː˥ w a˥ r
kwararre	kʷ aː˥ ɽ r eː˩
kwararren	kʷ aː˥ ɽ r eː˩ ŋ
kwararru	kʷ aː˥ ɽ r uː˥
kwararrun	kʷ aː˥ ɽ r ɪ˩ ŋ
kware	kʷ aː˥ ɽ eː˩
kwarewa	kʷ aː˥ ɽ eː˥ w aː˥
kwarewar	kʷ aː˥ ɽ eː˥ w a˥ r
kwarewarsu	kʷ aː˥ ɽ eː˥ w aː˥ ɽ s ɪ˩
kwari	kʷ ə˥ ɽ iː˥
kwarin	kʷ aː˥ ɽ ɪ˥ ŋ
kwariya	kʷ aː˥ ɽ ɪ˥ j aː˩
kwarjinin	kʷ aː˥ ɽ dʒ ɪ˥ n ɪ˥ ŋ
kwarya	kʷ ə˥ r j aː˩
kwaryar	kʷ ə˥ r j ɛ˥ r
kwashe	kʷ ə˥ ʃ e˥
kwashen	kʷ ə˥ ʃ eː˩ ŋ
kwaskwarima	kʷ a˥˦ s kʷ ə˥ r iː˥ m aː˩
kwaskwarimar	kʷ a˥˦ s kʷ ə˥ r iː˥ m a˩ r
kwastan	kʷ a˩ s t a˩ ŋ
kwat	kʷ aː˩ t
kwata	kʷ aː˩ t aː˩
kwatanta	kʷ aː˩ t a˥ n t aː˩
kwatsam	kʷ ə˥ sʼ a˩ m
kwaya	kʷ aː˩ j aː˥
kwayan	kʷ aː˩ j ŋ
kwayar	kʷ aː˩ j ɛ˥ r
kwayoyi	kʷ aː˩ j oː˩ j ɪ˥
kwayoyin	kʷ aː˩ j oː˩ j ɪ˥ ŋ
kwazo	kʷ aː˥ z oː˥
kwaɓin	kʷ ə˥ ɓ ɪ˩ ŋ
kwaɗo	kʷ aː˩ ɗ oː˥
kwaɗo	kʷ ə˥ ɗ o˩
kwiyat	kʷ ɪ˩ j ɛ˥˦ t
kya	c ɛ˥
kyabil	c ɛ˥ b ɪ˥˦ l
kyaftin	c ɛ˥ ɸ t ɪ˩ ŋ
kyakkyawa	c ɛ˥ c ɛ˥ w aː˥
kyakkyawan	c ɛ˥ c ɛ˥ w a˩ ŋ
kyakkyawar	c ɛ˥ c ɛ˥ w a˥ r
kyale	c ɛ˥ l eː˩
kyalle	c ɛ˥ l eː˥
kyallen	c ɛ˥ l eː˩ ŋ
kyamarar	c ɛ˥ m ə˩ r a˩ r
kyan	c ɛ˥ ŋ
kyanada	c ɛ˥ n ə˥ d ə˩
kyandira	c ɛ˥ n d ɪ˩ r aː˥
kyandiran	c ɛ˥ n d ɪ˩ r a˩ ŋ
kyanwa	c ɛ˥˦ m w aː˥
kyar	c ɛ˥ r
kyat	c ɛ˥˦ t
kyau	c aw˥˦
kyaun	c aw˥˦ ŋ
kyauta	c aw˥˦ t aː˩
kyautar	c aw˥˦ t a˩ r
kyautata	c aw˥˦ t aː˥ t aː˩
kyautatawa	c aw˥˦ t aː˩ t aː˥ w aː˥
kyautatta	c aw˥˦ t a˩ t aː˥
kyautatuwa	c aw˥˦ t aː˩ t ʊ˥ w aː˥
kyautatuwar	c aw˥˦ t aː˩ t ʊ˥ w a˥ r
kyautukan	c aw˥˦ t ɪ˥ k a˩ ŋ
kyaututtuka	c aw˥˦ t uː˥ t ɪ˥ k aː˩
kyaw	c ɛ˥ w
kyawawan	c ɛ˥ w aː˥ w a˥˦ ŋ
kyawun	c ɛ˥ w ʊ˩ ŋ
kyawunki	c ɛ˥ w ʊ˥ ɲ c iː˩
la	l aː˩
la'ada	l ə˩ ʔ a˥ d aː˩
la'akari	l ə˩ ʔ a˥ k ə˩ r iː˥
la'alla	l ə˩ ʔ a˥ l aː˩
la'asar	l ə˩ ʔ a˥ s a˩ r
la'asariyya	l ə˩ ʔ a˩ s ə˥ r ɪ˥ j aː˩
la'ifi	l ə˩ ʔ iː˥ ɸ iː˩
lab	l aː˩ b
laba	l aː˥ b aː˩
labanan	l aː˩ b ə˥ n a˩ ŋ
labarai	l aː˩ b ə˥ r aj˥
labaran	l ə˥ b ə˩ r a˥˦ ŋ
labari	l aː˩ b aː˥ r iː˩
labarin	l aː˩ b aː˥ r ɪ˩ ŋ
labarinta	l aː˩ b aː˥ r ɪ˥ n t aː˩
labaru	l aː˩ b aː˥ r uː˥
labarun	l aː˩ b aː˥ r ɪ˩ ŋ
labudda	l aː˩ b ʊ˥ d ə˩
lacca	l a˥ tʃ aː˩
laccar	l a˥ tʃ a˩ r
lada	l aː˥ d aː˥
ladabi	l ə˥ d ə˩ b iː˩
ladan	l aː˩ d a˥˦ ŋ
ladani	l aː˩ d aː˥ n iː˩
ladi	l aː˥ d ɪ˩
laditu	l aː˥ d ɪ˩ t ɪ˩
lafa	l ə˥ ɸ aː˩
lafazi	l ə˥ ɸ ə˩ z iː˥
lafi	l aː˥ ɸ iː˩
lafiya	l aː˥ ɸ ɪ˥ j aː˩
lafiyar	l aː˥ ɸ ɪ˥ j ɛ˥ r
lafiyarmu	l aː˥ ɸ ɪ˥ j aː˥ ɽ m uː˩
lafiyarsa	l aː˥ ɸ ɪ˥ j aː˥ ɽ s aː˥
lahadi	l ə˥ h a˩ d ɪ˩
lahani	l ə˥ h aː˥ n iː˩
lahanta	l ə˥ h a˩ n t aː˥
lahira	l aː˥ h ɪ˥ r aː˩
laifi	l aj˥˦ ɸ iː˥
laifin	l aj˥˦ ɸ ɪ˩ ŋ
laifinsa	l aj˥˦ ɸ iː˥ n s aː˩
laifinsu	l aj˥˦ ɸ iː˥ n s ɪ˩
laifuffukan	l aj˥˦ ɸ ʊ˩ ɸ ʊ˩ k a˩ ŋ
laifuka	l aj˥˦ ɸ ʊ˩ k aː˩
laifukan	l aj˥˦ ɸ ʊ˩ k a˩ ŋ
laima	l aj˥ m aː˩
laita	l aj˥ t aː˩
laka	l aː˥ k aː˥
laka	l ə˥ k aː˥
lakabi	l ə˥ k ə˩ b iː˥
lakabin	l ə˥ k ə˩ b ɪ˩ ŋ
lakcar	l ə˥ kʷ tʃ a˩ r
lakwaja	l ə˥ kʷ ə˥ dʒ ə˩
lalace	l ə˩ l aː˥ tʃ eː˩
lalacewa	l aː˥ l aː˩ tʃ eː˥ w aː˩
lalacewar	l aː˥ l aː˩ tʃ eː˥ w a˥ r
lalata	l aː˥ l aː˥ t aː˩
lale	l aː˥ l eː˩
lallacewar	l a˥ l aː˥ tʃ eː˥ w a˥ r
lallai	l a˥ l aj˥
lallausar	l a˥ l aw˩ s a˩ r
lallaɓa	l a˥ l aː˩ ɓ ə˥
lalle	l a˥ l eː˥
lalle	l a˥ l eː˩
lallodar	l a˥ l oː˥ d aː˩ r
lalo	l aː˥ l oː˩
lam	l a˥ ŋ
lama	l aː˥ m aː˩
lamarin	l ə˩ m ə˩ r ɪ˥ ŋ
lamba	l a˥ m b aː˩
lambar	l a˥ m b a˩ r
lambawan	l a˥ m b ə˥ w a˩ ŋ
lambobi	l a˥ m b oː˥ b iː˥
lambobin	l a˥ m b oː˥ b ɪ˩ ŋ
lambu	l a˩ m b uː˥
lambun	l a˥ m b ʊ˩ ŋ
lambuna	l a˥ m b uː˥ n aː˩
lambunan	l a˥ m b uː˩ n a˥˦ ŋ
lami	l aː˩ m iː˥˦
lamiam	l ə˩ m ɪ˥ a˥˦ ŋ
lamido	l ə˩ m iː˥ d oː˩
lamiri	l ə˩ m iː˥ r iː˩
lamirin	l ə˩ m iː˥ r ɪ˥ ŋ
lamuni	l a˥ m ʊ˩ n iː˩
lamuran	l a˥ m ʊ˩ r a˩ ŋ
landan	l a˥ n d a˩ ŋ
lang	l a˥ ŋ
lanka	l a˥ ŋ k aː˥
lantarki	l a˥ n t a˥ ɽ c ɪ˥
lao	l a˥ o˥
laraba	l aː˩ r ə˩ b aː˥
larabawa	l aː˩ r ə˩ b aː˥ w aː˥
larabci	l aː˩ r ə˩ b aː˥ tʃ iː˥
lardi	l a˥ r d iː˩
lardin	l a˥ r d ɪ˩ ŋ
larduna	l a˥ r d uː˥ n aː˩
lardunan	l a˥ r d uː˥ n a˩ ŋ
lare	l a˥ ɽ eː˩
laretu	l ə˩ ɽ eː˥ t ɪ˩
larura	l ə˩ r uː˥ r aː˩
las	l aː˥ s
lasa	l aː˥ s aː˩
lashe	l ə˥ ʃ e˥
lasin	l aː˥ s ɪ˩ ŋ
lasisi	l aː˥ s iː˥ s iː˩
lasisin	l aː˥ s iː˥ s ɪ˩ ŋ
laskofur	l a˥˦ s kʷ oː˥ ɸ ʊ˩ r
latin	l aː˩ t ɪ˥ ŋ
latsa	l aː˥ sʼ aː˩
latti	l a˥ t ɪ˥
launi	l aw˥ n iː˩
launin	l aw˥ n ɪ˥ ŋ
launinsu	l aw˥ n iː˥ n s ɪ˩
launuka	l aw˥ n ɪ˥ k aː˩
launukan	l aw˥ n ɪ˥ k a˩ ŋ
laushi	l aw˥ ʃ iː˥
lauya	l aw˥ j aː˩
lauyoyin	l aw˥ j oː˩ j ɪ˥ ŋ
lawur	l aː˥ w ʊ˥ ɽ
laya	l aː˥ j aː˩
layi	l aː˩ j iː˥
layin	l aː˥ j ɪ˩ ŋ
layinsa	l aː˥ j iː˥ n s aː˩
lazza	l a˥ z aː˩
league	l eː˩ ɡʷ ʊ˩ eː˩
lebanon	l eː˩ b aː˩ n oː˥ ŋ
lebur	l eː˩ b ʊ˥ r
leburin	l eː˩ b ʊ˩ r ɪ˥ ŋ
legas	l eː˥ ɡ a˩ s
leken	l eː˩ c eː˥ ŋ
lema	l eː˩ m aː˥
lemar	l eː˩ m a˩ r
lemo	l eː˩ m oː˥
lemon	l eː˩ m ɔ˩ ŋ
lena	l eː˥ n aː˩
lhasa	l h aː˥ s aː˩
li	l iː˩
lian	l ɪ˩ a˥˦ ŋ
liang	l ɪ˩ a˥ ŋ
liberia	l ɪ˩ b eː˥ r ɪ˥ aː˩
liberiya	l ɪ˩ b eː˥ r ɪ˥ j aː˩
lif	l ɪ˥˦ ɸ
lifta	l ɪ˩ ɸ t aː˩
lika	l ɪ˩ k aː˥
likita	l ɪ˥ c ɪ˥ t ə˩
likitan	l ɪ˥ c ɪ˥ t a˩ ŋ
likitanci	l ɪ˥ c ɪ˥ t a˥ n tʃ iː˥
likitancin	l ɪ˥ c ɪ˥ t a˥ n tʃ ɪ˩ ŋ
likitoci	l ɪ˥ c ɪ˥ t oː˥ tʃ ɪ˩
likitocin	l ɪ˥ c ɪ˥ t oː˥ tʃ ɪ˩ ŋ
lily	l ɪ˩ l j
limam	l iː˩ m a˥˦ ŋ
liman	l iː˩ m a˥˦ ŋ
lin	l ɪ˩ ŋ
lincoln	l ɪ˩ n tʃ oː˥ l ŋ
linda	l ɪ˥ n d aː˩
linjila	l ɪ˩ n dʒ iː˥ l aː˥
link	l ɪ˩ n k
linzami	l ɪ˩ n z aː˥ m iː˩
liping	l ɪ˥ p ɪ˩ ŋ
lisa	l ɪ˥ s aː˩
lisha	l iː˩ ʃ aː˥
lissafa	l ɪ˩ s aː˥ ɸ aː˩
lissafi	l ɪ˩ s aː˥ ɸ iː˩
lissafinmu	l ɪ˩ s aː˥ ɸ ɪ˥ n m uː˩
litattafai	l ɪ˥ t a˩ t ə˥ ɸ aj˥
litattafan	l ɪ˥ t a˩ t ə˥ ɸ a˩ ŋ
litinin	l iː˩ t ɪ˩ n ɪ˥˦ ŋ
littafai	l ɪ˥ t aː˥ ɸ aj˥
littafan	l ɪ˥ t aː˥ ɸ a˩ ŋ
littafi	l ɪ˥ t aː˥ ɸ iː˩
littafin	l ɪ˥ t aː˥ ɸ ɪ˥ ŋ
littattafai	l ɪ˥ t a˩ t ə˥ ɸ aj˥
littattafan	l ɪ˥ t a˩ t ə˥ ɸ a˩ ŋ
liu	l ɪ˩ uː˩
liyafa	l ɪ˩ j aː˥ ɸ aː˥
liyafar	l ɪ˩ j aː˥ ɸ a˩ r
lobster	l oː˥ b s t eː˥ r
loga	l oː˥ ɡ aː˩
lokaci	l oː˥ k ə˩ tʃ iː˥
lokaci'	l oː˥ k ə˩ tʃ iː˥ ʔ
lokacin	l oː˥ k ə˩ tʃ ɪ˩ ŋ
lokacinda	l oː˥ k ə˩ tʃ iː˥ n d aː˩
lokacinsa	l oː˥ k ə˩ tʃ iː˥ n s aː˩
lokacn	l oː˥ k ə˩ ŋ
lokuta	l oː˥ kʷ uː˥ t aː˩
lokutan	l oː˥ kʷ ʊ˥ t a˩ ŋ
lola	l oː˩ l ə˩
london	l oː˥ n d oː˩ ŋ
lori	l oː˥ r iː˩
lotus	l oː˥ t ɪ˩ s
louie	l oː˥ ʊ˥ ɪ˥ eː˩
lu	l uː˥˦
lubayya	l ɪ˩ b ɛ˥ j ɛ˩
lugga	l ɪ˥ ɡ aː˩
luke	l uː˥ c eː˥
lula	l uː˥ l aː˩
lullube	l uː˥ l uː˥ b e˩
lumana	l ɪ˩ m aː˥ n aː˩
luo	l ɪ˥ o˥
lura	l uː˥ r aː˩
lushan	l uː˥ ʃ a˥˦ ŋ
luwaɗi	l ʊ˩ w aː˥ ɗ iː˩
luƙwi	l ɪ˥ kʷʼ iː˥
ma	m aː˩
ma'abuta	m ə˩ ʔ a˩ b uː˥ t aː˩
ma'adinai	m ə˥ ʔ a˩ d iː˥ n aj˥
ma'adinan	m ə˥ ʔ a˩ d iː˥ n a˥˦ ŋ
ma'aikacin	m ə˩ ʔ aj˥ k aː˩ tʃ ɪ˥ ŋ
ma'aikata	m ə˩ ʔ aj˥ k ə˥ t aː˩
ma'aikatan	m ə˩ ʔ aj˥ k ə˥ t a˩ ŋ
ma'aikatar	m ə˩ ʔ aj˥ k ə˥ t a˩ r
ma'amala	m ə˩ ʔ aː˥ m ə˥ l aː˩
ma'ana	m ə˩ ʔ a˩ n aː˥
ma'anar	m ə˩ ʔ a˩ n a˩ r
ma'auni	m ə˩ ʔ aw˥ n iː˩
mabiyan	m ə˥ b ɪ˩ j aː˥ ŋ
mabiyansa	m ə˥ b ɪ˩ j aː˥ n s aː˩
mabiyi	m ə˥ b ɪ˩ j iː˥
mabudin	m ə˥ b ʊ˥ d ɪ˩ ŋ
mac	m ə˩ tʃ
macao	m ə˩ tʃ o˥
mace	m ə˩ tʃ eː˩
maciji	m ə˩ tʃ ɪ˥ dʒ iː˩
macijin	m ə˩ tʃ ɪ˥ dʒ ɪ˥ ŋ
macizai	m ə˩ tʃ iː˥ z aj˥
madadin	m ə˥ d ə˥ d ɪ˩ ŋ
madafun	m ə˩ d a˩ ɸ ʊ˩ ŋ
madagascar	m ə˥ d ə˩ ɡ ə˩ s tʃ a˩ r
madam	m ə˩ d a˩ ŋ
madannai	m ə˩ d a˥ n aj˥
madannin	m ə˩ d a˥ n ɪ˥ ŋ
madara	m ə˩ d aː˥ r aː˩
madatsar	m ə˩ d ə˥ sʼ a˩ r
madaukaki	m ə˩ d aw˩ k aː˩ c iː˥
madauki	m ə˩ d aw˩ c iː˥
madina	m ə˩ d iː˥ n ə˩
madinah	m ə˩ d iː˥ n aː˩
madison	m ə˩ d iː˥ s oː˥ ŋ
madogara	m ə˥ d oː˩ ɡ ə˥ ɽ aː˩
madubi	m ə˥ d uː˥ b iː˥
madugu	m ə˩ d ɪ˥ ɡʷ ʊ˩
madugun	m ə˩ d ɪ˥ ɡʷ ʊ˩ ŋ
mafani	m ə˥ ɸ aː˥ n iː˩
mafarautan	m ə˥ ɸ ə˩ r aw˥ t a˩ ŋ
mafarin	m ə˥ ɸ ə˩ r ɪ˥ ŋ
mafarki	m ə˥ ɸ a˩ ɽ c ɪ˥
mafarkin	m ə˥ ɸ a˩ ɽ c ɪ˥ ŋ
mafi	m ə˩ ɸ iː˥
mafificin	m ə˥ ɸ iː˥ ɸ ɪ˥ tʃ ɪ˩ ŋ
mafita	m aː˥ ɸ ɪ˥ t ə˩
mafitar	m aː˥ ɸ ɪ˥ t a˩ r
mafiya	m aː˥ ɸ ɪ˥ j aː˩
magabatansu	m ə˥ ɡ aː˩ b aː˥ t ə˩ n s ɪ˩
magaji	m ə˥ ɡ aː˩ dʒ iː˥
magaji	m ə˥ ɡ aː˩ dʒ ɪ˥
magajiya	m ə˥ ɡ aː˥ dʒ ɪ˩ j aː˥
magana	m ə˥ ɡ aː˥ n aː˩
maganan	m ə˥ ɡ ə˥ n a˩ ŋ
magananka	m ə˥ ɡ aː˥ n a˥ ŋ k aː˥
maganar	m ə˥ ɡ ə˥ n a˩ r
maganarmu	m ə˥ ɡ ə˥ n a˩ r m uː˩
maganarta	m ə˥ ɡ ə˥ n a˩ r t aː˩
magance	m ə˥ ɡ a˥ n tʃ eː˩
maganganu	m ə˥ ɡ a˥ ŋ ɡ aː˥ n ɪ˩
maganganun	m ə˥ ɡ a˥ ŋ ɡ aː˥ n ɪ˩ ŋ
magani	m ə˥ ɡ aː˥ n iː˩
maganin	m ə˥ ɡ aː˩ n ɪ˥ ŋ
maganinta	m ə˥ ɡ aː˥ n ɪ˥ n t aː˩
magariba	m ə˩ ɡ ə˩ r ɪ˥ b aː˩
magatakardan	m ə˥ ɡ aː˩ t ə˥ k a˩ r d a˥˦ ŋ
mage	m ə˥ ɟ eː˥
magini	m ə˥ ɟ iː˩ n iː˥
mago	m ə˥ ɡʷ o˥
magudana	m ə˥ ɡʷ ʊ˥ d ə˥ n ə˥
maguna	m ə˥ ɡʷ ʊ˩ n aː˥
magunguna	m ə˥ ɡʷ ʊ˩ ŋ ɡʷ ʊ˩ n aː˥
magungunan	m ə˥ ɡʷ ʊ˩ ŋ ɡʷ ʊ˩ n a˥˦ ŋ
mahaifa	m ə˩ h aj˥˦ ɸ aː˩
mahaifin	m ə˩ h aj˥˦ ɸ ɪ˩ ŋ
mahaifina	m ə˩ h aj˥˦ ɸ ɪ˥ n aː˩
mahaifinka	m ə˩ h aj˥˦ ɸ ɪ˩ ŋ k aː˥
mahaifinsa	m ə˩ h aj˥˦ ɸ iː˥ n s aː˩
mahaifinta	m ə˩ h aj˥˦ ɸ ɪ˥ n t aː˩
mahaifiya	m ə˩ h aj˥˦ ɸ ɪ˥ j aː˩
mahaifiyarsa	m ə˩ h aj˥˦ ɸ ɪ˩ j aː˥ ɽ s aː˥
mahaifiyarta	m ə˩ h aj˥˦ ɸ ɪ˥ j ɛ˥ r t aː˩
mahalarta	m ə˩ h a˥˦ l a˥ r t aː˩
mahalartan	m ə˩ h a˥˦ l a˥ r t a˩ ŋ
mahalli	m ə˩ h a˥˦ l iː˥
mahaluki	m ə˩ h a˥˦ l uː˥ c iː˩
mahanga	m ə˩ h a˥ ŋ ɡ aː˥
mahara	m ə˥ h a˩ r aː˩
mahawara	m ə˩ h aː˥ w ə˥ r aː˩
mahimmanci	m ə˩ h ɪ˥ m a˥ n tʃ iː˥
mahmoud	m aː˩ m oː˥ ʊ˥ d
mahmudu	m aː˩ m uː˥ d ɪ˩
mahukunta	m ə˩ h ʊ˩ kʷ uː˥ n t aː˥
mahukuntan	m ə˩ h ʊ˩ kʷ uː˥ n t a˩ ŋ
mai	m aj˥˦
maida	m aj˩ d aː˩
maiduguri	m aj˩ d ɪ˥ ɡʷ ʊ˩ r ɪ˥
maigado	m aj˩ ɡ ə˥ d o˥
maigari	m aj˩ ɡ ə˩ ɽ ɪ˥
maihaifin	m aj˩ h aj˥˦ ɸ ɪ˩ ŋ
maiji	m aj˩ dʒ iː˥
maikuɗi	m aj˩ kʷ ʊ˥ ɗ ɪ˥
maimakon	m aj˥ m aː˥ kʷ oː˩ ŋ
maimuna	m aj˥ m ʊ˩ n aː˥
maimunatu	m aj˥ m ʊ˩ n ə˥ t ɪ˩
maina	m aj˥ n ə˩
mairiga	m aj˩ ɽ iː˩ ɡ ə˩
maiso	m aj˥ s oː˥
maita	m aj˥˦ t aː˥
maitama	m aj˩ t ə˥ m ə˥
maiwada	m aj˩ w ə˩ d aː˥
maiɗaki	m aj˩ ɗ aː˥ c ɪ˩
majalisa	m ə˩ dʒ ə˩ l ɪ˥ s aː˩
majalisar	m ə˩ dʒ aː˥ l ɪ˩ s a˩ r
majalisun	m ə˩ dʒ aː˥ l ɪ˩ s ɪ˩ ŋ
majami'a	m ə˩ dʒ aː˥ m ɪ˥ ʔ aː˩
majanuni	m ə˩ dʒ ə˩ n uː˥ n iː˩
majina	m ə˩ dʒ ɪ˥ n aː˩
majiyar	m ə˩ dʒ ɪ˩ j ɛ˥ r
majiyyata	m ə˩ dʒ ɪ˩ j aː˥ t aː˩
maka	m ə˥ k ə˩
makada	m ə˥ k ə˥ d aː˩
makafi	m ə˥ k aː˥ ɸ iː˩
makama	m ə˥ k aː˥ m aː˥
makama	m ə˥ k aː˩ m aː˥
makamai	m ə˥ k aː˥ m aj˥
makaman	m ə˥ k aː˥ m a˩ ŋ
makamancin	m ə˥ k aː˩ m a˥ n tʃ ɪ˩ ŋ
makamantansu	m ə˥ k aː˥ m ə˩ n t ə˩ n s ɪ˩
makamashi	m ə˥ k aː˥ m ə˩ ʃ iː˥
makamashin	m ə˥ k aː˥ m ə˩ ʃ ɪ˥˦ ŋ
makami	m ə˥ k aː˥ m iː˩
makara	m ə˥ k ə˥ r aː˩
makaranta	m ə˥ k ə˥ r a˥ n t aː˥
makarantar	m ə˥ k ə˥ r a˩ n t a˩ r
makarantarmu	m ə˥ k ə˥ r a˩ n t a˩ r m uː˩
makarantu	m ə˥ k ə˥ r a˥ n t ɪ˩
makarantun	m ə˥ k ə˥ r a˥ n t ɪ˥ ŋ
makare	m ə˥ k ə˩ r eː˩
makashin	m ə˥ k ə˩ ʃ ɪ˥˦ ŋ
makasudin	m ə˥ k aː˩ s ʊ˥ d ɪ˩ ŋ
makaɗi	m ə˥ k ə˥ ɗ iː˥
makaɗi	m ə˥ k ə˩ ɗ iː˥
make	m ə˩ c eː˥
makel	m ə˩ c eː˥ l
makero	m ə˩ c eː˥ ɽ oː˩
maki	m aː˩ c iː˥
makin	m aː˥ c ɪ˩ ŋ
makirci	m ə˥ c ɪ˩ ɽ tʃ iː˥
makiyansu	m ə˥ c ɪ˩ j aː˥ n s ɪ˩
makiyaya	m ə˥ c ɪ˩ j aː˩ j aː˥
makiyayai	m ə˥ c ɪ˩ j aː˩ j ɛ˥ aj˥
makiyayi	m ə˥ c ɪ˩ j aː˩ j iː˥
makka	m a˥ k k ə˩
mako	m aː˥ kʷ oː˩
makoma	m aː˥ kʷ oː˩ m ə˩
makomar	m aː˥ kʷ oː˩ m ə˩ r
makon	m aː˥ kʷ oː˩ ŋ
makonnin	m aː˥ kʷ oː˩ n ɪ˥ ŋ
maku	m aː˥ kʷ ʊ˩
makullan	m aː˥ kʷ ʊ˥ l a˥˦ ŋ
makullin	m aː˥ kʷ ʊ˥ l ɪ˩ ŋ
mala'ika	m ə˩ l aː˥ ʔ ɪ˥ k aː˩
mala'iku	m ə˩ l aː˥ ʔ ɪ˥ kʷ ʊ˩
malafanshi	m aː˥ l ə˩ ɸ aː˩ n ʃ iː˥
malala	m aː˥ l ə˩ l aː˥
malalan	m aː˥ l ə˩ l a˩ ŋ
malalar	m aː˥ l ə˩ l a˩ r
malam	m aː˥ l a˩ ŋ
malama	m aː˥ l ə˩ m aː˥
malamai	m aː˥ l ə˩ m aj˥
malaman	m aː˥ l ə˩ m a˩ ŋ
malamar	m aː˥ l ə˩ m ə˩ r
malami	m aː˥ l ə˩ m iː˥
malamin	m aː˥ l ə˩ m ɪ˥ ŋ
malaminmu	m aː˥ l ə˩ m iː˥ n m uː˩
malasiya	m aː˥ l ə˩ s ɪ˥ j aː˩
malawi	m aː˥ l aː˥ w iː˥
maleriya	m aː˥ l eː˥ r ɪ˥ j aː˩
mali	m aː˥ l iː˥
mallaka	m a˥ l aː˥ k aː˥
mallakar	m a˥ l ə˥ k a˩ r
mallaki	m a˥ l aː˩ c iː˥
mallam	m a˥ l aː˥ m
mama	m aː˩ m ə˥
mamaki	m ə˥ m aː˩ c iː˥
mamakin	m ə˥ m aː˩ c ɪ˥ ŋ
mamallakan	m ə˥ m a˥ l aː˥ k a˩ ŋ
maman	m aː˥ m a˩ ŋ
mamana	m aː˩ m aː˥ n aː˩
mamatan	m ə˥ m aː˩ t a˩ ŋ
mamaye	m ə˥ m aː˩ j eː˥
mamayewa	m ə˥ m aː˩ j eː˥ w aː˩
mamayewar	m ə˥ m aː˩ j eː˥ w a˥ r
mamban	m a˩ m b a˩ ŋ
mambobi	m a˥ m b oː˥ b iː˥
mambobin	m a˥ m b oː˥ b ɪ˩ ŋ
mamoepa	m ə˥ m oː˥ eː˥ p ə˩
man	m a˩ ŋ
mana	m aː˥ n aː˩
manaja	m aː˥ n aː˩ dʒ aː˩
manas	m ə˥ n a˩ s
mandela	m a˩ n d eː˥ l ə˩
mandiri	m a˩ n d iː˥ r iː˩
manema	m a˩ n eː˥ m aː˥
maneman	m a˩ n eː˥ m a˩ ŋ
mangariba	m a˩ ŋ ɡ ə˩ r ɪ˥ b aː˩
manhaja	m a˥ ŋ h a˥ dʒ aː˩
manhajar	m a˥ ŋ h a˥ dʒ a˥ r
manhattan	m a˥ ŋ h a˩ t a˩ ŋ
mani	m aː˥ n iː˩
manja	m a˥ n dʒ ə˩
manjo	m a˥ n dʒ ɔ˩
manna	m a˥ n aː˩
manoma	m aː˥ n oː˩ m ə˩
manoman	m aː˩ n oː˥ m a˩ ŋ
manomi	m aː˩ n oː˥ m iː˥
manta	m a˩ n t aː˥
mantau	m a˩ n t aw˥
manufa	m aː˥ n ɪ˩ ɸ aː˥
manufar	m aː˥ n ɪ˩ ɸ a˩ r
manufofi	m aː˥ n ɪ˩ ɸ oː˩ ɸ iː˥
manufofin	m aː˥ n ɪ˩ ɸ oː˥ ɸ ɪ˩ ŋ
manufofinta	m aː˥ n ɪ˩ ɸ oː˩ ɸ ɪ˥ n t aː˩
manya	m ɛ˥ ɲ j aː˩
manyan	m ɛ˥ ɲ j ŋ
manzo	m a˩ n z oː˥
manzon	m a˩ n z oː˥ ŋ
mao	m ə˥ oː˩
maonan	m ə˥ oː˩ n a˥˦ ŋ
mara	m ə˥ r aː˩
maraba	m ə˥ r aː˩ b ə˥
maraba	m ə˥ ɽ ə˥ b aː˥
marabce	m ə˥ r aː˥ b tʃ eː˩
marabtar	m ə˥ r aː˥ b t a˩ r
maras	m ə˩ r a˥ s
marasa	m ə˥ ɽ aː˥ s aː˩
marayu	m ə˥ ɽ aː˥ j uː˩
maraɗi	m ə˥ ɽ aː˥ ɗ ɪ˥
marc	m a˥ ɽ tʃ
marco	m a˥ ɽ tʃ oː˥
marcus	m a˥ ɽ tʃ ɪ˩ s
margeret	m a˥ r ɟ eː˥ ɽ eː˥ t
margret	m ə˩ r ɡ ɽ eː˥ t
marhabin	m a˩ r h a˥ b ɪ˩ ŋ
marigayi	m ə˥ ɽ iː˩ ɡ aː˩ j iː˥
marigayin	m ə˥ ɽ iː˩ ɡ aː˥ j ɪ˩ ŋ
marijuana	m ə˥ ɽ iː˩ dʒ uː˥ aː˥ n aː˩
marili	m ə˩ r iː˥ l iː˩
marilyn	m ə˩ r iː˥ l j ŋ
marina	m ə˥ ɽ ɪ˥ n aː˥
mariri	m aː˩ ɽ iː˥ ɽ iː˥
maris	m aː˥ r ɪ˩ s
mariya	m ə˩ r ɪ˥ j ɛ˩
marke	m a˥ ɽ c eː˥
maroko	m ə˩ r oː˥ kʷ o˩
maroƙi	m ə˥ ɽ oː˩ cʼ iː˥
martaba	m a˥ r t aː˩ b ə˥
martabar	m a˥ r t aː˩ b a˩ r
martani	m a˥ r t aː˥ n iː˩
martanin	m a˥ r t aː˩ n ɪ˥ ŋ
maru	m aː˥ ɽ ɪ˩
marubuci	m ə˩ r ɪ˥ b ʊ˩ tʃ iː˥
marubucin	m ə˩ r ɪ˥ b ʊ˩ tʃ ɪ˩ ŋ
marubutan	m ə˩ r ɪ˥ b uː˩ t a˩ ŋ
mary	m a˥ r j
maryam	m a˥ r j ɛ˥ m
maryamu	m a˥ r j ɛ˥ m ʊ˩
masa	m ə˥ s aː˥
masallachi	m ə˥ s a˥ l aː˥ tʃ iː˩
masallaci	m ə˥ s a˥ l aː˥ tʃ iː˥
masallacin	m ə˥ s a˥ l aː˥ tʃ ɪ˩ ŋ
masallatai	m ə˥ s a˥ l aː˩ t aj˥
masallatan	m ə˥ s a˥ l aː˩ t a˩ ŋ
masana	m ə˥ s ə˥ n ə˥
masana'anta	m ə˥ s ə˥ n ə˥ ʔ a˩ n t aː˥
masana'antar	m ə˥ s ə˥ n ə˥ ʔ a˩ n t a˩ r
masana'antu	m ə˥ s ə˥ n ə˥ ʔ a˩ n t ɪ˩
masana'antun	m ə˥ s ə˥ n ə˥ ʔ a˩ n t ɪ˥ ŋ
masanan	m ə˥ s ə˥ n a˩ ŋ
masani	m ə˥ s aː˥ n iː˩
masanin	m ə˥ s aː˩ n ɪ˥ ŋ
masar	m ə˥ s a˩ r
masara	m ə˥ s ə˩ r aː˥
masarar	m ə˥ s ə˩ r a˩ r
masarautar	m ə˥ s ə˩ ɽ aw˥ t a˩ r
masauki	m ə˥ s aw˩ c iː˥
masaukin	m ə˥ s aw˥ c ɪ˥ ŋ
masaya	m ə˥ s aː˥ j aː˥
masaya	m ə˥ s ɛ˥ j aː˥
mashahama	m ə˩ ʃ ə˩ h aː˥ m aː˩
mashahuri	m ə˩ ʃ ə˩ h uː˥ r iː˩
mashahurin	m ə˩ ʃ ə˩ h uː˥ r ɪ˥ ŋ
mashahuriyar	m ə˩ ʃ ə˩ h uː˥ r ɪ˥ j ɛ˥ r
mashahurun	m ə˩ ʃ ə˩ h uː˥ r ɪ˩ ŋ
mashaya	m ə˩ ʃ ɛ˥ j aː˩
mashayar	m ə˩ ʃ aː˥ j ɛ˥ r
mashi	m aː˥ ʃ iː˩
mashigar	m ə˩ ʃ ɪ˥ ɡ r
mashigin	m ə˩ ʃ ɪ˩ ɟ ɪ˩ ŋ
mashin	m ə˩ ʃ ɪ˥˦ ŋ
masifa	m ə˩ s iː˥ ɸ aː˩
masinja	m aː˥ s ɪ˥ n dʒ ə˩
maslahar	m ə˩ s l ə˥ h a˩ r
maso	m ə˩ s oː˥
masoro	m ə˩ s oː˥ ɽ o˥
masoyan	m ə˩ s oː˩ j ŋ
masoyansu	m ə˩ s oː˩ j aː˥ n s ɪ˩
masoyiyar	m ə˩ s oː˥ j ɪ˩ j ɛ˥ r
masoyiyata	m ə˩ s oː˥ j ɪ˩ j aː˥ t aː˩
massar	m ə˩ s a˩ r
masters	m ə˩ s t eː˥ r s
masu	m ə˩ s ɪ˥
masun	m ə˩ s ɪ˩ ŋ
mata	m aː˥ t aː˥
mata	m aː˩ t aː˥
matafiya	m ə˥ t aː˥ ɸ ɪ˥ j aː˩
matafiyan	m ə˥ t aː˥ ɸ ɪ˥ j ɛ˩ ŋ
mataimaki	m ə˥ t aj˥ m aː˥ c iː˩
mataimakin	m ə˥ t aj˥ m aː˥ c ɪ˩ ŋ
mataimakiyar	m ə˥ t aj˥ m ə˥ c ɪ˩ j ɛ˥ r
matakai	m ə˥ t ə˥ k aj˥
matakala	m ə˥ t ə˥ k ə˥ l aː˩
matakan	m ə˥ t ə˥ k a˩ ŋ
mataki	m ə˥ t aː˩ c iː˥
matakin	m ə˥ t aː˥ c ɪ˩ ŋ
matalauci	m ə˥ t ə˩ l aw˩ tʃ iː˥
matalauta	m ə˥ t ə˩ l aw˩ t aː˩
matan	m ə˥ t a˩ ŋ
matanin	m ə˥ t aː˩ n ɪ˥ ŋ
matar	m ə˥ t a˩ r
matarka	m ə˥ t a˩ r k aː˥
matarsa	m ə˥ t ə˩ ɽ s aː˥
matasa	m ə˥ t aː˥ s aː˩
matasan	m ə˥ t aː˥ s a˩ ŋ
matashi	m ə˥ t ə˩ ʃ iː˥
matashin	m ə˥ t ə˩ ə˩ ʃ ɪ˥˦ ŋ
matashiya	m ə˥ t ə˩ ʃ ɪ˥ j aː˩
matashiyar	m ə˥ t ə˩ ʃ ɪ˩ j ɛ˥ r
matata	m ə˥ t aː˥ t aː˩
matsa	m aː˥ sʼ aː˩
matsakaicin	m ə˥ sʼ ə˥ k aj˥ tʃ ɪ˩ ŋ
matsakaita	m ə˥ sʼ ə˥ k aj˥ t ə˥
matsala	m ə˥ sʼ ə˥ l aː˩
matsalar	m ə˥ sʼ ə˥ l ə˥ r
matsalarmu	m ə˥ sʼ ə˥ l ə˥ r m uː˩
matsaloli	m ə˥ sʼ aː˥ l oː˩ l iː˥
matsalolin	m ə˥ sʼ aː˥ l oː˩ l ɪ˩ ŋ
matsalolinku	m ə˥ sʼ aː˥ l oː˩ l ɪ˩ ŋ kʷ ʊ˩
matsanancin	m ə˥ sʼ aː˥ n a˥ n tʃ ɪ˩ ŋ
matsananciyar	m ə˥ sʼ aː˥ n a˥ n tʃ ɪ˩ j ɛ˥ r
matsawa	m ə˥ sʼ aː˥ w aː˥
matsaya	m aː˥ sʼ aː˩ j aː˥
matsayi	m aː˥ sʼ aː˩ j iː˥
matsayin	m ə˥ sʼ aː˥ j ɪ˩ ŋ
matsayinsa	m aː˥ sʼ aː˩ j iː˥ n s aː˩
matsayinsu	m aː˥ sʼ aː˩ j iː˥ n s ɪ˩
matsayinta	m aː˥ sʼ aː˩ j iː˥ n t aː˥
matse	m ə˥ sʼ e˩
matsi	m ə˥ sʼ iː˥
matsin	m ə˥ sʼ ɪ˥ ŋ
matsu	m ə˥ sʼ uː˥
matsuguni	m ə˥ sʼ ɪ˥ ɡʷ ʊ˩ n iː˩
matt	m ə˥ t
matuka	m aː˩ t ɪ˥ k aː˩
matukar	m aː˩ t ɪ˥ k a˩ r
matuƙar	m aː˩ t ɪ˥ kʼ a˩ r
matuƙin	m aː˩ t ɪ˥ cʼ ɪ˥ ŋ
mauritania	m aw˥ ɽ ɪ˥ t ə˩ n iː˥ aː˩
mauritaniya	m aw˥ ɽ ɪ˥ t aː˥ n ɪ˥ j ɛ˩
mauritius	m aw˥ ɽ ɪ˥ t iː˥ ɪ˩ s
mawaka	m ə˩ w ə˥ k aː˩
mawaki	m w aː˩ c iː˥
mawakin	m w aː˩ c ɪ˥ ŋ
mawaƙa	m ə˩ w ə˥ kʼ ə˩
mawaƙin	m ə˥ w aː˩ cʼ ɪ˥ ŋ
mawuyacin	m aː˩ w ʊ˥ j aː˩ tʃ ɪ˥ ŋ
maya	m aː˩ j aː˥
mayafin	m aː˩ j aː˥ ɸ ɪ˩ ŋ
mayakan	m aː˩ j aː˥ k a˩ ŋ
mayani	m ɛ˥ j aː˥ n iː˥
mayar	m aː˩ j ɛ˥ r
mayarwa	m aː˩ j aː˥ ɽ w aː˥
mayaƙan	m aː˩ j aː˥ kʼ a˩ ŋ
maye	m aː˩ j eː˥
mayen	m aː˩ j eː˥ ŋ
mayu	m aː˥ j uː˩
maza	m ə˥ z aː˥
maza	m ə˥ z ə˥
mazaje	m ə˥ z aː˥ dʒ e˩
mazan	m ə˥ z a˩ ŋ
mazansu	m ə˥ z ə˥ n s ɪ˩
mazauna	m ə˥ z aw˥ n aː˩
mazaunan	m ə˥ z aw˥ n a˩ ŋ
mazaunin	m ə˥ z aw˥ n ɪ˥ ŋ
maƙabartar	m ə˩ kʼ ə˩ b a˥ r t a˩ r
maƙala	m ə˩ kʼ ə˩ l aː˩
maƙale	m ə˩ kʼ ə˩ l e˥
maƙaryaci	m ə˥ kʼ a˥ ɽ j aː˩ tʃ iː˥
maƙil	m aː˩ cʼ ɪ˥ l
maƙiya	m aː˩ cʼ ɪ˥ j aː˩
maƙullan	m aː˩ kʷʼ ʊ˥ l a˥˦ ŋ
maƙwabcinsa	m aː˩ kʷʼ b tʃ iː˩ n s aː˩
maɓuɓɓugan	m aː˥ ɓ ʊ˩ ɓ ʊ˩ ɡ a˥˦ ŋ
maɗaba'a	m ə˥ ɗ aː˥ b ə˥ ʔ aː˥
maɗaci	m ə˥ ɗ aː˩ tʃ iː˥
maɗauri	m ə˥ ɗ aw˥ ɽ iː˥
mbeki	m b eː˥ c iː˩
me	m eː˩
mecece	m eː˥ tʃ eː˥ tʃ eː˩
media	m eː˥ d ɪ˥ aː˩
meg	m eː˥ ɡ
mele	m eː˥ l eː˥
meles	m eː˩ l eː˩ s
melissa	m eː˥ l ɪ˩ s ə˩
membobin	m eː˥ m b oː˥ b ɪ˩ ŋ
mene	m n e˥
menene	m n eː˥ n e˥
mercedes	m eː˥ ɽ tʃ eː˥ d eː˩ s
merkel	m eː˥ ɽ c eː˥ l
mesa	m eː˥ s aː˩
mesin	m eː˥ s ɪ˩ ŋ
metan	m a˥ t a˩ ŋ
meyasa	m eː˥ j aː˥ s aː˩
meziko	m eː˥ z ɪ˩ kʷ oː˥
miao	m ɪ˥ o˥
microsoft	m ɪ˥ k ɽ oː˩ s oː˩ ɸ t
midil	m ɪ˥ d ɪ˥ l
miji	m ɪ˥ dʒ iː˩
mijin	m ɪ˥ dʒ ɪ˥ ŋ
mijina	m ɪ˥ dʒ ɪ˥ n aː˩
mijinta	m ɪ˥ dʒ ɪ˥ n t aː˩
mika	m ɪ˥ k aː˩
mike	m ɪ˥ c eː˥
miki	m ɪ˥ c iː˩
mikiya	m ɪ˥ c ɪ˥ j aː˩
mil	m ɪ˥ l
miliyan	m ɪ˥ l ɪ˩ j aː˥ ŋ
miliyon	m ɪ˥ l ɪ˩ j ɔ˩ ŋ
mill	m ɪ˥ l
milliyan	m ɪ˥ l ɪ˥ j ɛ˩ ŋ
mim	m ɪ˥ ŋ
min	m ɪ˥ ŋ
mindar	m ɪ˥ n d a˥˦ r
ming	m ɪ˥ ŋ
mini	m ɪ˥ n iː˥
miniabinda	m ɪ˥ n ɪ˥ a˩ b ɪ˥ n d aː˩
minista	m ɪ˥ n ɪ˥ s t ə˩
ministan	m ɪ˥ n ɪ˥ s t a˩ ŋ
ministoci	m ɪ˥ n ɪ˥ s t oː˥ tʃ ɪ˩
miniti	m ɪ˥ n ɪ˥ t iː˩
minti	m ɪ˥ n t iː˩
mintoci	m ɪ˥ n t oː˥ tʃ ɪ˩
mintuna	m ɪ˥ n t ɪ˩ n aː˩
mirror	m ɪ˥ r oː˥ r
mirya	m ɪ˥ ɽ j ɛ˩
misalai	m ɪ˩ s aː˥ l aj˥
misali	m ɪ˩ s aː˥ l iː˩
misalin	m ɪ˩ s aː˥ l ɪ˩ ŋ
mishi	m ɪ˥ ʃ iː˥
misira	m ɪ˥ s ɪ˥ r ə˩
miski	m ɪ˥ s c iː˩
miskini	m ɪ˩ s c iː˥ n iː˩
mista	m ɪ˥ s t aː˩
mister	m ɪ˥ s t eː˥ r
mita	m ɪ˥ t ə˩
miya	m ɪ˥ j aː˩
miyan	m ɪ˥ j ɛ˩ ŋ
mizani	m iː˥ z aː˥ n iː˩
miƙe	m ɪ˥ cʼ eː˩
mo	m oː˥
model	m oː˥ d eː˥ l
mogae	m oː˥ ɡ eː˩
mogao	m oː˥ ɡ o˥
mohammed	m ʊ˩ h a˥ m a˩ d
molo	m oː˥ l oː˥
mona	m oː˥ n aː˥
mongolia	m ɔ˩ ŋ ɡʷ oː˥ l ɪ˩ aː˩
mongoliya	m ɔ˩ ŋ ɡʷ oː˥ l ɪ˥ j aː˩
monroe	m ɔ˩ ŋ ɽ oː˩ eː˩
morais	m oː˥ r ɪ˥˦ s
morales	m oː˥ r a˩ l eː˩ s
more	m oː˥ r eː˩
morgan	m oː˥ r ɡ a˥˦ ŋ
moriya	m oː˥ r ɪ˥ j aː˩
moriyar	m oː˥ r ɪ˩ j ɛ˥ r
moriyarsu	m oː˥ r ɪ˩ j aː˥ ɽ s ɪ˩
morocco	m oː˥ r o˩ tʃ oː˥
moryar	m oː˥ r j ɛ˥ r
moscow	m oː˥ s tʃ oː˥ w
mossad	m oː˥ s ə˩ d
mota	m oː˥ t aː˩
motan	m oː˥ t a˩ ŋ
motar	m oː˥ t a˩ r
motata	m oː˥ t aː˩ t aː˩
motoci	m oː˥ t oː˥ tʃ ɪ˩
motocin	m oː˥ t oː˥ tʃ ɪ˩ ŋ
motsa	m oː˥ t s aː˥
motsi	m oː˥ sʼ iː˥
mottaki	m oː˥ t aː˩ c iː˥
mowa	m oː˥ w aː˩
mu	m uː˥
mu'amala	m ʊ˩ ʔ aː˥ m ə˥ l aː˩
mu'amalar	m ʊ˩ ʔ aː˥ m ə˥ l a˩ r
mu'amalata	m ʊ˩ ʔ aː˥ m ə˥ l aː˥ t aː˩
mu'ujiza	m ʊ˩ ʔ ʊ˩ dʒ ɪ˥ z aː˩
mubarak	m ʊ˩ b a˥ ɽ ə˥ k
mubazzari	m ʊ˩ b a˥ z ə˩ r iː˥
mudassiru	m uː˥ d s iː˥ r uː˥
muddin	m ʊ˥ d ɪ˩ ŋ
mudu	m uː˥ d ɪ˩
mueller	m ʊ˩ a˥ l eː˥ r
mugayen	m ʊ˩ ɡ aː˩ j eː˥ ŋ
muggan	m ʊ˩ ɡ a˥˦ ŋ
mugu	m uː˥ ɡʷ uː˩
mugun	m ʊ˩ ɡʷ ʊ˩ ŋ
muhalli	m ʊ˩ h a˥ l iː˥
muhallin	m ʊ˩ h a˥ l ɪ˩ ŋ
muhallinmu	m ʊ˩ h a˥ l iː˩ n m uː˩
muhammad	m ʊ˩ h a˥ m ə˥ d
muhammadiyya	m ʊ˩ h a˩ m ə˩ d ɪ˥ j aː˩
muhammadu	m ʊ˩ h a˥ m ə˥ d ɪ˩
muhanmode	m ʊ˩ h a˥ n m oː˥ d e˩
muharram	m ʊ˩ h a˥ r a˩ ŋ
muhawara	m ʊ˩ h a˥ w ə˥ r aː˩
muhibba	m ʊ˩ h ɪ˥ b aː˩
muhimmaci	m ʊ˩ h ɪ˥ m ə˩ tʃ iː˥
muhimman	m ʊ˩ h ɪ˥ m a˩ ŋ
muhimmanci	m ʊ˩ h ɪ˥ m a˥ n tʃ iː˥
muhimmancin	m ʊ˩ h ɪ˥ m a˥ n tʃ ɪ˩ ŋ
muhimmi	m ʊ˩ h ɪ˥ m iː˩
muhimmin	m ʊ˩ h ɪ˥ m ɪ˥ ŋ
muhimmini	m ʊ˩ h ɪ˥ m ɪ˩ n iː˥
muhimmiyar	m ʊ˩ h ɪ˥ m ɪ˩ j ɛ˥ r
muhtari	m ʊ˩ k t aː˥ r ɪ˥
muhuri	m ʊ˥ h uː˥ ɽ iː˥
mujaddadi	m ʊ˩ dʒ a˥ d ə˩ d iː˥
mujalla	m ʊ˩ dʒ a˥ l aː˩
mujallar	m ʊ˩ dʒ a˥ l a˩ r
muje	m ʊ˩ dʒ e˩
mujiya	m uː˥ dʒ ɪ˩ j aː˥
muka	m uː˥ k aː˩
mukai	m uː˥ k aj˥
mukam	m uː˥ k aː˩ m
mukaman	m uː˥ k aː˥ m a˩ ŋ
mukami	m uː˥ k aː˥ m iː˩
mukamin	m uː˥ k aː˩ m ɪ˥ ŋ
mukaminsa	m uː˥ k aː˩ m ɪ˥ n s aː˩
muke	m uː˥ c eː˥
muku	m ʊ˩ kʷ ʊ˩
mukullin	m ʊ˩ kʷ ʊ˩ l ɪ˩ ŋ
mukunnin	m ʊ˩ kʷ uː˥ n ɪ˥ ŋ
mula	m ʊ˩ l ə˥
mulki	m ʊ˥ l c iː˩
mulkin	m ʊ˥ l c ɪ˥ ŋ
mulkinta	m ʊ˥ l c ɪ˥ n t aː˩
mulukiya	m ʊ˥ l uː˥ c ɪ˥ j aː˩
mumbari	m ʊ˥ m b ə˩ r iː˥
mumbengewi	m uː˥ m b eː˥ ɲ ɟ eː˥ w iː˥
mumini	m uː˥ m ɪ˩ n iː˥
mummunan	m uː˥ m uː˩ n a˥˦ ŋ
mummunar	m uː˥ m uː˩ n a˩ r
mumunan	m uː˥ m uː˩ n a˥˦ ŋ
mun	m ʊ˩ ŋ
muna	m ʊ˩ n aː˥
munafuki	m ʊ˩ n aː˥ ɸ ʊ˩ c iː˥
munafurci	m ʊ˩ n aː˥ ɸ ʊ˩ ɽ tʃ iː˥
munanan	m ʊ˩ n aː˥ n a˥˦ ŋ
mundia	m ʊ˩ n d iː˥ aː˩
muni	m ʊ˩ n iː˩
mur	m ʊ˥˦ r
mura	m ʊ˩ r aː˥
murabus	m ʊ˩ r aː˥ b ʊ˥ s
muradi	m ʊ˩ r aː˥ d iː˩
murar	m ʊ˩ r a˩ r
murfi	m ʊ˥ ɽ ɸ iː˥
murhu	m ʊ˥ ɽ h uː˩
murjani	m ʊ˩ r dʒ aː˥ n iː˩
murkushe	m ʊ˩ r kʷ ʊ˥ ʃ eː˩
murmurewarsa	m ʊ˥ ɽ m ʊ˩ ɽ eː˥ w a˥ r s aː˥
murmushi	m ʊ˥ ɽ m uː˩ ʃ iː˥
murna	m ʊ˩ r n aː˩
murnan	m ʊ˩ r n a˥˦ ŋ
murnar	m ʊ˩ r n a˩ r
murtuk	m ʊ˩ r t ɪ˥ k
murya	m ʊ˩ r j aː˩
muryan	m ʊ˩ r j ŋ
muryar	m ʊ˩ r j ɛ˥ r
muryarka	m ʊ˩ r j ɛ˥ r k ə˩
muryarki	m ʊ˩ r j a˥ ɽ c ɪ˥
muryarku	m ʊ˩ r j ɛ˥ r kʷ ʊ˩
murza	m ʊ˥ ɽ z aː˩
murza	m ʊ˩ ɽ z aː˥
murzani	m ʊ˩ r z aː˥ n iː˩
musa	m uː˥ s aː˥
musafiha	m uː˥ s ɛ˥ ɸ iː˥ h aː˩
musamman	m ʊ˥ s a˥ m a˩ ŋ
musanta	m ʊ˥ s a˥ n t aː˩
musanya	m uː˥ s ɛ˥ ɲ j aː˩
musanyar	m uː˥ s ɛ˥ ɲ j ɛ˥ r
musawa	m uː˥ s aː˥ w aː˥
musaya	m uː˥ s aː˥ j aː˥
musayar	m uː˥ s aː˥ j ɛ˥ r
musaye	m uː˥ s aː˥ j eː˥
musayen	m uː˥ s aː˥ j eː˥ ŋ
musharraf	m ʊ˥ ʃ a˥ r a˩ ɸ
mushe	m uː˥ ʃ eː˩
mushiriki	m ʊ˥ ʃ ɪ˥ r ɪ˩ c iː˥
mustapha	m ʊ˥ s t ə˩ ɸ aː˥
mustaphady	m ʊ˥ s t ə˩ ɸ d ɪ˩
musu	m ʊ˩ s ɪ˩
musulmai	m ʊ˩ s ɪ˩ l m aj˥
musulman	m ʊ˩ s ɪ˩ l m a˩ ŋ
musulmi	m ʊ˩ s ɪ˩ l m iː˥
musulmin	m ʊ˩ s ɪ˩ l m ɪ˥ ŋ
musulunci	m ʊ˩ s ɪ˩ l uː˥ n tʃ iː˥
musun	m ʊ˩ s ɪ˩ ŋ
musunta	m ʊ˩ s ɪ˩ n t aː˥
mutanan	m ʊ˥ t aː˥ n a˥˦ ŋ
mutane	m ʊ˥ t aː˥ n e˥
mutanen	m ʊ˥ t aː˥ n eː˥ ŋ
mutanensa	m ʊ˥ t aː˥ n eː˥ n s aː˩
mutu	m ʊ˥ t ɪ˩
mutum	m ʊ˩ t ɪ˥˦ ŋ
mutumi	m ʊ˥ t ɪ˩ m iː˥
mutumin	m ʊ˥ t ɪ˩ m ɪ˥ ŋ
mutun	m ʊ˩ t ɪ˥˦ ŋ
mutuncin	m ʊ˥ t ɪ˩ n tʃ ɪ˩ ŋ
mutuwa	m ʊ˥ t ʊ˥ w aː˥
mutuwar	m ʊ˩ t ɪ˥˦ w a˥ r
mutuwarsa	m ʊ˩ t ɪ˥˦ w a˥ r s aː˥
muyi	m uː˥ j iː˥
muzi	m uː˥ z iː˥
muzuru	m ʊ˩ z uː˥ ɽ uː˥
na	n aː˥
na'am	n ə˥ ʔ a˩ m
na'am	n ə˩ ʔ a˥ m
na'ibi	n aː˥ ʔ ɪ˩ b iː˥
na'ura	n aː˩ ʔ uː˥ r aː˩
naayi	n aː˥ j ɪ˩
nace	n ə˥ tʃ eː˩
nacewa	n aː˩ tʃ eː˥ w aː˩
naci	n ə˩ tʃ iː˥
nada	n ə˥ d aː˩
nadin	n ə˥ d ɪ˩ ŋ
nafi	n aː˥ ɸ iː˩
nafila	n aː˥ ɸ ɪ˥ l aː˩
naga	n ə˥ ɡ aː˥
nagari	n ə˥ ɡ ə˩ r iː˥
nagarta	n ə˥ ɡ ə˩ r t aː˩
nagartacciyar	n ə˥ ɡ ə˩ r t tʃ ɪ˩ j ɛ˥ r
nagartattun	n ə˥ ɡ ə˩ r t a˩ t ɪ˥ ŋ
nagode	n ə˥ ɡʷ oː˥ d e˩
nahawu	n ə˥ h a˥ w uː˩
nahiya	n aː˥ h ɪ˥ j aː˩
nahiyar	n aː˥ h ɪ˩ j ɛ˥ r
naijeriya	n aj˩ dʒ eː˥ r ɪ˥ j aː˩
naira	n aj˥ r aː˩
najad	n aː˩ dʒ ə˩ d
naje	n aː˩ dʒ e˩
najeriya	n aː˩ dʒ eː˥ r ɪ˥ j aː˩
najeriyar	n aː˩ dʒ eː˥ r ɪ˥ j ɛ˥ r
naka	n ə˥ k aː˥
nakasa	n ə˥ k aː˥ s aː˩
nakasassu	n ə˥ k aː˥ s aː˥ s ɪ˩
nake	n ə˩ c eː˥
naku	n aː˥ kʷ ʊ˩
nakusa	n ə˥ kʷ ʊ˥ s aː˩
nama	n aː˥ m aː˩
naman	n aː˥ m a˩ ŋ
namibiya	n aː˥ m ɪ˥ b ɪ˥ j ɛ˩
namiji	n aː˥ m ɪ˥ dʒ iː˩
namijin	n aː˥ m ɪ˩ dʒ ɪ˩ ŋ
namu	n aː˥ m ʊ˩
namun	n aː˥ m ʊ˩ ŋ
nan	n a˥˦ ŋ
nanjing	n a˥ n dʒ ɪ˥ ŋ
naomi	n ə˥ oː˥ m iː˥
narkar	n a˥ r k a˩ r
narke	n a˥ ɽ c eː˥
nas	n a˥˦ s
nasa	n ə˥ s aː˥
nasaba	n ə˥ s ə˥ b aː˩
nasan	n ə˥ s a˩ ŋ
nasara	n ə˥ s aː˥ r aː˩
nasara	n ə˥ s ə˥ r aː˩
nasarar	n ə˥ s ə˥ r a˩ r
nasarori	n ə˥ s ə˥ r oː˥ r iː˩
nasarorin	n ə˥ s ə˥ r oː˥ r ɪ˥ ŋ
nasaru	n ə˩ s aː˩ r uː˥
nashi	n ə˩ ʃ iː˥
nasiha	n ə˩ s iː˥ h aː˩
nasu	n ə˩ s ɪ˥
nata	n ə˥ t aː˩
nato	n ə˥ t o˥
nau'i	n aw˥ ʔ iː˩
naurarka	n aw˥ r a˩ r k aː˥
nauyi	n aw˥ j iː˥
nauyin	n aw˥ j ɪ˩ ŋ
nauyinmu	n aw˥ j iː˥ n m uː˩
nauyinsu	n aw˥ j iː˥ n s ɪ˩
nawa	n aː˥ w aː˥
nawane	n ə˥ w a˩ n e˥
nayi	n aː˩ j iː˥
nazari	n ə˥ z ə˩ r iː˥
nazarin	n ə˥ z aː˥ ɽ ɪ˥ ŋ
naɗe	n ə˥ ɗ eː˩
ne	n eː˥
neja	n eː˥ dʒ ə˩
nema	n eː˥ m aː˥
neman	n eː˥ m a˩ ŋ
nemansu	n eː˥ m aː˥ n s ɪ˩
nemawa	n eː˥ m aː˥ w aː˥
neme	n eː˥ m eː˩
nemi	n eː˥ m iː˥
nemo	n eː˥ m oː˥
nepal	n eː˥ p a˥˦ l
nesa	n eː˥ s ə˩
new	n eː˥ w
ni	n iː˥
ni'ima	n ɪ˥ ʔ ɪ˥ m aː˩
nicolas	n ɪ˥˦ tʃ oː˥ l a˩ s
niger	n ɪ˥˦ ɟ eː˥ r
nigeria	n ɪ˥˦ ɟ eː˥ r ɪ˥ aː˩
nigeriya	n ɪ˥˦ ɟ eː˥ r ɪ˥ j aː˩
nijar	n iː˩ dʒ a˥ r
nijer	n iː˩ dʒ eː˥ r
nijeriya	n iː˩ dʒ eː˥ r ɪ˥ j ɛ˩
nike	n ɪ˥ c eː˥
nil	n ɪ˥˦ l
nilu	n iː˥ l ɪ˩
nim	n ɪ˥˦ ŋ
nima	n iː˥ m aː˩
nina	n ɪ˥ n aː˩
nine	n ɪ˩ n e˥
ningbo	n ɪ˥˦ ŋ ɡʷ b oː˥
ninka	n ɪ˥˦ ŋ k aː˥
ninkaya	n ɪ˥˦ ŋ k aː˥ j aː˩
ninki	n ɪ˥ ɲ c iː˩
nisa	n ɪ˥˦ s aː˥
nisan	n ɪ˥˦ s a˩ ŋ
nisance	n ɪ˥˦ s a˥ n tʃ eː˩
nishadi	n ɪ˩ ʃ aː˥ d iː˩
nishaɗi	n ɪ˩ ʃ aː˥ ɗ iː˩
nitsar	n ɪ˥˦ sʼ a˩ r
niu	n ɪ˥˦ uː˩
niujie	n iː˥ ʊ˩ dʒ ɪ˥ eː˥
niyan	n ɪ˥ j ɛ˩ ŋ
niyar	n ɪ˩ j ɛ˥ r
niyya	n ɪ˥ j aː˩
niyyar	n ɪ˥ j ɛ˥ r
nobel	n oː˥ b a˥ l
noma	n oː˥ m aː˩
noman	n oː˥ m a˩ ŋ
nono	n oː˥ n oː˩
nora	n oː˥ r aː˩
noti	n oː˥ t iː˩
notis	n oː˥ t ɪ˩ s
nu	n ɪ˩
nufanshi	n ɪ˩ ɸ aː˥ n ʃ iː˥
nufi	n ɪ˥ ɸ iː˥
nufin	n ɪ˥ ɸ ɪ˩ ŋ
nufo	n ɪ˥ ɸ o˥
nuhu	n ɪ˥ h ʊ˩
nujoma	n ɪ˥ dʒ oː˩ m ə˩
nukiliya	n uː˥ c ɪ˥ l ɪ˩ j aː˥
nukiliyar	n uː˥ c ɪ˥ l ɪ˩ j ɛ˥ r
nukus	n ɪ˩ kʷ ʊ˩ s
numbobin	n ɪ˥ m b oː˥ b ɪ˩ ŋ
numfarfashi	n ɪ˥ m ɸ ə˩ r ɸ ə˩ ʃ iː˥
numfasawa	n ɪ˥ m ɸ ə˩ s aː˥ w aː˥
numfashi	n ɪ˥ m ɸ ə˩ ʃ iː˥
nun	n ɪ˥ ŋ
nuna	n ʊ˩ n aː˥
nunawa	n ɪ˩ n aː˥ w aː˥
nuni	n uː˥ n iː˩
nunin	n ɪ˥ n ɪ˥ ŋ
nunka	n ɪ˩ ŋ k aː˥
nutsu	n uː˥ sʼ uː˥
nuwamba	n ʊ˩ w a˥ m b aː˩
o	ʔ oː˥
obama	ʔ oː˥ b aː˩ m ə˥
obasanjo	ʔ oː˥ b ə˩ s a˥ n dʒ ɔ˩
obin	ʔ oː˥ b ɪ˩ ŋ
oda	ʔ oː˥ d aː˩
odar	ʔ oː˥ d aː˩ r
odinga	ʔ oː˥ d ɪ˩ ŋ ɡ aː˥
oeleans	ʔ oː˥ eː˩ l eː˩ n s
offishin	ʔ oː˥ ɸ ɪ˩ ʃ ɪ˥ ŋ
ofis	ʔ oː˥ ɸ ɪ˩ s
ofishin	ʔ oː˥ ɸ ɪ˩ ʃ ɪ˥ ŋ
ofisoshi	ʔ oː˥ ɸ ɪ˩ s oː˥ ʃ iː˥
ofisoshin	ʔ oː˥ ɸ ɪ˩ s oː˥ ʃ ɪ˥ ŋ
oga	ʔ o˩ ɡ aː˥
okello	ʔ oː˥ c a˥ l o˩
oktoba	ʔ ɔ˩ k t oː˥ b aː˩
olimpic	ʔ oː˥ l ɪ˩ m p ɪ˩ tʃ
olmert	ʔ oː˥ l m r t
olusegun	ʔ oː˥ l uː˥ s e˥˦ ɡʷ ʊ˩ ŋ
olympic	ʔ oː˥ l j m p ɪ˩ tʃ
olympics	ʔ oː˥ l j m p ɪ˩ k s
omar	ʔ oː˥ m a˩ r
omo	ʔ oː˥ m oː˩
opera	ʔ oː˥ p eː˥ ɽ aː˩
oryem	ʔ oː˥ r j eː˥ ŋ
ostiraliya	ʔ oː˥ s t ɪ˩ r aː˥ l ɪ˩ j aː˥
otal	ʔ oː˥ t a˥ l
otel	ʔ oː˥ t eː˥ l
oto	ʔ oː˥ t o˥
oza	ʔ oː˥ z aː˩
pablo	p ə˩ b l oː˩
pacific	p ə˩ tʃ iː˥ ɸ ɪ˥ tʃ
pakistan	p aː˥ c ɪ˥ s t a˩ ŋ
palasdinawa	p ə˩ l a˩ s d iː˥ n aː˥ w aː˥
palastine	p ə˩ l a˩ s t ɪ˩ n e˥
palasɗinu	p ə˩ l a˩ s ɗ iː˥ n ɪ˩
pan	p a˥˦ ŋ
panda	p a˩ n d aː˥
paris	p aː˥ r ɪ˩ s
pasha	p aː˥ ʃ ə˩
pasific	p ə˩ s iː˥ ɸ ɪ˥ tʃ
pasto	p aː˥ t o˥
patty	p aː˥ t iː˩
paul	p aw˥ l
peach	p eː˥ aː˩ tʃ
pedro	p eː˥ d ɽ oː˩
philippines	ɸ iː˥ l iː˩ p p ɪ˩ n eː˥ s
physics	ɸ iː˥ s ɪ˩ k s
piano	p ɪ˩ ə˥ n o˥
pijo	p ɪ˩ dʒ o˥
pillow	p ɪ˩ l oː˥ w
pine	p ɪ˩ n e˥
ping	p ɪ˩ ŋ
pingyao	p ɪ˩ ŋ ɡ j ɛ˩ o˥
piper	p ɪ˩ p eː˥ r
piraministan	p ɪ˩ r aː˥ m ɪ˩ n ɪ˥ s t a˩ ŋ
piying	p ɪ˩ j ɪ˥ ŋ
player	p l aː˩ j eː˥ r
pleomorphic	p l eː˥ oː˥ m oː˥ r ɸ ɪ˥ tʃ
po	p oː˥˦
podcast	p oː˩ d tʃ a˩ s t
poland	p oː˩ l a˩ n d
pole	p oː˩ l eː˩
portugal	p oː˩ ɽ t ɪ˩ ɡ a˥˦ l
potala	p oː˩ t ə˩ l aː˩
potter	p oː˩ t eː˥ r
pudong	p ʊ˥ d oː˩ ŋ
pumi	p ʊ˥ m iː˥
purple	p ʊ˥ ɽ p l eː˩
ra	ɽ aː˩
ra'ayi	r ə˥ ʔ ɛ˩ j iː˥
ra'ayin	r ə˥ ʔ ɛ˩ j ɪ˩ ŋ
ra'ayinsa	r ə˥ ʔ ɛ˩ j iː˥ n s aː˩
ra'ayoyi	r ə˥ ʔ ɛ˩ j oː˩ j ɪ˥
ra'ayoyin	r ə˥ ʔ ɛ˩ j oː˩ j ɪ˥ ŋ
ra'i	r aː˥ ʔ iː˩
raba	ɽ ə˥ b aː˩
rabawa	r ə˩ b aː˥ w aː˥
rabecca	ɽ ə˥ b eː˥ tʃ aː˩
rabi	r ə˩ b iː˥
rabin	ɽ ə˥ b ɪ˩ ŋ
rabo	ɽ ə˥ b oː˩
rabonta	ɽ ə˥ b oː˩ n t aː˥
rabu	r ə˥ b ʊ˩
rabuwa	ɽ ə˥ b ʊ˥ w aː˥
rabuwar	ɽ ə˥ b ʊ˥ w a˥ r
rada	ɽ ə˥ d aː˩
radio	ɽ aː˥ d ɪ˩ o˥
radiyo	ɽ aː˥ d ɪ˩ j oː˥˦
rafani	r aː˥ ɸ aː˩ n iː˥
ragama	ɽ ə˥ ɡ ə˩ m aː˥
ragar	r ə˩ ɡ ə˩ r
rage	r ə˥ ɟ eː˥
ragewar	r ə˥ ɟ eː˥ w a˥ r
ragi	r ə˥ ɟ iː˩
ragon	r ə˥ ɡʷ oː˥ ŋ
ragu	r ə˥ ɡʷ ʊ˩
raguna	r ə˥ ɡʷ ʊ˩ n aː˥
raguwa	ɽ aː˩ ɡʷ ʊ˥ w aː˥
raguwar	ɽ aː˩ ɡʷ ʊ˥ w a˥ r
rahama	r ə˥ h a˥ m aː˩
rahaman	r ə˥ h a˥ m a˩ ŋ
rahila	ɽ ə˩ h iː˥ l aː˥
rahotanni	r ə˩ h oː˥ t a˥ n iː˩
rahotannin	r ə˩ h oː˥ t a˥ n ɪ˥ ŋ
rahoto	r ə˩ h oː˥ t o˥
rahoton	r ə˩ h oː˥ t a˥ ŋ
rahotonnin	r ə˩ h oː˥ t oː˥ n ɪ˥ ŋ
rahusa	r ə˩ h uː˥ s aː˥
rai	ɽ aj˥˦
raine	ɽ aj˩ n e˥
rairai	ɽ aj˩ ɽ aj˥
rairayi	ɽ aj˩ ɽ ɛ˩ j iː˥
rajab	ɽ ə˥ dʒ a˩ b
rajista	ɽ ə˥ dʒ ɪ˥ s t aː˩
raka	ɽ ə˥ k aː˩
raka'a	r ə˥ k ə˥ ʔ aː˩
rake	ɽ ə˩ c eː˥
raki	ɽ aː˥ c iː˩
rakiyarsa	ɽ aː˥ c ɪ˩ j aː˥ ɽ s aː˥
rakuma	ɽ aː˥ kʷ ʊ˩ m aː˥
rakumai	ɽ aː˥ kʷ ʊ˩ m aj˥
rakumi	ɽ aː˥ kʷ ʊ˩ m iː˥
rally	r ə˥ l j
rama	ɽ aː˩ m ə˥
rama	ɽ ə˥ m aː˩
ramadan	ɽ ə˥ m aː˩ d a˥˦ ŋ
ramalan	ɽ ə˩ m ə˩ l a˥˦ ŋ
rami	ɽ aː˥ m iː˩
ramin	ɽ aː˩ m ɪ˥ ŋ
ramuka	ɽ aː˩ m uː˥ k aː˩
ramukan	ɽ ə˥ m ʊ˩ k a˩ ŋ
ramuwa	ɽ ə˥ m ʊ˥ w aː˥
ramɓasɓas	r a˩ m ɓ a˩ s ɓ a˩ s
ran	r a˩ ŋ
rana	ɽ aː˥ n aː˥
rana	ɽ aː˥ n ə˥
ranan	ɽ ə˥ n a˩ ŋ
ranar	ɽ ə˥ n a˩ r
rancen	r a˥ n tʃ eː˩ ŋ
randa	ɽ a˩ n d aː˥
rangadin	r a˥ ŋ ɡ ə˥ d ɪ˩ ŋ
rani	ɽ ə˥ n iː˥
ranka	r a˥ ŋ k aː˥
ranki	ɽ ə˥ ɛ˥ ɲ c iː˩
rano	ɽ ə˥ n o˥
ransa	r a˥ n s ə˩
ransu	r a˥ n s ɪ˩
ranta	r a˥ n t aː˩
rantse	ɽ aː˥ n sʼ e˩
rantsuwar	r a˥ n t s ʊ˥ w a˥ r
rarar	r ə˥ r a˩ r
rarraaba	ɽ ə˥ r ə˩ b aː˥˦
rarraba	ɽ ə˥ r ə˩ b aː˥˦
rasa	r ə˥ s aː˥
rasha	ɽ aː˥ ʃ ə˩
rashanci	r ə˥ ʃ a˥ n tʃ iː˥
rashawa	r ə˥ ʃ ə˥ w aː˥
rashi	r ə˩ ʃ iː˥
rashin	r ə˩ ʃ ɪ˥˦ ŋ
rashinta	r ə˥ ʃ ɪ˥ n t aː˩
rasu	r ə˩ s ɪ˥
rasuwar	ɽ aː˩ s ʊ˥ w a˥ r
rataya	r ə˥ t ɛ˥ j aː˩
rataye	r ə˥ t ɛ˥ j eː˥
ratsa	ɽ aː˥ sʼ aː˩
rauni	ɽ aw˥ n iː˩
raunin	ɽ aw˥ n ɪ˥ ŋ
raunuka	ɽ aw˥ n ɪ˥ k aː˩
rawa	ɽ ə˥ w aː˩
rawani	ɽ ə˥ w ə˩ n iː˥
rawar	ɽ ə˥ w a˥ r
rawaya	ɽ aː˩ w ɛ˥ j aː˩
rawayan	ɽ aː˩ w ɛ˥ j ŋ
rawayen	ɽ aː˩ w ɛ˥ j eː˥ ŋ
raya	ɽ aː˩ j aː˥
rayar	ɽ aː˩ j ɛ˥ r
raye	ɽ aː˩ j eː˥
rayu	ɽ aː˩ j ʊ˥
rayukan	ɽ aː˥ j uː˩ k a˩ ŋ
rayuwa	ɽ aː˩ j ʊ˥ w aː˥
rayuwan	ɽ aː˩ j ʊ˥ w a˩ ŋ
rayuwansu	ɽ aː˩ j ʊ˥ w a˥ n s ɪ˩
rayuwar	ɽ aː˩ j ʊ˥ w a˥ r
rayuwarmu	ɽ aː˩ j ʊ˥ w a˥ r m uː˩
rayuwarsa	ɽ aː˩ j ʊ˥ w a˥ r s aː˥
rayuwarsu	ɽ aː˩ j ʊ˩ w aː˥ ɽ s ɪ˩
rayuwarta	ɽ aː˩ j ʊ˥ w a˥ r t aː˩
rayuwata	ɽ aː˩ j ʊ˥ w ə˥ t aː˩
raywa	ɽ aː˩ j w aː˥
raƙumi	ɽ aː˩ kʷʼ ʊ˥ m iː˥
raɓa	ɽ aː˥ ɓ aː˥
raɗau	r ə˥ ɗ aw˥
raɗaɗi	r ə˥ ɗ aː˥ ɗ iː˩
real	ɽ eː˥ a˥˦ l
red	ɽ eː˥ d
redio	ɽ eː˥ d ɪ˥ o˥
rediyo	ɽ eː˥ d ɪ˥ j oː˥˦
rediyon	ɽ eː˥ d ɪ˥ j ɔ˩ ŋ
rediyonmu	ɽ eː˥ d ɪ˥ j oː˥˦ n m uː˩
rema	ɽ eː˥ m aː˥
ren	ɽ eː˥ ŋ
rena	ɽ eː˥ n aː˩
renminbi	ɽ eː˥ n m ɪ˥ n b iː˥
renon	ɽ eː˥ n ɔ˩ ŋ
rera	r eː˩ r aː˩
reras	r eː˩ r a˥ s
reshen	ɽ eː˥ ʃ eː˩ ŋ
reza	r eː˥ z aː˩
ri	r iː˩
riba	r iː˥ b aː˩
riba	r ɪ˩ b ə˥
ribar	r ɪ˩ b a˩ r
rice	ɽ ɪ˥ tʃ eː˩
richard	ɽ ɪ˥ tʃ a˩ r d
rida	r iː˥ d aː˩
ridda	r ɪ˥ d aː˥
ridha	r ɪ˥ d h aː˩
rifkatu	r iː˥ ɸ k ə˥ t ɪ˩
riga	ɽ iː˩ ɡ aː˥
rigakafi	ɽ iː˩ ɡ ə˥ k aː˥ ɸ iː˩
rigakafin	ɽ iː˩ ɡ ə˥ k aː˥ ɸ ɪ˩ ŋ
rigan	ɽ iː˩ ɡ a˥˦ ŋ
rigar	ɽ iː˩ ɡ aː˩ r
rige	ɽ ɪ˥ ɟ e˥
right	ɽ ɪ˥ t
rigimar	ɽ ɪ˥ ɟ iː˥ m a˩ r
riguna	ɽ ɪ˥ ɟ uː˩ n aː˩
rijau	ɽ ɪ˥ dʒ aw˥
rijista	ɽ ɪ˥ dʒ ɪ˥ s t aː˩
rijiya	ɽ ɪ˥ dʒ ɪ˩ j aː˥
rijiyoyi	ɽ ɪ˥ dʒ ɪ˩ j oː˥˦ j iː˥
rijstar	ɽ ɪ˥ dʒ a˥ s t a˩ r
rika	ɽ ɪ˥ k aː˩
rike	r ɪ˩ c eː˥
rikici	ɽ ɪ˥ c ɪ˥ tʃ iː˥
rikicin	ɽ ɪ˥ c ɪ˥ tʃ ɪ˩ ŋ
rikitarwan	ɽ ɪ˥ c ɪ˥ t a˩ r w a˥˦ ŋ
rikodin	r ɪ˩ c ɔ˩ d ɪ˩ ŋ
rikon	r ɪ˩ c ɔ˩ ŋ
rilwanu	ɽ ɪ˥ l w aː˥ n ɪ˩
rimi	ɽ iː˥ m iː˥
rimi	ɽ iː˥ m ɪ˥
rina	ɽ ɪ˥ n aː˥
ringim	ɽ ɪ˥ ɲ ɟ ɪ˩ ŋ
rinjayar	ɽ ɪ˥ n dʒ aː˩ j ɛ˥ r
rinjaye	ɽ ɪ˥ n dʒ aː˩ j eː˥
rinjayi	ɽ ɪ˥ n dʒ aː˩ j iː˥
rinka	r ɪ˩ ŋ k aː˥
rio	ɽ ɪ˥ o˥
riris	ɽ ɪ˥ ɽ ɪ˩ s
rita	ɽ ɪ˥ t ə˩
riƙe	ɽ ɪ˥ cʼ eː˩
robert	ɽ oː˥ b eː˥ r t
robot	ɽ oː˥ b oː˥ t
roger	ɽ oː˥ ɡʷ eː˥ r
rogo	ɽ oː˥ ɡʷ oː˩
rogo	ɽ oː˥ ɡʷ o˩
roke	ɽ oː˥ c eː˥
roki	ɽ oː˥ c iː˩
rokon	ɽ oː˥ k ɔ˩ ŋ
rokonsu	ɽ oː˥ kʷ oː˩ n s ɪ˩
rome	ɽ oː˥ m eː˩
romo	ɽ oː˥ m oː˥
rong	ɽ oː˥ ŋ
rotary	ɽ oː˥ t a˥ r j
roy	ɽ oː˥ j
roƙe	ɽ oː˥ cʼ eː˩
ru'uya	r ɪ˩ ʔ ʊ˩ j aː˥
rubanya	r ɪ˥ b ɛ˥ ɲ j aː˩
rubewan	r ɪ˥ b eː˥ w a˥˦ ŋ
rubu'i	r ɪ˥ b ʊ˩ ʔ iː˥
rubuce	r ɪ˥ b ʊ˩ tʃ eː˩
rubuta	r ɪ˥ b uː˩ t aː˥
rubutattun	r ɪ˥ b uː˩ t a˩ t ɪ˥ ŋ
rubuto	r ɪ˥ b uː˩ t o˥
rubutu	r ɪ˥ b uː˩ t ɪ˩
rubutun	r ɪ˥ b uː˩ t ɪ˥ ŋ
rufa	ɽ ʊ˥ ɸ aː˥
rufaffe	ɽ ʊ˥ ɸ aː˥ ɸ eː˩
rufe	r uː˥ ɸ eː˩
rufin	r uː˥ ɸ ɪ˩ ŋ
ruhin	r uː˥ h ɪ˥ ŋ
ruhu	r uː˥ h ʊ˩
rukuni	r ɪ˥ kʷ uː˥ n iː˩
rukunin	r ɪ˥ kʷ uː˥ n ɪ˥ ŋ
rula	r uː˥ l aː˩
rumfa	r ɪ˥ m ɸ aː˩
rundunar	r ɪ˩ n d uː˥ n a˩ r
runguma	r ɪ˩ ŋ ɡʷ ʊ˥ m aː˩
ruri	ɽ ɪ˩ ɽ iː˥
rusa	r uː˥ s aː˩
rushe	r uː˥ ʃ eː˩
rushewan	r uː˥ ʃ eː˩ w a˥˦ ŋ
rutsa	r uː˥ sʼ aː˩
rututu	r ɪ˥ t ɪ˥ t ɪ˥
ruwa	ɽ ʊ˥ w aː˥
ruwa	ɽ ʊ˥ w ə˥
ruwaito	ɽ ʊ˥ w aj˩ t o˥
ruwan	ɽ ʊ˥ w a˩ ŋ
ruwanda	ɽ ʊ˥ w a˥ n d aː˩
ruwanta	ɽ ʊ˥ w a˥ n t aː˩
ruwayoyi	ɽ ʊ˥ w aː˩ j oː˩ j ɪ˥
ruƙayyatu	ɽ ɪ˥ kʼ ɛ˩ j ɛ˥ t ɪ˩
ruɓewa	ɽ ʊ˥ ɓ eː˩ w aː˥
rwanda	r w a˥ n d aː˩
sa	s aː˥˦
sa'a	s aː˥ ʔ aː˩
sa'a	s ə˥ ʔ aː˩
sa'adu	s ə˥ ʔ a˩ d ɪ˩
sa'an	s ə˥ ʔ a˩ ŋ
sa'ar	s ə˥ ʔ a˩ r
sa'ata	s ə˥ ʔ aː˥ t aː˩
sa'ida	s ə˩ ʔ iː˥ d aː˩
sa'o'i	s ə˩ ʔ oː˥ ʔ iː˩
saamu	s a˥ m ʊ˩
saba	s ə˥ b aː˩
saba'in	s ə˩ b ə˩ ʔ ɪ˥ ŋ
sababbin	s ə˥ b ə˩ b ɪ˩ ŋ
sababi	s ə˥ b ə˩ b iː˥
sabain	s ə˩ b ə˩ ɪ˩ ŋ
sabani	s ə˥ b aː˩ n iː˥
sabanin	s ə˥ b aː˩ n ɪ˥ ŋ
sabawa	s ə˩ b aː˥ w aː˥
sabbin	s aː˥ b ɪ˩ ŋ
sabida	s ə˩ b iː˥ d aː˩
sabili	s ə˩ b iː˥ l iː˩
sabo	s aː˥ b oː˥
sabo	s aː˥ b o˥
saboda	s aː˥ b oː˥ d aː˩
sabon	s aː˥ b oː˥ ŋ
sabulu	s aː˥ b ʊ˥ l ɪ˩
sabunta	s aː˥ b ʊ˥ n t aː˥
sabuwar	s aː˥ b ʊ˥ w a˥ r
sace	s ə˩ tʃ eː˩
sacko	s ə˩ kʷ oː˥
sada	s aː˥ d aː˩
sadaka	s ə˥ d ə˥ k aː˩
sadaki	s ə˩ d aː˥˦ c iː˥
sadarwa	s aː˩ d a˥ ɽ w aː˥
sadau	s aː˩ d aw˥
sadaukar	s aː˩ d aw˥ k a˩ r
sadik	s aː˩ d ɪ˥˦ k
sadin	s aː˩ d ɪ˥˦ ŋ
sadu	s aː˩ d ɪ˩
saduwa	s aː˩ d ʊ˥ w aː˥
safa	s aː˩ ɸ aː˥
safa	s ə˩ ɸ aː˥˦
safai	s ə˥ ɸ aj˥
safar	s ə˥ ɸ a˩ r
safara	s ə˥ ɸ ə˥ r aː˩
safe	s aː˥ ɸ e˥
safen	s ə˥ ɸ eː˩ ŋ
safi	s aː˥ ɸ iː˥
safiyar	s aː˥ ɸ ɪ˥ j ɛ˥ r
sagara	s aː˩ ɡ ə˥ ɽ aː˥
sage	s ə˥ ɟ eː˩
sago	s ə˥ ɡʷ oː˥
sahab	s ə˩ h a˩ b
sahani	s ə˩ h aː˥ n iː˩
sahara	s ə˩ h aː˥ r aː˩
sahibi	s aː˥ h ɪ˩ b iː˥
sahihan	s ə˩ h iː˥ h a˥ ŋ
sahihanci	s ə˩ h iː˥ h a˥ n tʃ iː˥
sahihi	s ə˩ h iː˥ h iː˩
sahihiyar	s ə˩ h iː˥ h ɪ˩ j ɛ˥ r
sahihiyyar	s ə˩ h iː˥ h ɪ˥ j ɛ˥ r
sahon	s ə˩ h oː˥ ŋ
sahun	s ə˩ h ʊ˩ ŋ
sahur	s ə˩ h ʊ˥˦ r
sai	s aj˥
saja	s aː˥ dʒ aː˩
sajjad	s a˥ dʒ ə˥ d
saka	s ə˥ k aː˥
sakaliya	s ə˥ k aː˥ l ɪ˩ j aː˥
sakamako	s ə˥ k aː˩ m aː˥ kʷ oː˩
sakamakon	s ə˥ k aː˩ m aː˥ kʷ oː˩ ŋ
sakamamko	s ə˥ k aː˩ m aː˥ m kʷ oː˥
sakamokn	s ə˥ k aː˩ m oː˥ kʷ ŋ
sakan	s ə˥ k a˩ ŋ
sakandare	s ə˥ k a˩ n d ə˩ r eː˩
sakandari	s ə˥ k a˩ n d ə˩ r iː˥
sakar	s ə˥ k a˩ r
sakarai	s aː˥ k ə˥ r aj˥
sakataren	s ə˥ k ə˥ t aː˥ r e˩ ŋ
sakatariyarsa	s ə˥ k ə˥ t aː˥ r ɪ˩ j aː˥ ɽ s aː˥
sake	s ə˩ c eː˥
sakewa	s ə˩ c eː˥ w aː˩
saki	s aː˥ c iː˩
sakin	s aː˥ c ɪ˩ ŋ
sakkwato	s a˥ kʷ ə˥ t o˥
sako	s ə˩ kʷ oː˥
sakon	s ə˩ kʷ oː˥ ŋ
sakonni	s ə˩ kʷ oː˩ n iː˩
saku	s aː˥ kʷ ʊ˩
sakyamuni	s ə˩ c ɛ˥ m ʊ˩ n iː˩
salad	s ə˩ l aː˥ d
salam	s ə˩ l aː˥ m
salama	s ə˩ l aː˥ m aː˩
salamu	s ə˩ l aː˥ m ʊ˩
salati	s ə˩ l aː˥ t iː˩
saleh	s ə˩ l e˥ ʃ
salga	s a˥ l ɡ aː˥
salihi	s aː˥ l ɪ˩ h iː˥
saliyo	s aː˩ l ɪ˩ j oː˥˦
salka	s a˩ l k aː˥
salla	s a˥ l aː˩
sallah	s a˥ l aː˩
sallamar	s a˥ l aː˥ m ə˩ r
sallame	s a˥ l ə˩ m eː˩
sallar	s a˥ l a˩ r
sallau	s a˩ l aw˥
sally	s a˥ l j
salmon	s a˥ l m oː˥ ŋ
salo	s aː˥ l oː˩
salon	s a˥ l ɔ˩ ŋ
salou	s aː˥ l oː˩ uː˩
salula	s a˥ l uː˥ l aː˩
salular	s a˥ l uː˥ l a˩ r
sam	s a˥ m
sama	s ə˥ m ə˩
saman	s aː˩ m a˥ ŋ
samaniya	s ə˩ m aː˩ n ɪ˥ j ɛ˩
samanja	s aː˩ m a˥ n dʒ ə˩
samar	s ə˥ m ə˩ r
samari	s a˥ m ə˩ r iː˥
samarin	s aː˩ m a˥ ɽ ɪ˥ ŋ
samartaka	s aː˩ m a˥ r t ə˥ k aː˩
samarwa	s aː˩ m a˥ ɽ w aː˥
same	s a˥ m eː˩
samfurin	s a˥ m ɸ ʊ˩ r ɪ˥ ŋ
sami	s aː˥ m iː˩
samo	s a˥ m oː˥
samu	s aː˥ m ʊ˩
samun	s aː˥ m ʊ˩ ŋ
samunsu	s aː˥ m ʊ˩ n s ɪ˩
samuwa	s aː˥ m ʊ˩ w aː˥
samɓal	s a˩ m ɓ a˥ l
samɓala	s a˥ m ɓ ə˥ l aː˥
samɓali	s a˥ m ɓ ə˥ l ɪ˥
samɓalɓal	s a˩ m ɓ a˩ l ɓ a˩ l
san	s a˩ ŋ
sana'a	s ə˩ n ə˥ ʔ aː˩
sana'oi	s ə˥ n ə˥ ʔ o˥ ɪ˥
sanadin	s ə˥ n ə˥ d ɪ˩ ŋ
sanadiyar	s ə˥ n ə˥ d ɪ˩ j ɛ˥ r
sanadiyyar	s ə˥ n ə˥ d ɪ˥ j ɛ˥ r
sanannen	s ə˥ n ə˥ n eː˥ ŋ
sanannun	s ə˥ n ə˥ n ɪ˩ ŋ
sanar	s ə˥ n a˩ r
sanarwa	s ə˥ n ə˥ ɽ w aː˥
sanarwar	s ə˥ n a˩ r w a˥ r
sanata	s ə˥ n ə˥ t aː˩
sanda	s a˩ n d ə˥
sandal	s a˥ n d a˩ l
sandan	s a˥ n d a˩ ŋ
sandar	s a˩ n d a˥˦ r
sanduna	s a˩ n d uː˥ n aː˩
sanduƙi	s a˩ n d uː˥ cʼ iː˩
sandwich	s a˩ n d w iː˥ tʃ
sandwiches	s a˩ n d w ɪ˥ tʃ eː˥ s
sangandale	s a˥ ŋ ɡ a˥ n d ə˩ l e˥
sani	s ə˥ n iː˩
sanin	s aː˩ n ɪ˥ ŋ
saninsa	s aː˥ n ɪ˥ n s aː˩
saniya	s aː˥ n ɪ˩ j aː˥
sanka	s a˥ ŋ k aː˥
sannan	s a˥ n a˥˦ ŋ
sannu	s a˥ n ɪ˩
sannu	s a˩ n ɪ˥
sannunku	s a˥ n ɪ˩ ŋ kʷ ʊ˩
sansani	s a˥ n s a˥ n iː˩
sansanin	s a˥ n s aː˩ n ɪ˥ ŋ
sanshi	s a˩ n ʃ iː˥
santa	s a˩ n t aː˥
santambul	s a˩ n t a˩ m b ʊ˥˦ l
santi	s a˩ n t ɪ˥
santos	s a˩ n t a˥˦ s
sanya	s ɛ˥ ɲ j aː˩
sanyalokacin	s ɛ˥ ɲ j aː˥ l oː˥ k ə˩ tʃ ɪ˩ ŋ
sanyawa	s ɛ˥ ɲ j aː˥ w aː˥
sanye	s ɛ˥ ɲ j eː˥
sanyi	s a˩ n j iː˥
sanyin	s a˩ n j ɪ˩ ŋ
sara	s ə˥ r aː˩
sarai	s ə˥ r aj˥
sarakuna	s ə˥ r aː˥ kʷ ʊ˩ n aː˥
sarakunan	s aː˥ r ə˥ kʷ uː˩ n a˥˦ ŋ
sarara	s ə˩ ɽ ə˩ ɽ ə˩
sararin	s ə˩ ɽ ə˩ ɽ ɪ˥ ŋ
saratu	s aː˥ r ə˥ t ɪ˩
sarauniya	s ə˥ ɽ aw˥ n ɪ˩ j aː˥
sarauniyar	s ə˩ ɽ aw˥ n ɪ˩ j ɛ˥ r
sarauta	s ə˩ ɽ aw˥ t aː˩
sarautar	s ə˩ ɽ aw˥ t a˩ r
sardauna	s a˩ r d aw˥ n ə˥
sare	s ə˩ ɽ eː˥
sarewa	s ə˩ ɽ eː˥ w aː˥
sarka	s a˩ r k aː˥
sarki	s a˥ ɽ c iː˥
sarki	s a˥ ɽ c ɪ˥
sarkin	s a˥ ɽ c ɪ˥ ŋ
sarkozy	s a˩ r kʷ oː˩ z j
sarrafa	s a˩ r aː˥ ɸ aː˩
sarrafawa	s a˩ r ɸ aː˥ w aː˥
sarƙa	s a˥ ɽ kʼ aː˩
sarƙata	s a˥ r kʼ aː˥ t aː˩
sasanta	s ə˩ s a˥ n t aː˩
sasantawa	s ə˩ s a˥ n t aː˥ w aː˥
sashe	s ə˩ ə˥ ʃ e˥
sashen	s ə˥ ʃ e˥ ŋ
sashi	s ə˩ ʃ iː˥
sashin	s aː˥ ə˩ ʃ ɪ˥˦ ŋ
sassa	s ə˩ s ə˩
sassafe	s ə˩ s aː˥ ɸ e˥
sassaka	s ə˩ s ə˥ k aː˥
sassan	s ə˩ s a˩ ŋ
sassauta	s ə˩ s aw˥ t aː˩
sata	s aː˥ t aː˩
satar	s aː˥ t a˩ r
sati	s aː˥ t iː˥
satin	s aː˥ t ɪ˩ ŋ
satumba	s ə˩ t ɪ˥ m b aː˩
sau	s aw˥
sau	s aw˩
saudi	s aw˩ d iː˩
saudiyya	s aw˩ d ɪ˥ j aː˩
sauka	s aw˩ k aː˩
saukaka	s aw˩ k ə˥ k aː˩
saukar	s aw˩ k a˩ r
sauki	s aw˩ c iː˥
saukin	s aw˩ c ɪ˥ ŋ
sauko	s aw˩ kʷ oː˥
sauna	s aw˥ n aː˩
saura	s aw˩ ɽ aː˥
sauran	s aw˥ r a˩ ŋ
sauransu	s aw˥ r a˥ n s ɪ˩
saurara	s aw˩ ɽ aː˥ r aː˩
saurarar	s aw˩ ɽ aː˥ ɽ r
saurare	s aw˩ ɽ aː˥ ɽ eː˩
sauraren	s aw˩ ɽ aː˥ ɽ eː˥ ŋ
saurarenmu	s aw˩ ɽ aː˥ ɽ eː˥ n m uː˩
saurari	s aw˩ ɽ aː˥ ɽ iː˥
sauraro	s aw˩ ɽ aː˥ ɽ oː˩
sauraron	s aw˩ ɽ aː˥ ɽ oː˩ ŋ
sauraronmu	s aw˩ ɽ aː˥ ɽ oː˩ n m uː˩
sauraronsa	s aw˩ ɽ aː˥ ɽ oː˩ n s aː˩
saurayi	s aw˥ r aː˩ j iː˥
saurayin	s aw˩ ɽ aː˥ j ɪ˩ ŋ
saurayina	s aw˥ r aː˩ j iː˥ n ə˩
saurayinta	s aw˥ r aː˩ j iː˥ n t aː˥
sauri	s aw˥ ɽ iː˥
saurin	s aw˥ ɽ ɪ˥ ŋ
sauro	s aw˥ ɽ oː˩
sauron	s aw˥ r ɔ˩ ŋ
sauti	s aw˥ t iː˩
sautin	s aw˥ t ɪ˥ ŋ
sauya	s aw˥ j aː˩
sauyawa	s aw˥ j aː˥ w aː˥
sauye	s aw˥ j eː˥
sauyi	s aw˥ j iː˥
sauyin	s aw˥ j ɪ˩ ŋ
sauƙar	s aw˩ kʼ a˩ r
sauƙaƙa	s aw˩ kʼ ə˩ kʼ ə˩
sauƙaƙe	s aw˩ kʼ cʼ eː˩
sauƙi	s aw˩ cʼ iː˩
sauƙin	s aw˩ cʼ ɪ˥ ŋ
sawun	s aː˥ w ʊ˥ ŋ
saya	s aː˩ j aː˥
sayar	s aː˩ j ɛ˥ r
sayarwa	s aː˩ j ɛ˩ ɽ w aː˥
sayawa	s aː˩ j aː˥ w aː˥
saye	s aː˩ j eː˥
saye	s ɛ˩ j eː˥
sayen	s aː˩ j eː˥ ŋ
sayi	s aː˩ j iː˥
sayo	s aː˩ j oː˥˦
saƙo	s aː˩ kʷʼ o˥
saƙonka	s aː˩ kʷʼ oː˥ ŋ k aː˥
saɗara	s ə˩ ɗ ə˥ r aː˩
scotch	s kʷ oː˥ tʃ
sebastien	s e˥˦ b a˩ s t ɪ˩ eː˩ ŋ
sef	s e˥˦ ɸ
senegal	s e˥˦ n eː˩ ɡ a˥˦ l
seychelles	s e˥˦ j tʃ eː˥ l eː˩ s
sha	ʃ ə˥
sha'aban	ʃ ə˩ ʔ a˩ b a˥˦ ŋ
sha'ani	ʃ ə˥ ʔ a˩ n iː˥
sha'anin	ʃ ə˥ ʔ a˩ n ɪ˥ ŋ
sha'awa	ʃ ə˥ ʔ a˩ w aː˥
sha'awan	ʃ ə˥ ʔ aː˥ w a˥˦ ŋ
sha'awar	ʃ ə˥ ʔ aː˥ w a˥ r
shabab	ʃ ə˥ b a˩ b
shabiyun	ʃ ə˥ b ɪ˩ j ʊ˩ ŋ
shadda	ʃ a˥ d aː˩
shadda	ʃ a˥˦ d aː˥
shafa	ʃ ə˥ ɸ aː˩
shafar	ʃ ə˥ ɸ a˩ r
shafe	ʃ aː˥ ɸ e˥
shafi	ʃ aː˥ ɸ iː˩
shafin	ʃ aː˩ ɸ ɪ˩ ŋ
shafinka	ʃ aː˩ ɸ ɪ˩ ŋ k aː˥
shafinsa	ʃ aː˥ ɸ ɪ˥ n s aː˩
shafuka	ʃ aː˥ ɸ ʊ˩ k aː˩
shagabannin	ʃ aː˥ ɡ aː˩ b a˥ n ɪ˥ ŋ
shagalin	ʃ aː˥ ɡ aː˥ l ɪ˩ ŋ
shago	ʃ ə˥ ɡʷ oː˥
shagon	ʃ ə˥ ɡʷ oː˥ ŋ
shagulgula	ʃ ə˥ ɡʷ ʊ˥ l ɡʷ ʊ˥ l aː˩
shaguna	ʃ ə˥ ɡʷ ʊ˩ n aː˥
shah	ʃ aː˩
shahada	ʃ ə˩ h aː˥ d aː˩
shahara	ʃ ə˩ h aː˥ r aː˩
shahararen	ʃ ə˩ h aː˥ ɽ a˥ r eː˩ ŋ
shahararren	ʃ ə˩ h aː˥ ɽ a˥ r eː˩ ŋ
shahararriyar	ʃ ə˩ h aː˥ ɽ a˥ r ɪ˩ j ɛ˥ r
shahararru	ʃ ə˩ h aː˥ ɽ a˥ r uː˥
shahararrun	ʃ ə˩ h aː˥ ɽ a˥ r ɪ˩ ŋ
shaho	ʃ aː˥ h oː˩
shai'an	ʃ aj˥ ʔ a˩ ŋ
shaida	ʃ aj˥ d aː˩
shaidar	ʃ aj˥ d aː˩ r
shaidarsa	ʃ aj˥ d a˩ r aː˩
shaidu	ʃ aj˥ d ɪ˩
shaihi	ʃ aj˥ h iː˩
shaiɗan	ʃ aj˩ ɗ a˥˦ ŋ
shakar	ʃ ə˥ k a˩ r
shakatawa	ʃ ə˥ k ə˥ t aː˥ w aː˥
shakatawan	ʃ ə˥ k ə˥ t aː˥ w a˥˦ ŋ
shakka	ʃ a˥ k k aː˩
shakkar	ʃ a˥ k k a˩ r
sham	ʃ a˥˦ ŋ
shamsiyya	ʃ a˩ m s ɪ˥ j aː˩
shan	ʃ a˥˦ ŋ
shandong	ʃ a˥ n d oː˩ ŋ
shang	ʃ a˥ ŋ
shanghai	ʃ a˥ ŋ ɡʷ h aj˥
shanono	ʃ aː˩ n oː˥ n o˩
shanu	ʃ aː˥ n ɪ˩
shanun	ʃ aː˥ n ɪ˩ ŋ
shanya	ʃ ɛ˥ ɲ j aː˩
shaolin	ʃ ə˥ oː˩ l ɪ˩ ŋ
shar	ʃ ə˩ r
shara	ʃ ə˩ r aː˥
sharadin	ʃ ə˩ r aː˥ d ɪ˩ ŋ
sharan	ʃ ə˩ r a˩ ŋ
sharaɗi	ʃ ə˥ r ə˩ ɗ iː˥
share	ʃ ə˩ r eː˩
sharhi	ʃ a˥ r h iː˩
sharhin	ʃ ə˩ r h ɪ˥ ŋ
shari'a	ʃ ə˩ r ɪ˥ ʔ aː˩
sharia	ʃ ə˩ r ɪ˥ aː˩
sharif	ʃ ə˩ r ɪ˥˦ ɸ
sharifi	ʃ ə˩ r iː˥ ɸ iː˩
shark	ʃ ə˩ r k
sharo	ʃ ə˥ r o˩
sharri	ʃ a˥ r iː˩
sharrudan	ʃ a˥ r uː˥ d a˥˦ ŋ
sharu	ʃ ə˩ r uː˥˦
sharuda	ʃ ə˩ r uː˥ d aː˩
sharuddan	ʃ ə˩ r uː˥ d a˥˦ ŋ
sharuɗan	ʃ ə˩ r uː˥˦ ɗ a˥˦ ŋ
sharuɗɗan	ʃ ə˩ r uː˥˦ ɗ a˥˦ ŋ
shashasha	ʃ a˥ s h ə˥ ʃ ə˩
shat	ʃ a˥˦ t
shawara	ʃ a˩ w aː˥ r aː˩
shawara'	ʃ a˩ w aː˥ r ə˥ ʔ
shawarar	ʃ a˩ w aː˥ r a˩ r
shawararsa	ʃ a˩ w aː˥ r a˩ r aː˩
shawarci	ʃ ə˥ w a˥ ɽ tʃ iː˥
shawarwari	ʃ ə˥ w a˩ r w a˥ r iː˩
shawarwarin	ʃ ə˥ w a˩ r w a˥ r ɪ˥ ŋ
shawarwrin	ʃ a˩ w aː˥ ɽ w ɽ ɪ˥ ŋ
shawo	ʃ a˩ w oː˩
shawwal	ʃ a˩ w a˥˦ l
shayar	ʃ aː˥ j ɛ˥ r
shayarwa	ʃ aː˩ j ɛ˩ ɽ w aː˥
shayi	ʃ aː˥ j ɪ˩
shayi	ʃ aː˩ j iː˥
shayin	ʃ aː˥ j ɪ˩ ŋ
shaƙa	ʃ ə˩ kʼ ə˩
shaƙatawar	ʃ a˥˦ kʼ aː˩ t aː˥ w a˥ r
shaƙe	ʃ ə˩ cʼ eː˩
shaɗaya	ʃ ə˥ ɗ ɛ˥ j aː˩
shebab	ʃ eː˩ b a˩ b
sheda	ʃ eː˥ d aː˩
shehi	ʃ eː˥ h iː˩
shehu	ʃ eː˥ h uː˩
shehun	ʃ eː˥ h ʊ˩ ŋ
sheila	ʃ eː˩ iː˥ l aː˩
shekara	ʃ eː˩ k ə˥ ɽ aː˩
shekarar	ʃ eː˩ k ə˩ ɽ r
shekarau	ʃ eː˩ k ə˩ ɽ aw˥
shekaru	ʃ eː˩ k ə˥ ɽ uː˥
shekarun	ʃ eː˩ k ə˥ ɽ ɪ˥ ŋ
shekarunka	ʃ eː˩ k ə˥ ɽ ɪ˥ ŋ k aː˥
shekarunki	ʃ eː˩ k ə˥ ɽ ɪ˩ n c iː˩
shekarunsa	ʃ eː˩ k ə˩ r uː˥ n s aː˩
shekarunsu	ʃ eː˩ k ə˥ ɽ ɪ˩ n s ɪ˩
shekarunta	ʃ eː˩ k ə˥ ɽ ɪ˩ n t aː˥
shekera	ʃ eː˥ c eː˥ ɽ aː˩
shelanta	ʃ eː˥ l a˥ n t aː˩
shell	ʃ eː˥ l
sheng	ʃ eː˩ ŋ
shenzhen	ʃ eː˥ n dʒ eː˥ ŋ
shewa	ʃ eː˩ w aː˥
sheƙa	ʃ eː˩ kʼ aː˩
sheƙeƙe	ʃ eː˩ cʼ eː˩ cʼ eː˩
shi	ʃ ɪ˥
shida	ʃ ɪ˥ d ə˩
shidda	ʃ ɪ˥ d ə˩
shifta	ʃ ɪ˥ ɸ t aː˩
shiga	ʃ ɪ˥ ɡ aː˩
shigab	ʃ ɪ˥ ɡ ə˥ b
shigad	ʃ ɪ˥ ɡ ə˥ d
shigar	ʃ ɪ˥ ɡ r
shigata	ʃ ɪ˥ ɡ aː˩ t ə˥
shige	ʃ ɪ˥ ɟ e˥
shigi	ʃ ɪ˥ ɟ iː˥
shigo	ʃ ɪ˥ ɡʷ oː˩
shigowa	ʃ ɪ˥ ɡʷ oː˩ w aː˥
shigowar	ʃ ɪ˥ ɡʷ oː˩ w a˥ r
shihuang	ʃ ɪ˥ h uː˥ a˥ ŋ
shimfida	ʃ ɪ˥ m ɸ iː˥ d aː˩
shimfidu	ʃ ɪ˥ m ɸ iː˥ d ɪ˩
shin	ʃ ɪ˥ ŋ
shine	ʃ ɪ˩ n e˥
shinge	ʃ ɪ˥ ɲ ɟ eː˥
shinkafa	ʃ ɪ˩ ŋ k aː˥ ɸ aː˥
shiraz	ʃ ɪ˥ r ə˩ z
shiri	ʃ ɪ˩ r iː˥
shirim	ʃ ɪ˩ ɽ ɪ˩ m
shirin	ʃ ɪ˥ ɽ ɪ˥ ŋ
shirinki	ʃ ɪ˥ ɽ ɪ˥ ɲ c iː˩
shirinmu	ʃ ɪ˥ ɽ ɪ˥ ɲ m uː˩
shirinsa	ʃ ɪ˥ ɽ ɪ˥ n s aː˩
shiriya	ʃ ɪ˥ r ɪ˩ j aː˥
shirka	ʃ ɪ˥ r k aː˩
shirley	ʃ ɪ˥ r l eː˩ j
shirme	ʃ ɪ˩ r m eː˩
shiru	ʃ ɪ˥ ɽ uː˥
shirun	ʃ ɪ˥ r ɪ˩ ŋ
shirya	ʃ ɪ˥ r j aː˩
shirye	ʃ ɪ˥ r j eː˥
shiryen	ʃ ɪ˥ r j eː˥ ŋ
shisha	ʃ ɪ˥ ʃ ə˩
shishigi	ʃ ɪ˥ ʃ ɪ˥ ɟ iː˥
shisshigi	ʃ ɪ˥ s ʃ ɪ˥ ɟ iː˥
shiyoyyi	ʃ ɪ˥ j oː˩ j iː˩
shiyya	ʃ ɪ˥ j aː˩
shiyyar	ʃ ɪ˥ j ɛ˥ r
shiyyoyi	ʃ ɪ˥ j oː˩ j ɪ˥
shiyyoyin	ʃ ɪ˥ j oː˩ j ɪ˥ ŋ
shizhen	ʃ ɪ˥ dʒ eː˥ ŋ
shu	ʃ uː˥
shu'umi	ʃ ɪ˥ ʔ ʊ˩ m iː˥
shudi	ʃ uː˥ d iː˩
shugaba	ʃ uː˥ ɡ aː˩ b ə˥
shugaban	ʃ uː˥ ɡ ə˥ b a˩ ŋ
shugabanci	ʃ uː˥ ɡ aː˩ b a˥ n tʃ iː˥
shugabancin	ʃ uː˥ ɡ aː˩ b a˥ n tʃ ɪ˩ ŋ
shugabanni	ʃ uː˥ ɡ aː˩ b a˥ n iː˩
shugabannin	ʃ uː˥ ɡ aː˩ b a˥ n ɪ˥ ŋ
shugabanta	ʃ uː˥ ɡ ə˥ b a˩ n t aː˥
shugabar	ʃ uː˥ ɡ ə˥ b a˩ r
shuka	ʃ uː˥ k aː˩
shuke	ʃ uː˥ c eː˥
shun	ʃ ɪ˥ ŋ
shuni	ʃ uː˥ n iː˩
shuya	ʃ uː˥ j aː˩
shuɗi	ʃ uː˥ ɗ iː˩
si	s iː˥
sichuan	s ɪ˥ tʃ uː˥ a˥˦ ŋ
sida	s iː˥ d aː˩
sifanish	s ɪ˥ ɸ aː˩ n ɪ˥ ʃ
sifar	s ɪ˥ ɸ a˩ r
siffanta	s ɪ˥ ɸ a˩ n t aː˥
siffar	s ɪ˥ ɸ a˩ r
sifili	s ɪ˥ ɸ ɪ˩ l iː˥
sifiri	s ɪ˥ ɸ ɪ˩ r iː˥
sifofin	s ɪ˥ ɸ oː˥ ɸ ɪ˩ ŋ
siga	s iː˥ ɡ aː˩
sigar	s iː˥ ɡ aː˩ r
sigari	s iː˥ ɡ ə˩ r iː˥
sigarin	s iː˥ ɡ ə˩ r ɪ˥ ŋ
sigogin	s ɪ˥ ɡʷ oː˩ ɟ ɪ˩ ŋ
sikatana	s ɪ˥ k ə˥ t aː˥ n aː˩
siket	s ɪ˩ c a˥ t
sila	s ɪ˥ l aː˩
silalla	s iː˥ l a˥ l aː˩
silba	s iː˥ l b aː˩
sili	s iː˥ l iː˩
siliki	s iː˥ l ɪ˩ c iː˥
silin	s iː˥ l ɪ˩ ŋ
silk	s iː˥ l k
silma	s iː˥ l m aː˥
simbarashe	s ɪ˩ m b ə˥ r ə˥ ʃ e˥
simintin	s ɪ˩ m ɪ˥ n t ɪ˥ ŋ
sin	s ɪ˥ ŋ
sinadarin	s ɪ˥ n ə˥ d ə˩ r ɪ˥ ŋ
sinanci	s ɪ˥ n a˥ n tʃ iː˥
sinawa	s ɪ˥ n aː˥ w aː˥
singapore	s ɪ˩ ŋ ɡ p oː˩ ɽ eː˥
sinima	s ɪ˥ n iː˥ m aː˩
sinkayen	s ɪ˩ ŋ k aː˩ j eː˥ ŋ
sinnawa	s ɪ˥ n aː˥ w aː˥
sir	s ɪ˥ r
sirdi	s ɪ˥ r d iː˩
siririyar	s iː˥ r ɪ˥ r ɪ˩ j ɛ˥ r
siriya	s iː˥ r ɪ˥ j ɛ˩
sirleaf	s ɪ˥ r l eː˩ ɸ
sirri	s ɪ˥ r iː˩
sirrin	s ɪ˥ r ɪ˥ ŋ
sirrinka	s ɪ˥ r ɪ˩ ŋ k aː˥
sisi'	s ɪ˥ s ɪ˥ ʔ
sista	s ɪ˥ s t aː˩
sitam	s ɪ˩ t a˥˦ ŋ
sitampi	s ɪ˩ t a˥ m p iː˩
sitira	s ɪ˩ t ɪ˥ r aː˩
sito	s ɪ˩ t o˥
sittin	s ɪ˩ t ɪ˥ ŋ
siya	s ɪ˥ j aː˩
siyan	s ɪ˥ j ɛ˩ ŋ
siyar	s ɪ˩ j ɛ˥ r
siyarwa	s ɪ˥ j ɛ˩ ɽ w aː˥
siyasa	s ɪ˩ j aː˥ s aː˩
siyasan	s ɪ˩ j aː˥ s a˩ ŋ
siyasar	s ɪ˩ j aː˥ s a˩ r
siyawa	s ɪ˩ j aː˥ w aː˥
siyayya	s ɪ˩ j ɛ˥ j aː˩
siyayyar	s ɪ˥ j ɛ˩ j ɛ˥ r
siyo	s ɪ˩ j oː˥˦
siɗik	s ɪ˥ ɗ ɪ˥ k
ski	s c iː˩
smack	s m ə˩ k
smith	s m ɪ˥ t h
so	s oː˥
soba	s oː˩ b ə˥
soci	s oː˥ tʃ ɪ˩
soja	s oː˥ dʒ ə˩
sojan	s oː˥ dʒ a˥ ŋ
soji	s oː˥ dʒ iː˥
sojin	s oː˥ dʒ ɪ˩ ŋ
sojoji	s oː˥ dʒ ɔ˩ dʒ iː˥
sojojin	s oː˥ dʒ ɔ˩ dʒ ɪ˩ ŋ
sojojinsa	s oː˥ dʒ ɔ˩ dʒ ɪ˥ n s aː˩
sojojinta	s oː˥ dʒ ɔ˩ dʒ ɪ˥ n t aː˩
soke	s oː˥ c eː˥
soki	s oː˥ c iː˩
sol	s ɔ˥ l
soma	s oː˩ m ə˩
somalia	s oː˥ m aː˥ l ɪ˩ aː˩
somaliya	s oː˥ m aː˥ l ɪ˩ j aː˥
somi	s oː˥ m iː˩
son	s oː˥ ŋ
song	s oː˥ ŋ
sonsa	s oː˩ n s aː˩
sosai	s oː˩ s aj˥
soso	s oː˩ s oː˥
soyayya	s oː˩ j ɛ˥ j aː˩
soyayyar	s oː˩ j ɛ˥ j ɛ˥ r
soyayyen	s oː˩ j ɛ˥ j eː˥ ŋ
soye	s oː˩ j eː˥
spaghetti	s p ə˩ ɡʷ h eː˥ t ɪ˥
spain	s p ɪ˩ ŋ
spaniya	s p aː˥ n ɪ˥ j ɛ˩
spencer	s p eː˥ n tʃ eː˥ r
spherical	s ɸ eː˥ r ɪ˥ tʃ a˩ l
sraila	s r aj˥ l aː˩
sri	s r iː˩
state	s t aː˥ t e˥
stated	s t ə˥ sʼ a˩ d
states	s t aː˩ t eː˥ s
stephen	s t eː˥ ɸ eː˥ ŋ
steroids	s t eː˥ r oː˥ iː˥ d s
su	s uː˩
subhanahu	s ɪ˥ b h aː˥ n ə˥ h ʊ˩
subpleural	s ɪ˥ b p l eː˩ uː˥ r a˥˦ l
sudan	s uː˥ d a˥˦ ŋ
sufana	s ɪ˩ ɸ aː˥ n aː˩
sufuri	s ɪ˥ ɸ ʊ˩ r iː˩
sui	s ɪ˥ iː˩
sujada	s uː˥ dʒ ə˥ d aː˩
suje	s uː˥ dʒ e˩
sujjada	s ɪ˩ dʒ ə˥ d aː˩
suka	s ɪ˥ k aː˩
sukan	s ɪ˥ k a˩ ŋ
sukar	s ɪ˥ k a˩ r
sukari	s ɪ˥ k ə˩ r iː˥
suke	s uː˥ c eː˥
sukuku	s ɪ˩ kʷ ʊ˩ kʷ ʊ˩
sukuni	s ɪ˩ kʷ ʊ˩ n iː˩
sukuwa	s ɪ˩ kʷ ʊ˩ w aː˥
sukuwar	s ɪ˩ kʷ ʊ˥ w a˥ r
sulaiman	s ɪ˥ l aj˥ m a˩ ŋ
sule	s ɪ˥ l eː˩
sulemani	s ɪ˥ l eː˩ m aː˥ n iː˩
sulemanu	s ɪ˥ l eː˩ m aː˥ n ɪ˩
sulhu	s ɪ˥ l h ʊ˩
sum	s ɪ˩ m
sumabatar	s ɪ˥ m ə˥ b a˩ t a˩ r
sumba	s ɪ˥ m b aː˩
sumbace	s ɪ˥ m b ə˩ tʃ eː˩
sumbaci	s ɪ˥ m b aː˩ tʃ iː˥
sumbantar	s ɪ˥ m b a˩ n t a˩ r
sumbata	s ɪ˥ m b ə˥ t aː˩
sumbatarka	s ɪ˥ m b ə˥ t a˩ r k aː˥
sumul	s ɪ˥ m ʊ˥ l
sun	s ɪ˩ ŋ
suna	s uː˥ n aː˥
sunan	s uː˩ n a˥˦ ŋ
sunanka	s uː˥ n a˥ ŋ k aː˥
sunans	s uː˥ n aː˥ n s
sunansa	s uː˥ n aː˥ n s aː˩
sunanta	s uː˥ n a˥ n t aː˩
sunaye	s uː˥ n aː˩ j eː˥
sunayen	s uː˥ n aː˩ j eː˥ ŋ
sunbaci	s ɪ˩ n b aː˩ tʃ iː˥
sunduƙi	s ɪ˩ n d uː˥ cʼ iː˩
sune	s ɪ˩ n e˥
sunna	s ɪ˥ n aː˩
sunyi	s ɪ˩ n j iː˥
super	s ɪ˥ p eː˥ r
superman	s ɪ˥ p eː˥ r m a˩ ŋ
sura	s uː˥ r aː˩
sura	s uː˩ r aː˥
surar	s uː˩ r a˩ r
surarta	s uː˩ r a˥ r t aː˩
surin	s ɪ˩ r ɪ˥ ŋ
surutu	s uː˩ r ɪ˥ t ɪ˥
sut	s uː˥ t
suttura	s uː˥ t uː˥ r aː˩
suya	s uː˥ j aː˩
suzhen	s uː˥ dʒ eː˥ ŋ
suzhou	s uː˥ dʒ oː˥ uː˩
swan	s w a˥˦ ŋ
switzerland	s w iː˥ t z eː˥ ɽ l a˩ n d
syana	s j aː˥ n aː˩
syria	s j ɽ ɪ˥ aː˩
ta	t aː˩
ta'adda	t ə˩ ʔ a˥ d aː˩
ta'addace	t ə˩ ʔ a˥ d aː˩ tʃ eː˩
ta'addanci	t ə˩ ʔ a˥ d a˥ n tʃ iː˥
ta'ala	t ə˩ ʔ a˥ l aː˩
taala	t ə˩ l aː˩
taba	t aː˩ b ə˥
tabar	t ə˥ b a˩ r
tabarau	t ə˩ b aː˩ ɽ aw˥
tabarbarewa	t aː˩ b a˥ ɽ b ə˩ ɽ eː˥ w aː˥
tabarbarewar	t aː˩ b a˥ ɽ b aː˩ ɽ eː˥ w a˥ r
tabarma	t aː˩ b a˥ ɽ m aː˥
tabas	t ə˥ b a˩ s
tabbaci	t a˩ b aː˩ tʃ iː˥
tabbacin	t a˩ b aː˩ tʃ ɪ˥ ŋ
tabbas	t a˩ b a˩ s
tabbata	t a˩ b ə˥ t aː˩
tabbataccen	t a˩ b ə˥ t ə˥ tʃ eː˩ ŋ
tabbatar	t a˩ b ə˥ t a˩ r
tabki	t ə˥ b c iː˥
tabkin	t ə˥ b c ɪ˥ ŋ
tabo	t aː˩ b oː˥
tabon	t ə˥ b ɔ˩ ŋ
tace	t ə˩ tʃ eː˩
tada	t ə˩ d aː˥
tadawa	t ə˩ d ə˥ w aː˩
tafarkin	t ə˥ ɸ a˩ ɽ c ɪ˥ ŋ
tafarnuwa	t ə˥ ɸ a˩ ɽ n ʊ˥ w aː˥
tafe	t aː˥ ɸ e˥
tafi	t aː˥ ɸ iː˩
tafin	t aː˥ ɸ ɪ˥ ŋ
tafiya	t aː˥ ɸ ɪ˥ j aː˩
tafiyar	t aː˥ ɸ ɪ˥ j ɛ˥ r
tafiyarmu	t aː˥ ɸ ɪ˥ j aː˥ ɽ m uː˩
tafiyarwa	t aː˥ ɸ ɪ˥ j ɛ˩ ɽ w aː˥
tafkawa	t aː˥ ɸ k aː˥ w aː˥
tafki	t a˥ ɸ c iː˩
tafkin	t a˥ ɸ c ɪ˥ ŋ
tafsiri	t a˩ ɸ s iː˥ r iː˩
taga	t aː˥ ɡ aː˩
tagar	t ə˩ ɡ ə˩ r
tagari	t ə˩ ɡ ə˩ r iː˥
tagayyara	t aː˥ ɡ aː˩ j aː˥ r aː˩
tagomashi	t ə˥ ɡʷ oː˥ m ə˩ ʃ iː˥
tagulla	t ə˥ ɡʷ ʊ˥ l ə˩
taguwa	t aː˩ ɡʷ ʊ˥ w aː˩
taguwa	t ə˥ ɡʷ ʊ˥ w aː˩
tagwayen	t ə˥ ɡʷ aː˩ j eː˥ ŋ
taha	t ə˥ h aː˩
taibei	t ə˩ ɪ˩ b eː˥ iː˩
tailor	t ə˩ ɪ˩ l oː˥ r
taimaka	t aj˥ m ə˥ k aː˩
taimakawa	t aj˥ m ə˥ k aː˥ w aː˥
taimake	t aj˥ m ə˩ c eː˥
taimaki	t aj˥ m aː˥ c iː˩
taimako	t aj˥ m aː˥ kʷ oː˩
taimakon	t aj˥ m aː˥ kʷ oː˩ ŋ
taimakonsa	t aj˥ m aː˥ kʷ oː˩ n s aː˩
taimakonsu	t aj˥ m aː˥ kʷ oː˩ n s ɪ˩
taimakonta	t aj˥ m aː˥ kʷ oː˩ n t aː˥
taiwan	t aj˥˦ w a˩ ŋ
tajiri	t aː˥ dʒ ɪ˩ r iː˥
tak	t aː˩ k
taka	t ə˥ k aː˥
takaice	t ə˥ k aj˥ tʃ eː˩
takaici	t ə˥ k aj˥ tʃ iː˥
takaita	t ə˥ k aj˥ t ə˥
takaitaccen	t ə˥ k aj˥ t ə˥ tʃ eː˩ ŋ
takalifi	t aː˩ k a˩ l ɪ˩ ɸ iː˥
takalma	t aː˩ k a˩ l m aː˥
takalmi	t aː˩ k a˩ l m iː˥
takalmin	t aː˩ k a˩ l m ɪ˥ ŋ
takalminsa	t aː˩ k a˩ l m iː˥ n s aː˩
takamaiman	t ə˥ k aː˥ m aj˥ m a˩ ŋ
takara	t ə˥ k ə˥ r aː˩
takarar	t ə˥ k ə˥ r a˩ r
takarda	t ə˥ k a˩ r d aː˥
takardar	t ə˥ k a˩ r d a˥ r
takardu	t ə˥ k a˩ r d ɪ˩
takardun	t ə˥ k a˩ r d ɪ˩ ŋ
takardunku	t ə˥ k a˩ r d ɪ˩ ŋ kʷ ʊ˩
takawa	t ə˥ k aː˥ w aː˥
take	t ə˩ c eː˥
taken	t ə˩ c eː˥ ŋ
taki	t aː˩ c iː˥
takila	t aː˥ c ɪ˩ l ə˩
takin	t aː˥ c ɪ˩ ŋ
takobi	t ə˥ kʷ oː˩ b iː˥
takobin	t ə˥ kʷ oː˩ b ɪ˩ ŋ
takum	t aː˥ kʷ ʊ˩ ŋ
takunkumi	t aː˩ kʷ ʊ˥ ŋ kʷ ʊ˩ m iː˥
takunkumin	t aː˩ kʷ ʊ˥ ŋ kʷ ʊ˩ m ɪ˥ ŋ
takwaransa	t ə˥ kʷ ə˥ r a˥ n s ə˩
takwarorinsa	t ə˥ kʷ aː˥ ɽ oː˩ ɽ ɪ˥ n s aː˩
takwas	t ə˥ kʷ a˩ s
talabijan	t ə˩ l aː˥ b iː˩ dʒ a˥ ŋ
talabijin	t ə˩ l aː˥ b ɪ˥ dʒ ɪ˥ ŋ
talaka	t ə˥ l ə˩ k ə˩
talakar	t ə˥ l ə˩ k a˩ r
talakawa	t ə˥ l ə˩ k aː˥ w aː˥
talata	t ə˩ l aː˥ t ə˩
talatin	t ə˩ l aː˩ t ɪ˥ ŋ
talatu	t ə˩ l aː˥ t ɪ˩
talauci	t ə˩ l aw˩ tʃ iː˥
talaucin	t ə˩ l aw˩ tʃ ɪ˩ ŋ
taliban	t aː˥ l ɪ˩ b a˩ ŋ
talibijin	t aː˥ l ɪ˩ b ɪ˥ dʒ ɪ˥ ŋ
talikai	t aː˥ l ɪ˩ k aj˥
taliki	t aː˥ l ɪ˩ c iː˥
taliya	t aː˥ l ɪ˩ j aː˥
talla	t a˩ l ə˩
tallafa	t a˩ l ə˥ ɸ aː˩
tallafawa	t a˩ l ə˥ ɸ aː˥ w aː˥
tallafi	t a˩ l aː˥ ɸ iː˩
tallafin	t a˩ l ə˥ ɸ ɪ˩ ŋ
tallan	t a˩ l a˥˦ ŋ
tallata	t a˩ l aː˥ t aː˩
talle	t a˥ l eː˥
tamanin	t ə˩ m aː˩ n ɪ˥ ŋ
tambarin	t a˩ m b aː˥ r ɪ˩ ŋ
tambaya	t a˩ m b ɛ˥ j aː˩
tambayar	t a˩ m b ɛ˥ j ɛ˥ r
tambaye	t a˩ m b ɛ˥ j eː˥
tambayi	t a˩ m b ɛ˥ j iː˥
tambayoyi	t a˩ m b ɛ˥ j oː˩ j ɪ˥
tambayoyin	t a˩ m b ɛ˥ j oː˩ j ɪ˥ ŋ
tamkar	t a˩ m k a˩ r
tan	t a˩ ŋ
tana	t aː˥ n aː˥
tanada	t ə˥ n ə˥ d aː˩
tanadar	t aː˥ n aː˥ d a˥˦ r
tanadi	t aː˥ n aː˥ d iː˩
tanadin	t aː˥ n aː˥ d ɪ˩ ŋ
tanaka	t aː˩ n aː˥ k aː˩
tandu	t a˥ n d uː˥
tang	t a˥ ŋ
tangaram	t a˥ ŋ ɡ ə˩ r a˥ ŋ
tangaza	t a˥ ŋ ɡ ə˥ z aː˩
tanimu	t ə˩ n iː˥ m ʊ˩
tano	t ə˩ n oː˥˦
tantabara	t a˩ n t ə˥ b ə˩ r aː˥
tantakwashi	t a˩ n t ə˥ kʷ ə˩ ʃ iː˥
tantama	t a˩ n t ə˥ m ə˩
tantamar	t a˩ n t ə˥ m ə˩ r
tantance	t a˩ n t ə˥ n tʃ eː˩
tanti	t a˥ n t iː˩
tanzania	t a˩ n z aː˥ n ɪ˥ aː˩
tao	t ə˩ o˥
tara	t aː˥ ɽ aː˩
tara	t aː˩ ɽ aː˥
tara	t ə˥ r ə˩
tara	t ə˩ ɽ aː˥
tarabulus	t ə˥ r aː˥ b ʊ˥ l ɪ˩ s
tarar	t ə˥ r a˩ r
tarayya	t ə˥ r ɛ˥ j aː˩
tarayyar	t ə˥ r ɛ˩ j ɛ˥ r
tarbiyya	t a˩ r b ɪ˥ j aː˩
tarbiyyantar	t a˩ r b ɪ˥ j aː˩ n t a˩ r
tare	t aː˥ ɽ eː˩
tarho	t a˩ r h oː˥
tari	t aː˥ ɽ iː˥
tarihi	t aː˥ r iː˥ h iː˩
tarihi'	t aː˥ r iː˥ h ɪ˥ ʔ
tarihin	t aː˥ r iː˥ h ɪ˥ ŋ
tarihinsa	t aː˥ r iː˥ h iː˩ n s aː˩
tarin	t aː˥ ɽ ɪ˥ ŋ
tarjama	t a˩ r dʒ ə˥ m aː˩
tarko	t a˩ r kʷ oː˩
tarnakin	t a˥ r n aː˥ c ɪ˩ ŋ
tarnatsa	t a˥ r n ə˥ sʼ aː˥
taro	t aː˥ ɽ oː˩
taron	t aː˥ ɽ oː˩ ŋ
tartsatsin	t aː˥ ɽ sʼ ə˥ sʼ ɪ˥ ŋ
taru	t aː˥ ɽ uː˥
taruruka	t aː˥ ɽ ɪ˥ ɽ ɪ˥ k aː˩
tarwatse	t aː˥ ɽ w ə˥ sʼ e˩
tasa	t aː˥ s aː˩
tasalla	t ə˥ s a˥ l ə˩
tasani	t a˥ s aː˥ n iː˩
tasha	t ə˥ ʃ ə˩
tashar	t aː˩ s h a˩ r
tashe	t ə˥ ʃ e˥
tashen	t ə˥ ʃ e˥ ŋ
tashi	t ə˩ ʃ iː˥
tashin	t ə˩ ʃ ɪ˥˦ ŋ
tashoshin	t aː˩ s h oː˥ ʃ ɪ˥ ŋ
tasi	t aː˩ s iː˥˦
tasiri	t ə˩ s iː˥ r iː˩
tasirin	t ə˩ s iː˥ r ɪ˥ ŋ
tasiu	t ə˩ s iː˥ uː˩
taska	t a˥ s k aː˩
tasku	t a˥ s kʷ ʊ˩
taso	t a˥ s oː˥
tasoshin	t a˥ s oː˥ ʃ ɪ˥ ŋ
tasowa	t a˥ s oː˥ w aː˩
taswira	t aː˩ s w iː˥ r aː˩
tatsuniya	t ə˥ sʼ ɪ˥ n ɪ˥ j ɛ˩
tatsuniyar	t ə˥ sʼ ɪ˥ n ɪ˥ j ɛ˥ r
tatsuniyoyi	t ə˥ sʼ ɪ˥ n ɪ˥ j oː˩ j ɪ˥
tatsuniyoyin	t ə˥ sʼ ɪ˥ n ɪ˥ j oː˩ j ɪ˥ ŋ
tattabara	t a˩ t ə˥ b ə˩ r aː˥
tattaki	t a˩ t aː˩ c iː˥
tattalin	t a˩ t aː˥ l ɪ˩ ŋ
tattara	t a˩ t aː˥ r aː˩
tattare	t a˩ t aː˥ r e˩
tattauinawa	t a˩ t aw˥ ɪ˥ n aː˥ w aː˥
tattauna	t a˩ t aw˥ n aː˩
tattaunarmu	t a˩ t aw˥ n a˩ r m uː˩
tattaunawa	t a˩ t aw˥ n aː˥ w aː˥
tattaunawar	t a˩ t aw˥ n w a˥ r
tattausan	t a˩ t aw˥ s a˩ ŋ
tattaɓa	t a˩ t ə˥ ɓ ə˥
tattoo	t a˩ t o˥
tatul	t aː˩ t ɪ˥ l
taubashi	t aw˥ b aː˩ ʃ iː˥
tauhidi	t aw˩ h iː˥ d iː˩
tauna	t aw˥ n aː˩
taurari	t aw˩ ɽ aː˥ ɽ iː˥
tauraro	t aw˩ ɽ aː˥ ɽ oː˩
tauraron	t aw˩ ɽ aː˥ ɽ oː˩ ŋ
taure	t aw˥ ɽ eː˩
tauri	t aw˥ ɽ iː˥
tausa	t aw˩ s aː˥
tausayi	t aw˩ s aː˩ j iː˥
tausayin	t aw˩ s aː˩ j ɪ˩ ŋ
taushi	t aw˥ ʃ iː˥
tautau	t aw˥ t aw˩
tawada	t ə˩ w ə˥ d aː˩
tawaga	t ə˩ w aː˥ ɡ aː˥
tawagar	t aː˥ w ə˩ ɡ ə˩ r
tawaye	t aː˩ w ɛ˥ j eː˥
tawayen	t aː˩ w ɛ˥ j eː˥ ŋ
tawul	t aː˩ w ʊ˥ l
taya	t aː˩ j aː˥
tayan	t aː˩ j ŋ
tayar	t aː˩ j ɛ˥ r
tayi	t aː˩ j iː˥
tayin	t aː˥ j ɪ˩ ŋ
tayoyin	t aː˩ j oː˩ j ɪ˥ ŋ
taƙaita	t ə˩ kʼ aj˥ t ə˥
taɓa	t ə˥ ɓ ə˥
taɓin	t ə˩ ɓ ɪ˩ ŋ
taɓo	t ə˩ ɓ oː˥
tchima	tʃ iː˥ m aː˩
tebur	t eː˥ b ʊ˥ r
teburi	t eː˩ b ʊ˩ r iː˩
teburin	t eː˩ b ʊ˩ r ɪ˥ ŋ
teddy	t eː˥ d j
tef	t e˥ ɸ
tehran	t eː˥ h r a˩ ŋ
teku	t eː˩ kʷ ʊ˥
tekun	t eː˩ kʷ ʊ˥ ŋ
tel	t eː˥ l
tela	t eː˥ l ə˩
telebijin	t eː˥ l eː˥ b ɪ˥ dʒ ɪ˥ ŋ
tennis	t eː˥ n ɪ˥˦ s
terry	t eː˥ r j
thailand	t h aj˥ l a˩ n d
thomas	t h oː˥ m a˩ s
ti	t iː˥˦
tian	t ɪ˥˦ a˥˦ ŋ
tianjin	t ɪ˥˦ a˥ n dʒ ɪ˩ ŋ
tibet	t ɪ˩ b eː˥ t
tif	t ɪ˥˦ ɸ
tifa	t iː˥ ɸ aː˩
tijara	t ɪ˩ dʒ aː˥ r aː˩
tijjani	t ɪ˥˦ dʒ ə˥ n iː˥
tijjania	t ɪ˥˦ dʒ ə˥ n iː˥ aː˩
tik	t ɪ˥˦ k
tikitin	t ɪ˩ c ɪ˩ t ɪ˥ ŋ
tilas	t iː˥ l a˩ s
tilasta	t iː˥ l a˩ s t aː˩
tilastawa	t iː˥ l a˩ s t aː˥ w aː˥
tilo	t iː˩ l oː˥
tim	t ɪ˥˦ m
tim	t ɪ˥˦ ŋ
times	t ɪ˥˦ m eː˥ s
tina	t ɪ˥ n aː˩
tire	t ɪ˩ r e˥
tiriliyan	t ɪ˩ r ɪ˥ l ɪ˩ j aː˥ ŋ
tis'in	t ɪ˩ s ʔ ɪ˥ ŋ
titi	t iː˥ t iː˩
titin	t ɪ˩ t ɪ˥ ŋ
tituna	t iː˥ t ɪ˩ n aː˩
tiyata	t ɪ˩ j aː˥ t aː˩
tiyatan	t ɪ˩ j aː˥ t a˩ ŋ
tiƙis	t ɪ˥ cʼ ɪ˥ s
to	t o˥
tofa	t oː˥ ɸ aː˩
togo	t oː˥ ɡʷ o˥
toh	t oː˥ ʃ
toka	t oː˩ k aː˥
tokyo	t oː˩ k aː˥ j oː˥˦
ton	t a˥ ŋ
tona	t oː˥ n aː˥
tonne	t oː˥ n e˥
tono	t oː˥ n oː˩
tony	t oː˥ n ɪ˩
toshiya	t oː˥ ʃ ɪ˥ j aː˥
toure	t oː˩ ʊ˩ ɽ eː˥
tozali	t oː˥ z ə˩ l iː˥
tozo	t oː˥ z oː˥
trump	t ɽ ɪ˥ m p
tsabar	sʼ ə˥ b a˩ r
tsabga	sʼ a˥ b ɡ aː˩
tsabta	sʼ a˥ b t aː˩
tsabtacewar	sʼ a˥ b t aː˩ tʃ eː˥ w a˥ r
tsada	sʼ aː˥ d ə˥
tsaf	sʼ a˥ p
tsaffin	sʼ a˥ ɸ ɪ˩ ŋ
tsaftar	sʼ a˥ ɸ t a˩ r
tsagaita	sʼ ɡ aj˥ t ə˥
tsageran	sʼ ə˥ ɟ eː˥ r a˩ ŋ
tsaho	sʼ aː˥ h oː˩
tsahon	sʼ ə˥ h oː˥ ŋ
tsahona	sʼ ə˥ h oː˥ n aː˥
tsai	sʼ aj˥
tsaida	sʼ iː˥ d aː˩
tsaka	sʼ ə˥ k aː˥
tsaka	sʼ ə˥ k ə˩
tsakani	sʼ ə˥ k aː˥ n iː˥
tsakanin	sʼ ə˥ k aː˩ n ɪ˥ ŋ
tsakaninmu	sʼ ə˥ k aː˥ n iː˥ n m uː˩
tsakaninsa	sʼ ə˥ k aː˥ n iː˥ n s aː˩
tsakaninsu	sʼ ə˥ k aː˥ n iː˥ n s ɪ˩
tsakaninta	sʼ ə˥ k aː˥ n ɪ˥ n t aː˩
tsakar	sʼ ə˥ k a˩ r
tsakiya	sʼ ə˥ c ɪ˩ j aː˥
tsakiyar	sʼ ə˥ c ɪ˩ j ɛ˥ r
tsalala	sʼ ə˥ l ə˥ l ə˥
tsallaka	sʼ a˥ l aː˥ k aː˥
tsallake	sʼ a˥ l aː˩ c eː˥
tsalle	sʼ a˥ l eː˥
tsamani	sʼ a˩ m aː˥ n iː˩
tsami	sʼ a˩ m iː˥
tsammani	sʼ a˥ m aː˥ n iː˩
tsammanin	sʼ a˥ m aː˩ n ɪ˥ ŋ
tsamo	sʼ a˩ m oː˥
tsana	sʼ ə˥ n ə˥
tsanake	sʼ ə˥ n aː˥ c eː˥
tsanaki	sʼ ə˥ n aː˥ c iː˩
tsanani	sʼ ə˥ n aː˥ n iː˩
tsananin	sʼ ə˥ n aː˥ n ɪ˥ ŋ
tsananni	sʼ ə˥ n ə˥ n iː˩
tsananta	sʼ ə˥ n a˩ n t aː˥
tsanantar	sʼ ə˥ n a˩ n t a˩ r
tsanarta	sʼ ə˥ n a˩ r t aː˩
tsane	sʼ ə˥ n e˥
tsangwama	sʼ a˥ ŋ ɡʷ aː˥ m aː˩
tsani	sʼ ə˥ n iː˥
tsanyawa	sʼ ɛ˥ ɲ j aː˥ w aː˥
tsara	sʼ ə˥ r aː˩
tsare	sʼ ə˥ ɽ eː˩
tsari	sʼ ɽ iː˥
tsarin	sʼ aː˥ ɽ ɪ˥ ŋ
tsarki	sʼ a˥ ɽ c ɪ˥
tsaro	sʼ ə˥ r o˩
tsaron	sʼ a˥ r ɔ˩ ŋ
tsattsauran	sʼ aː˩ t s aw˥ r a˩ ŋ
tsauni	sʼ aw˥ n iː˩
tsaunin	sʼ aw˥ n ɪ˥ ŋ
tsaunuka	sʼ aw˥ n ɪ˥ k aː˩
tsaunukan	sʼ aw˥ n ɪ˥ k a˩ ŋ
tsawa	sʼ aː˥ w aː˥
tsawan	sʼ w a˥˦ ŋ
tsawo	sʼ w oː˩
tsawon	sʼ w oː˩ ŋ
tsawonsa	sʼ w oː˩ n s aː˩
tsawonsu	sʼ w oː˩ n s ɪ˩
tsawonta	sʼ w oː˩ n t aː˥
tsaya	sʼ ɛ˥ j aː˩
tsayar	sʼ aː˥ j ɛ˥ r
tsayawa	sʼ ɛ˥ j aː˥ w aː˥
tsaye	sʼ ɛ˩ j eː˥
tsayi	sʼ aː˩ j iː˥
tsayin	sʼ aː˥ j ɪ˩ ŋ
tsayinsa	sʼ aː˩ j iː˥ n s aː˩
tsayuwar	sʼ aː˩ j ʊ˥ w a˥ r
tsere	sʼ eː˥ ɽ e˥
tseren	sʼ eː˥ ɽ eː˥ ŋ
tserewa	sʼ eː˥ ɽ eː˥ w aː˥
tsibiran	sʼ ɪ˥ b ɪ˥ r a˩ ŋ
tsibiri	sʼ ɪ˩ b ɪ˥ ɽ iː˥
tsibirin	sʼ ɪ˥ b ɪ˥ ɽ ɪ˥ ŋ
tsifa	sʼ ɪ˥ ɸ aː˩
tsige	sʼ iː˥ ɟ eː˥
tsigi	sʼ iː˥ ɟ iː˥
tsila	sʼ iː˥ l ə˥
tsimin	sʼ ɪ˥ m ɪ˥ ŋ
tsinci	sʼ ɪ˥ n tʃ iː˥
tsinken	sʼ ɪ˥ ɲ c eː˥ ŋ
tsintsiya	sʼ ɪ˥ n sʼ ɪ˥ ɲ j aː˥
tsira	sʼ ɪ˥ r aː˥
tsirara	sʼ ɪ˥ r aː˥ r aː˩
tsirkiyoyi	sʼ ɪ˥ ɽ c ɪ˩ j oː˥˦ j iː˥
tsit	sʼ ɪ˥ t
tsiya	sʼ ɪ˥ ɲ j aː˥
tskanin	sʼ k aː˩ n ɪ˥ ŋ
tsofaffi	sʼ oː˥ ɸ a˥ ɸ iː˥
tsofaffin	sʼ oː˥ ɸ a˥ ɸ ɪ˩ ŋ
tsoffin	sʼ oː˥ ɸ ɪ˩ ŋ
tsoho	sʼ oː˥ h oː˥
tsohon	sʼ oː˥ h oː˥ ŋ
tsohuwa	sʼ oː˥ h ʊ˥ w aː˥
tsohuwar	sʼ oː˥ h ʊ˥ w a˥ r
tsokani	sʼ oː˥ k aː˥ n iː˩
tsokar	sʼ oː˥ k a˩ r
tsololo	sʼ oː˩ l oː˩ l oː˩
tsoma	sʼ oː˩ m ə˩
tsoran	sʼ oː˥ r a˩ ŋ
tsorata	sʼ oː˥ r aː˥ t aː˩
tsoro	sʼ oː˥ r o˩
tsoron	sʼ oː˥ r ɔ˩ ŋ
tsoronku	sʼ oː˥ r ɔ˩ ŋ kʷ ʊ˩
tsufa	sʼ ɪ˩ ɸ aː˥
tsufanta	sʼ ɪ˩ ɸ a˩ n t aː˥
tsugunar	sʼ ɪ˩ ɡʷ ʊ˥ n a˩ r
tsundum	sʼ ɪ˩ n d ɪ˥ m
tsundum	sʼ ɪ˩ n d ɪ˩ m
tsunduma	sʼ ɪ˩ n d ɪ˥ m aː˩
tsuntsaye	sʼ ɪ˥ n sʼ ɛ˩ j eː˥
tsuntsayen	sʼ ɪ˥ n sʼ ɛ˩ j eː˥ ŋ
tsuntsu	sʼ ɪ˥ n sʼ uː˥
tu	t ɪ˩
tubali	t uː˥ b ə˩ l iː˥
tubarkalla	t ɪ˩ b a˥ r k a˥ l aː˩
tuddai	t ʊ˥ d aj˥
tudu	t uː˥ d ɪ˩
tudun	t uː˥ d ɪ˩ ŋ
tufa	t ɪ˩ ɸ aː˥
tufaffi	t ɪ˩ ɸ aː˥ ɸ iː˥
tufafi	t ɪ˩ ɸ aː˥ ɸ iː˥
tufafin	t uː˥ ɸ aː˩ ɸ ɪ˩ ŋ
tufan	t ɪ˩ ɸ a˩ ŋ
tuffar	t uː˥ ɸ a˩ r
tuhuma	t ɪ˩ h ʊ˥ m aː˩
tuhumarsa	t ɪ˩ h ʊ˥ m a˩ r aː˩
tuhume	t ɪ˩ h ʊ˥ m eː˩
tuhumi	t ɪ˩ h ʊ˥ m iː˥
tujia	t uː˥ dʒ ɪ˥ aː˩
tuka	t ɪ˥ k aː˩
tukawa	t ɪ˥ k aː˥ w aː˥
tuki	t uː˥ c iː˩
tukin	t uː˥ c ɪ˥ ŋ
tukuf	t ɪ˥ kʷ ʊ˥ p
tukuna	t ɪ˩ kʷ ʊ˩ n aː˥
tukunna	t ɪ˥ kʷ ʊ˥ n aː˩
tukunya	t ɪ˥ kʷ ʊ˥ ɲ j aː˥
tukunyar	t ɪ˥ kʷ ʊ˥ ɲ j ɛ˥ r
tukuru	t ɪ˥ kʷ ʊ˩ ɽ uː˥
tukwane	t ɪ˥ kʷ ə˥ n e˥
tulu	t uː˩ l uː˥
tumaki	t uː˥ m aː˩ c iː˥
tumakinsa	t uː˥ m aː˩ c iː˥ n s aː˩
tumatir	t ɪ˥ m aː˥ t ɪ˩ r
tun	t ɪ˥ ŋ
tuna	t ɪ˩ n aː˩
tunananin	t ɪ˩ n aː˥ n aː˥ n ɪ˥ ŋ
tunani	t ɪ˩ n aː˥ n iː˩
tunanin	t ɪ˩ n aː˥ n ɪ˥ ŋ
tunanina	t ɪ˩ n aː˥ n ɪ˥ n aː˩
tunaninka	t ɪ˩ n aː˥ n ɪ˩ ŋ k aː˥
tunaninki	t ɪ˩ n aː˥ n ɪ˥ ɲ c iː˩
tunaninsa	t ɪ˩ n aː˥ n ɪ˥ n s aː˩
tunaninta	t ɪ˩ n aː˥ n ɪ˥ n t aː˩
tunannin	t ɪ˩ n a˥ n ɪ˥ ŋ
tunatar	t ɪ˩ n aː˥ t a˩ r
tunatarrwa	t ɪ˩ n aː˥ t ə˩ ɽ w aː˥
tunau	t ɪ˩ n aw˥
tunawa	t ɪ˩ n aː˥ w aː˥
tunda	t ɪ˩ n d aː˩
tuni	t ɪ˩ n iː˩
tunisiya	t ɪ˩ n ɪ˥ s ɪ˥ j aː˩
tunkiya	t ɪ˩ n c ɪ˥ j aː˩
tuntu	t ɪ˥ n t uː˥
tuntube	t ɪ˥ n t uː˥ b e˩
tuntubi	t ɪ˥ n t uː˥ b iː˥
tuntuɓar	t ɪ˥ n t uː˥ ɓ a˩ r
tuo	t uː˥ o˥
tuo'	t uː˥ oː˩ ʔ
tura	t uː˥ r aː˩
turai	t uː˥ r aj˥
turanci	t uː˥ r a˥ n tʃ iː˥
turare	t ɪ˩ ɽ aː˩ ɽ eː˥
turawa	t ɪ˩ ɽ aː˥ w aː˥
turawan	t uː˥ r w a˩ ŋ
turba	t ɪ˥ ɽ b aː˩
turkey	t ɪ˥ ɽ c eː˥ j
turkiya	t ɪ˥ ɽ c ɪ˥ j aː˩
turkiyya	t ɪ˥ ɽ c ɪ˥ j aː˩
turo	t ɪ˩ ɽ oː˩
tururi	t ɪ˩ ɽ ɪ˩ ɽ iː˥
tusa	t uː˥ s aː˩
tushe	t uː˥ ʃ eː˩
tushen	t uː˥ ʃ eː˩ ŋ
tuta	t uː˥ t aː˩
tutar	t uː˥ t a˩ r
tutocin	t uː˥ t oː˥ tʃ ɪ˩ ŋ
tutu	t uː˥ t ɪ˩
tuwo	t ʊ˥ w oː˥
tuƙa	t uː˥ kʼ aː˩
tuƙawa	t uː˥ kʼ aː˥ w aː˥
tuƙi	t uː˥ cʼ iː˩
tuƙin	t uː˥ cʼ ɪ˥ ŋ
twitte	t w ɪ˥ t e˥
u	ʔ ʊ˩
uba	ʔ ʊ˩ b aː˥
ubangiji	ʔ ʊ˩ b ɛ˥ ɲ ɟ ɪ˩ dʒ iː˥
ubangijinka	ʔ ʊ˩ b ɛ˥ ɲ ɟ ɪ˩ dʒ ɪ˩ ŋ k aː˥
ubanta	ʔ ʊ˩ b a˥ n t aː˩
uda	ʔ uː˥ d ə˩
uganda	ʔ ʊ˩ ɡ a˥ n d aː˩
ugandan	ʔ ʊ˩ ɡ a˥ n d a˩ ŋ
uhammad	ʔ ʊ˩ h a˩ m ə˩ d
uk	ɪ˥ k
uku	ʔ ʊ˥ kʷ ʊ˩
ulu	ʔ uː˥ l ɪ˩
umarci	ʔ ʊ˩ m a˥ ɽ tʃ iː˥
umarni	ʔ ʊ˩ m ə˥ r n iː˥
umaru	ʔ ʊ˩ m ə˥ r ɪ˩
umra	ʔ ʊ˥ m r aː˥
umunai	ʔ ʊ˥ m ʊ˩ n aj˥
umurni	ʔ ʊ˥ m ʊ˩ r n iː˥
umurnin	ʔ ʊ˥ m ʊ˩ r n ɪ˥ ŋ
una	ʔ ʊ˩ n aː˥
unan	uː˩ n a˥˦ ŋ
ungozoma	ʔ ʊ˩ ŋ ɡʷ oː˥ z oː˩ m ə˩
ungulu	ʔ ʊ˩ ŋ ɡʷ ʊ˩ l ɪ˥
unguwar	ʔ ʊ˩ ŋ ɡʷ ʊ˥ w a˥ r
unguwarmu	ʔ ʊ˩ ŋ ɡʷ ʊ˥ w a˥ r m uː˩
unicef	ʔ ʊ˥ n ɪ˥ tʃ eː˩ p
union	ʔ ʊ˥ n ɪ˥ ɔ˩ ŋ
united	ʔ ʊ˥ n ɪ˥ t eː˥ d
uniya	ʔ ʊ˥ n ɪ˥ j ɛ˩
uranium	ʔ ʊ˩ ɽ ə˩ n iː˥ ʊ˩ ŋ
usaina	ʔ ʊ˥ s aj˩ n aː˥
ushira	ʔ ʊ˥ ʃ ɪ˩ r aː˥
ushiri	ʔ ʊ˥ ʃ ɪ˩ r iː˥
usumanu	ʔ ʊ˩ s ɪ˩ m aː˥ n ɪ˩
usur	ʔ ʊ˥ s ɪ˩ r
utane	ʔ ʊ˥ t aː˥ n e˥
utumin	ʔ ʊ˥ t ɪ˩ m ɪ˥ ŋ
uwa	ʔ ʊ˥ w aː˥
uwa	ʔ ʊ˥ w ə˥
uwan	ʔ ʊ˩ w a˥ ŋ
uwana	ʔ ʊ˩ w aː˥ n aː˩
uwanmu	ʔ ʊ˥ w a˩ n m uː˩
uwansa	ʔ ʊ˥ w a˥ n s ə˩
uwar	ʔ ʊ˥ w a˥ r
uwata	ʔ ʊ˥ w ə˥ t aː˩
uwayen	ʔ ʊ˥ w aː˩ j eː˥ ŋ
uygur	ʔ ʊ˩ j ɡʷ ʊ˩ r
uzirin	ʔ ʊ˥ z ɪ˩ r ɪ˥ ŋ
uzuri	ʔ ʊ˥ z ɪ˩ r iː˥
uƙuba	ʔ ʊ˩ kʷʼ uː˥ b aː˩
wa	w aː˩
wa'adi	w ə˥ ʔ a˩ d iː˥
wa'azi	w ə˥ ʔ a˩ z iː˥
waccan	w a˥ tʃ a˩ ŋ
wacce	w a˥ tʃ eː˩
wace	w ə˩ tʃ eː˩
wada	w aː˩ d aː˥
wada	w ə˩ d aː˥
wadai	w ə˩ d aj˥
wadan	w ə˩ d a˥˦ ŋ
wadanan	w ə˩ d ə˥ n a˩ ŋ
wadancan	w ə˩ d a˥ n tʃ a˩ ŋ
wadanda	w ə˩ d a˥ n d aː˩
wadannan	w ə˩ d a˥ n a˥˦ ŋ
wadannnan	w ə˩ d a˥ n n a˥˦ ŋ
wadansu	w aː˩ d aː˥ n s ɪ˩
wadata	w ə˩ d aː˥ t aː˩
wadatar	w ə˩ d aː˥ t a˩ r
wadatarsu	w ə˩ d aː˥ t a˩ r uː˩
wadatuwa	w ə˩ d aː˥ t ʊ˥ w aː˥
wadda	w a˥ d aː˩
wade	w ə˩ d e˩
waga	w aː˥ ɡ aː˥
wagadugu	w ə˩ ɡ ə˩ d ɪ˥ ɡʷ ʊ˩
waha	w ə˥ h aː˩
wahala	w ə˩ h a˥ l aː˩
wahalar	w ə˩ h a˥ l a˩ r
wahalhalu	w ə˩ h a˥ l h aː˥ l ɪ˩
wahaloli	w ə˩ h a˥ l oː˩ l iː˥
wahalolin	w ə˩ h a˥ l oː˩ l ɪ˩ ŋ
wai	w aj˩
waina	w aj˩ n aː˥
wainar	w aj˩ n a˩ r
waiwaya	w aj˥˦ w aː˩ j aː˥
waiwayen	w aj˥˦ w aː˩ j eː˥ ŋ
waiwayi	w aj˥˦ w aː˩ j iː˥
wajaba	w ə˥ dʒ ə˩ b aː˩
waje	w ə˥ dʒ e˩
wajen	w ə˥ dʒ eː˥ ŋ
wajena	w ə˥ dʒ ɛ˥ n aː˩
wajenda	w ə˥ dʒ ɛ˥ n d aː˩
wajenka	w ə˥ dʒ ɛ˥ ŋ k aː˥
wajensa	w ə˥ dʒ ɛ˥ n s aː˩
wajensu	w ə˥ dʒ ɛ˥ n s ɪ˩
wajibi	w aː˥ dʒ ɪ˩ b iː˥
waka	w ə˥ k aː˥
wakan	w ə˥ k a˩ ŋ
wakar	w ə˥ k a˩ r
wake	w ə˩ c eː˥
wakilai	w ə˩ c iː˥ l aj˥
wakilan	w ə˩ c iː˥ l a˥˦ ŋ
wakilansa	w ə˩ c iː˥ l aː˥ n s aː˩
wakilci	w ə˩ c iː˥ l tʃ iː˥
wakili	w ə˩ c iː˥ l iː˩
wakilin	w ə˩ c iː˥ l ɪ˩ ŋ
wakilinmu	w ə˩ c iː˥ l iː˩ n m uː˩
wakiliyar	w ə˩ c iː˥ l ɪ˩ j ɛ˥ r
wakiliyarmu	w ə˩ c iː˥ l ɪ˩ j aː˥ ɽ m uː˩
wakiltar	w ə˩ c iː˥ l t a˩ r
wakoki	w ə˩ kʷ oː˥ c iː˩
wakokin	w ə˩ kʷ oː˥ c ɪ˥ ŋ
wakokinsa	w ə˩ kʷ oː˥ c iː˥ n s aː˩
wal	w a˩ l
wala	w aː˥ l aː˥
wala	w aː˥ l aː˩
walat	w aː˥ l aː˩ t
walau	w ə˩ l aw˩
walet	w aː˥ l eː˥ t
wali	w aː˥ l iː˥
wali	w ə˩ l iː˥˦
waliyyi	w ə˩ l ɪ˥ j iː˩
walkiya	w a˩ l c ɪ˥ j aː˩
wallafa	w a˩ l ə˥ ɸ aː˩
wallahi	w a˩ l aː˥ h ɪ˩
walwala	w a˩ l w ə˩ l aː˥
walƙiya	w a˩ l cʼ ɪ˥ j aː˥
wan	w a˩ ŋ
wancan	w a˥ n tʃ a˩ ŋ
wanda	w a˩ n d aː˥
wandaa	w a˩ n d aː˥
wando	w a˩ n d oː˩
wandunanka	w a˩ n d uː˥ n a˩ ŋ k aː˥
wane	w a˩ n e˥
wanene	w aː˥ n ɛ˥ n e˥
wanensu	w aː˥ n ɛ˥ n s ɪ˩
wang	w a˥ ŋ
wani	w ə˥ n ɪ˥
wanka	w a˥ ŋ k aː˥
wanka	w a˥ ŋ k aː˩
wanke	w a˥ ŋ k eː˩
wanki	w ɛ˥ ɲ c iː˩
wanna	w a˥ n aː˩
wannan	w a˥ n a˥˦ ŋ
wanne	w a˥ n eː˩
wannene	w a˥ n eː˥ n e˥
wanwar	w a˩ m w a˥ r
wanzam	w a˩ n z a˥˦ ŋ
wanzami	w a˩ n z aː˥ m iː˩
wanzanci	w a˥ n z a˥ n tʃ iː˩
wanzar	w a˩ n z a˥˦ r
ware	w aː˥ ɽ eː˩
warewa	w ə˩ ɽ eː˥ w aː˥
wargaza	w ə˩ r ɡ ə˥ z aː˩
wargi	w aː˥ ɽ ɟ iː˥
wariyar	w aː˥ ɽ ɪ˥ j ɛ˥ r
warkar	w a˥ r k a˩ r
warke	w a˥ ɽ c eː˥
warwar	w a˩ r w a˥ r
warware	w a˩ r w a˥ r eː˩
warwarewa	w a˩ r w a˥ r eː˩ w aː˥
warwas	w a˩ r w a˥ s
warƙa	w a˥ r kʼ aː˩
wasa	w aː˩ s aː˥
wasai	w ə˥ s aj˥
wasali	w ə˥ s ə˩ l iː˥
wasan	w ə˥ s a˩ ŋ
wasanni	w ə˥ s a˥ n iː˩
wasannin	w ə˥ s a˥ n ɪ˥ ŋ
wasika	w ə˩ s ɪ˥ k aː˩
wasikar	w ə˩ s ɪ˥ k a˩ r
wasiku	w ə˩ s iː˥ kʷ ʊ˩
wasikun	w ə˩ s iː˥ kʷ ʊ˥ ŋ
wasiyya	w ə˩ s ɪ˥ j aː˩
wasiƙa	w ə˩ s iː˥ kʼ aː˩
wasiƙar	w ə˩ s iː˥ kʼ aː˩ r
wasiƙunsa	w ə˩ s iː˥ kʼ uː˥ n s aː˩
wassu	w ə˥ s ə˩ s ɪ˥
wasu	w ə˩ s ɪ˥
wasunsu	w ə˩ s ɪ˩ n s ɪ˩
wata	w ə˥ t aː˩
wata	w ə˥ t ə˥
watakila	w ə˥ t aː˥ c ɪ˩ l ə˩
watan	w ə˥ t a˩ ŋ
watanni	w ə˥ t a˥ n iː˩
watari	w ə˩ t ə˩ ɽ ɪ˥
watau	w ə˥ t aw˥
wataƙila	w ə˥ t aː˩ cʼ ɪ˥ l aː˩
wato	w ə˥ t o˥
watsa	w aː˥ sʼ aː˩
watsawa	w ə˥ sʼ aː˥ w aː˥
watsi	w ə˥ sʼ iː˥
wau	w aw˥
wauta	w aw˥ t aː˩
wautar	w aw˥ t a˩ r
wawa	w aː˥ w aː˥
wawan	w aː˥ w a˥˦ ŋ
waya	w ɛ˥ j aː˩
wayan	w ɛ˥ j ŋ
wayanda	w aː˥ j a˥ n d aː˩
wayar	w aː˥ j ɛ˥ r
wayarta	w aː˥ j ɛ˥ r t aː˩
wayata	w aː˥ j aː˥ t aː˩
waye	w aː˩ j eː˥
wayewa	w aː˩ j eː˥ w aː˩
wayewar	w aː˩ j eː˥ w a˥ r
wayin	w aː˥ j ɪ˩ ŋ
wayo	w aː˥ j oː˥˦
wayoyin	w aː˥ j oː˩ j ɪ˥ ŋ
wayoyinsu	w aː˥ j oː˥˦ j iː˥ n s ɪ˩
wayyaye	w ɛ˥ j ɛ˩ j eː˥
waƙa	w ə˥ kʼ ə˩
waƙafi	w ə˥ kʼ ə˩ ɸ iː˥
waƙar	w ə˥ kʼ a˩ r
waɗanda	w ə˥ ɗ a˥ n d aː˩
waɗannan	w ə˥ ɗ a˥ n a˥˦ ŋ
waɗanne	w ə˥ ɗ a˥ n eː˩
wei	w eː˥ iː˩
wen	w ɛ˥ ŋ
western	w ɛ˥ s t eː˥ r n
white	w h ɪ˥ t e˥
widget	w iː˥ d ɟ eː˥ t
wili	w iː˥ l iː˩
willam	w iː˥ l aː˥ m
willi'am	w iː˥ l ɪ˥ ʔ a˩ m
wofi	w oː˩ ɸ iː˥
wokaci	w oː˥ k ə˩ tʃ iː˥
wong	w oː˩ ŋ
wood	w oː˩ oː˥ d
woolworth	w oː˩ oː˥ l w oː˩ ɽ t h
wu	w ʊ˥
wuce	w ʊ˥ tʃ eː˩
wucewa	w ʊ˥ tʃ eː˥ w aː˩
wudil	w ʊ˩ d ɪ˥ l
wuhan	w ʊ˥ h a˥˦ ŋ
wuka	w ʊ˥ k aː˩
wukake	w ʊ˥ k ə˩ c eː˥
wul	w ʊ˥ l
wul	w ʊ˩ l
wulik	w ʊ˥ l ɪ˥ k
wuluk	w ʊ˥ l ɪ˥ k
wuni	w ʊ˩ n iː˩
wunin	w ʊ˥ n ɪ˥ ŋ
wurare	w ʊ˥ r aː˥ ɽ eː˩
wuraren	w ʊ˩ ɽ ə˩ ɽ eː˥ ŋ
wuri	w ʊ˥ r iː˩
wuridi	w ʊ˥ r ɪ˩ d iː˥
wurin	w ʊ˥ r ɪ˩ ŋ
wurina	w ʊ˥ r ɪ˥ n aː˩
wurjanjan	w ʊ˥ r dʒ a˥ n dʒ a˥ ŋ
wuski	w ʊ˥ s c iː˥
wuski	w ʊ˥ s c iː˩
wuta	w ʊ˥ t aː˥
wutan	w ʊ˥ t a˩ ŋ
wutar	w ʊ˥ t a˩ r
wutsiyar	w ʊ˥ t s ɪ˩ j ɛ˥ r
wuya	w ʊ˥ j aː˩
wuya	w ʊ˩ j aː˥
wuyan	w ʊ˥ j ŋ
wuyana	w ʊ˥ j aː˥ n aː˩
wuyansa	w ʊ˥ j aː˥ n s aː˩
wuyar	w ʊ˥ j ɛ˥ r
wuƙa	w ʊ˥ kʼ aː˥
ya	j aː˩
yaba	j ɛ˩ b ə˩
yabawa	j ɛ˩ b aː˥ w aː˥
yabo	j aː˥ b o˥
yace	j aː˩ tʃ eː˩
yaci	j aː˩ tʃ iː˥
yada	j aː˥ d aː˩
yadda	j ɛ˥ d ə˩
yadda	j ɛ˥˦ d ə˩
yadi	j aː˥ d iː˩
yadu	j aː˥ d ɪ˩
yaduwa	j ɛ˥˦ d ʊ˥ w aː˥
yaduwar	j ɛ˥˦ d ʊ˥ w a˥ r
yafe	j aː˥ ɸ e˥
yafi	j aː˥ ɸ iː˩
yaga	j aː˥ ɡ aː˥
yah	j ɛ˩ aː˩
yahudanci	j ɛ˥ h ʊ˥ d a˥ n tʃ iː˥
yahudawa	j ɛ˥ h ʊ˥ d ə˥ w aː˩
yakai	j ɛ˥ k aj˥
yakamata	j aː˥ k aː˩ m aː˥ t aː˩
yakan	j ɛ˥ k a˩ ŋ
yakar	j ɛ˥ k a˩ r
yakasai	j ɛ˥ k ə˥ s aj˥
yake	j ɛ˥ c eː˥
yaki	j aː˩ c iː˥
yakin	j aː˥ c ɪ˩ ŋ
yakini	j aː˩ c iː˥ n iː˩
yaks	j ɛ˥ c s
yakubu	j aː˩ kʷ ʊ˥ b ʊ˩
yallaɓai	j ɛ˥ l aː˩ ɓ aj˥˦
yaluwar	j ɛ˩ l ʊ˩ w a˥ r
yalwa	j ɛ˩ l w ə˥
yalwata	j ɛ˩ l w ə˥ t aː˩
yalwatuwa	j ɛ˩ l w ə˥ t ʊ˥ w aː˥
yamai	j ɛ˩ m aj˩
yamal	j ɛ˥ m a˩ l
yaman	j ɛ˥ m a˩ ŋ
yamen	j ɛ˥ m eː˩ ŋ
yamma	j ɛ˥ m aː˩
yammaci	j ɛ˥ m ə˩ tʃ iː˥
yammacin	j ɛ˥ m aː˩ tʃ ɪ˥ ŋ
yan	j ɛ˥ ŋ
yana	j aː˥ n aː˩
yanar	j aː˥ n a˩ r
yanayi	j aː˥ n aː˩ j iː˥
yanayin	j aː˥ n aː˥ j ɪ˩ ŋ
yanchi	j ɛ˥ ɲ tʃ iː˩
yanci	j ɛ˩ a˥ n tʃ iː˥
yang	j ɛ˥ ŋ
yangang	j ɛ˥ ŋ ɡ a˥ ŋ
yangtse	j ɛ˥ ŋ sʼ e˩
yanka	j a˥ ŋ k aː˥
yanke	j ɛ˥ ɲ c eː˥
yankewa	j ɛ˥ ɲ c eː˥ w aː˩
yanki	j ɛ˥ ɲ c iː˩
yankin	j ɛ˥ ɲ c ɪ˥ ŋ
yankuna	j ɛ˥ ɲ c ʊ˩ n aː˥
yankunan	j ɛ˥ ɲ c uː˩ n a˥˦ ŋ
yanyi	j ɛ˥ ɲ j iː˥
yanyin	j ɛ˥ ɲ j ɪ˩ ŋ
yanzi	j ɛ˥ ɲ z iː˥
yanzu	j ɛ˥ ɲ z ɪ˩
yanzun	j ɛ˥ ɲ z ɪ˩ ŋ
yao	j ɛ˥ o˥
yar	j ɛ˥ r
yar'uwata	j aː˥ ɽ ʔ ʊ˩ w aː˥ t aː˩
yara	j aː˥ ɽ aː˩
yaran	j ɛ˥ r a˩ ŋ
yaranmu	j ɛ˥ r a˩ n m uː˩
yaransu	j ɛ˥ r a˥ n s ɪ˩
yaranta	j ɛ˥ r a˩ n t aː˥
yarda	j aː˥ ɽ d aː˩
yare	j aː˥ ɽ eː˩
yaren	j aː˥ ɽ eː˥ ŋ
yari	j ɛ˩ ɽ iː˥
yarima	j ɛ˩ r iː˥ m ə˩
yarin	j aː˥ ɽ ɪ˥ ŋ
yarinya	j aː˥ ɽ ɪ˥ ɲ j aː˩
yarinyan	j aː˥ ɽ ɪ˥ ɲ j ŋ
yarinyar	j aː˥ ɽ ɪ˥ ɲ j ɛ˥ r
yarje	j aː˥ ɽ dʒ e˩
yarjejeniyar	j aː˥ ɽ dʒ eː˥ dʒ eː˥ n ɪ˩ j ɛ˥ r
yarjejeniyoyi	j aː˥ ɽ dʒ eː˥ dʒ ɛ˥ n ɪ˩ j oː˥˦ j iː˥
yarjejeniyoyin	j aː˥ ɽ dʒ eː˥ dʒ ɛ˥ n ɪ˥ j oː˩ j ɪ˥ ŋ
yarlukutar	j aː˥ ɽ l ɪ˥ kʷ uː˥ t a˩ r
yaro	j aː˥ ɽ oː˩
yaron	j aː˥ ɽ oː˩ ŋ
yaronan	j aː˥ ɽ oː˩ n a˥˦ ŋ
yarsu	j aː˥ ɽ s ɪ˩
yartsana	j aː˥ ɽ sʼ ə˥ n ə˥
yasa	j aː˥ s aː˩
yasan	j aː˥ s a˩ ŋ
yashi	j ɛ˩ ə˩ ʃ iː˥
yashin	j ɛ˩ ə˩ ʃ ɪ˥˦ ŋ
yatsa	j aː˥ sʼ aː˩
yatsu	j aː˥ sʼ uː˥
yatsun	j aː˥ sʼ ɪ˩ ŋ
yatsunmu	j aː˥ sʼ ɪ˥ n m uː˩
yau	j aw˥
yauki	j aw˥ c iː˥
yaushe	j aw˥ ʃ eː˩
yautai	j aw˥ t aj˥
yawa	j aː˥ w aː˥
yawan	j ɛ˥ w a˥˦ ŋ
yawanci	j aː˥ w a˥ n tʃ iː˥
yawancin	j aː˥ w a˥ n tʃ ɪ˩ ŋ
yawancinsu	j aː˥ w a˥ n tʃ iː˩ n s ɪ˩
yawansa	j aː˥ w a˥ n s ə˩
yawansu	j aː˥ w ə˩ n s ɪ˩
yawo	j ɛ˥ w oː˩
yawon	j ɛ˥ w ɔ˩ ŋ
yawun	j ɛ˥ w ʊ˩ ŋ
yaya	j ɛ˥ j aː˩
yayana	j ɛ˥ j aː˥ n aː˩
yayansu	j ɛ˥ j aː˥ n s ɪ˩
yayata	j ɛ˥ j aː˥ t aː˩
yayi	j ɛ˥ j iː˥
yayin	j ɛ˩ j ɪ˩ ŋ
yayinda	j ɛ˥ j iː˥ n d aː˩
yayyafi	j ɛ˥ j ɛ˥ ɸ iː˥
yaƙarta	j ɛ˩ kʼ a˥ r t aː˩
yaƙi	j ɛ˥ cʼ iː˥
yaƙin	j ɛ˩ cʼ ɪ˥ ŋ
yaƙubu	j aː˩ kʷʼ ʊ˥ b ʊ˩
yaɗa	j ɛ˥ ə˥ ɗ aː˩
yaɗuwar	j aː˥ ɗ ʊ˥ w a˥ r
yen	j eː˥ ŋ
yi	j iː˥
yii	j ɪ˥˦ iː˩
yijin	j ɪ˥ dʒ ɪ˥ ŋ
yin	j ɪ˥˦ ŋ
ying	j ɪ˥ ŋ
yini	j iː˥ n iː˩
yinsa	j iː˥ n s aː˩
yinsu	j iː˥ n s ɪ˩
yinwa	j iː˥ n w aː˥
yis	j ɪ˥˦ s
yiwa	j iː˥ w aː˩
yiwu	j iː˥ w ʊ˥
yiwuwa	j iː˥ w ʊ˥ w aː˥
yiwuwar	j iː˥ w ʊ˥ w a˥ r
yola	j oː˩ l ə˩
yolar	j oː˩ l a˩ r
york	j oː˩ ɽ k
you	j oː˥˦ uː˩
younusi	j oː˩ ʊ˩ n ɪ˩ s iː˩
yu	j uː˥
yuan	j uː˥ a˥˦ ŋ
yuanzhang	j uː˥ a˩ n dʒ a˥ ŋ
yuganda	j ʊ˩ ɡ a˥ n d ə˩
yuli	j uː˥ l ɪ˩
yumbu	j uː˥ m b uː˥
yun	j uː˥ n
yunan	j uː˩ n a˥˦ ŋ
yunananci	j uː˥ n aː˥ n a˥ n tʃ iː˥
yuni	j uː˥ n ɪ˩
yunkurin	j uː˥ n kʷ ʊ˩ ɽ ɪ˥ ŋ
yunnan	j uː˥ n a˥˦ ŋ
yunwa	j uː˥ n w aː˥
yunƙurin	j uː˥ n kʷʼ ʊ˩ r ɪ˥ ŋ
yusuf	j uː˥ s ɪ˥ ɸ
yusufa	j uː˥ s ɪ˥ ɸ aː˩
yusufl	j uː˥ s ɪ˥ ɸ l
yusufn	j uː˥ s ɪ˥ ɸ ŋ
yusufu	j uː˥ s ɪ˥ ɸ ʊ˩
yuwuwar	j uː˥ w ʊ˥ w a˥ r
za	z aː˩
za'a	z aː˥ ʔ aː˩
za'ayi	z aː˥ ʔ aː˩ j iː˥
za'ida	z aː˥ ʔ ɪ˥ d aː˩
zaa	z aː˥
zab'e	z ə˩ b ʔ eː˩
zaba	z aː˩ b ə˥
zabarjadi	z ə˥ b a˩ r dʒ ə˥ d iː˩
zabe	z ə˥ b e˩
zaben	z ə˩ b eː˥ ŋ
zabi	z ə˩ b iː˥
zabiya	z ə˥ b ɪ˩ j aː˥
zaci	z ə˩ tʃ iː˥
zafaran	z aː˩ ɸ ə˩ r a˥˦ ŋ
zafi	z aː˥ ɸ iː˩
zafin	z aː˩ ɸ ɪ˩ ŋ
zaga	z aː˥ ɡ aː˥
zagaye	z aː˥ ɡ aː˩ j eː˥
zagi	z ə˥ ɟ iː˩
zahiri	z aː˥ h ɪ˩ r iː˥
zai	z aj˥
zaiba	z aj˥ b aː˩
zainab	z aj˩ n ə˥ b
zainabns	z aj˩ n ə˥ b n s
zainabt	z aj˩ n ə˥ b t
zainabtu	z aj˩ n ə˥ b t ɪ˩
zainabu	z aj˩ n ə˥ b ʊ˩
zaiti	z aj˥ t iː˩
zaitun	z aj˩ t ɪ˥˦ ŋ
zaiyi	z aj˩ j iː˥
zaizayewar	z aj˥ z aː˩ j eː˥ w a˥ r
zaka	z a˩ k aː˩
zakara	z a˩ k aː˥ r aː˩
zaki	z aː˥ c iː˩
zakin	z aː˥ c ɪ˩ ŋ
zakka	z a˩ k k aː˥
zaku	z aː˥ kʷ ʊ˩
zakuna	z aː˥ kʷ ʊ˩ n aː˥
zalika	z aː˥ l ɪ˩ k aː˥
zama	z aː˥ m aː˩
zaman	z aː˥ m a˩ ŋ
zamani	z aː˥ m ə˩ n iː˥
zamani	z aː˩ m aː˥ n iː˩
zamanin	z ə˩ m aː˩ n ɪ˥ ŋ
zamanka	z aː˥ m a˥ ŋ k aː˥
zamanni	z aː˥ m ə˩ n iː˩
zamansa	z aː˥ m ə˩ n s aː˩
zamansu	z aː˥ m ə˩ n s ɪ˩
zamanta	z aː˥ m ə˩ n t ə˩
zamantakewa	z aː˥ m ə˩ n t ə˩ c eː˥ w aː˩
zamantakewar	z aː˥ m ə˩ n t ə˩ c eː˥ w a˥ r
zamanto	z aː˥ m ə˩ n t o˥
zamba	z a˩ m b ə˥
zambia	z a˩ m b iː˥ aː˩
zambiya	z a˩ m b ɪ˩ j aː˥
zame	z a˥ m eː˩
zamfara	z aː˥ m ɸ ə˥ r aː˩
zamo	z a˩ m oː˥
zamowa	z a˩ m oː˥ w aː˩
zamu	z aː˥ m ʊ˩
zan	z a˩ ŋ
zana	z aː˥ n aː˩
zanar	z ə˥ n a˩ r
zance	z a˥ n tʃ eː˩
zandar	z a˩ n d a˥˦ r
zane	z a˩ n e˥
zanen	z a˩ n eː˥ ŋ
zang	z a˥ ŋ
zanga	z a˥ ŋ ɡ aː˥
zangar	z a˥ ŋ ɡ aː˩ r
zango	z a˥ ŋ ɡʷ oː˥
zanguna	z a˥ ŋ ɡʷ ʊ˩ n aː˥
zantawa	z a˩ n t ə˥ w aː˩
zanyi	z a˩ n j iː˥
zara	z aː˩ r aː˥
zara	z ə˩ ɽ aː˥
zarafi	z aː˩ r ə˩ ɸ iː˥
zaranda	z aː˥ ɽ a˩ n d aː˥
zarar	z aː˩ r a˩ r
zarce	z a˥ ɽ tʃ eː˩
zare	z aː˥ ɽ eː˩
zare	z aː˩ ɽ eː˥
zare	z ə˥ ɽ eː˩
zare	z ə˩ ɽ eː˥
zaren	z ə˩ ɽ eː˥ ŋ
zargi	z aː˥ ɽ ɟ iː˥
zargin	z aː˥ ɽ ɟ ɪ˩ ŋ
zaria	z aː˥ ɽ ɪ˥ aː˩
zariya	z aː˥ ɽ ɪ˥ j ɛ˩
zartas	z a˥ r t a˥ s
zarto	z a˥ r t oː˩
zasu	z ə˩ s ɪ˥
zata	z aː˥ t aː˩
zati	z aː˥ t iː˩
zato	z aː˩ t o˥
zaton	z aː˥ t a˥ ŋ
zau	z aw˥
zauna	z aw˥ n aː˩
zaunannen	z aw˥ n a˥ n eː˩ ŋ
zaune	z aw˥ n e˥
zauren	z aw˥ ɽ eː˥ ŋ
zawarcin	z aː˥ w a˥ ɽ tʃ ɪ˩ ŋ
zazzabi	z a˥ z a˩ b ɪ˩
zazzabin	z a˥ z a˩ b ɪ˩ ŋ
zazzau	z a˥ z aw˩
zazzaɓi	z a˥ z ɓ iː˩
zazzaɓin	z a˥ z ɓ ɪ˩ ŋ
zaƙaƙa	z ə˩ kʼ ə˩ kʼ ə˩
zaɓa	z ə˥ ɓ ə˥
zaɓarsu	z aː˩ ɓ a˩ r uː˩
zaɓe	z ɓ e˩
zaɓi	z aː˥ ɓ iː˩
zaɓin	z aː˥ ɓ ɪ˩ ŋ
zaɓuɓɓuka	z aː˥ ɓ ʊ˩ ɓ uː˥ k aː˩
zemin	z eː˥ m ɪ˥ ŋ
zeng	z eː˩ ŋ
zhang	dʒ a˥ ŋ
zhangzhou	dʒ a˥ ŋ ɡʷ dʒ oː˥ uː˩
zhao	dʒ o˥
zhejiang	dʒ eː˥ dʒ ɪ˥ a˥ ŋ
zheng	dʒ eː˥ ŋ
zhenlin	dʒ eː˥ n l ɪ˩ ŋ
zhi	dʒ iː˩
zhou	dʒ oː˥ uː˩
zhu	dʒ ʊ˩
zhuang	dʒ uː˥ a˥ ŋ
zhumadian	dʒ uː˥ m ə˩ d ɪ˥ a˥˦ ŋ
zi	z iː˥˦
zigidir	z ɪ˩ ɟ ɪ˩ d ɪ˥ r
zik	z ɪ˥˦ k
zikiri	z ɪ˥ c ɪ˩ r iː˥
zimbabuwe	z ɪ˩ m b aː˩ b ʊ˥ w eː˩
zimbabwe	z ɪ˩ m b ə˥ b w eː˩
zina	z ɪ˩ n aː˥
zinare	z iː˥ n aː˥ r e˩
zinari	z iː˥ n aː˥ r iː˩
zinariya	z iː˥ n aː˥ r ɪ˩ j aː˥
zira'i	z ɪ˩ r aː˥ ʔ iː˩
zirga	z ɪ˩ r aː˥ ɡ aː˩
zirgar	z ɪ˩ r ɡ aː˩ r
zirin	z ɪ˩ r ɪ˥ ŋ
ziyara	z ɪ˩ j aː˥ r aː˩
ziyarar	z ɪ˩ j aː˥ r a˩ r
ziyararsa	z ɪ˩ j aː˥ r a˩ r aː˩
ziyarce	z ɪ˩ j aː˥ ɽ tʃ eː˩
ziyarci	z ɪ˩ j aː˥ ɽ tʃ iː˥
ziyartar	z ɪ˩ j aː˥ r t a˩ r
zo	z oː˥
zoben	z oː˥ b eː˥ ŋ
zololo	z oː˩ l oː˩ l oː˩
zombi	z oː˥ m b iː˥
zomo	z oː˥ m oː˥
zoonotic	z oː˥ oː˩ n oː˥ t ɪ˩ tʃ
zuba	z ɪ˩ b aː˩
zubairu	z ɪ˩ b aj˥ r ɪ˩
zubar	z ɪ˩ b a˩ r
zube	z ɪ˩ b e˩
zuciya	z ɪ˩ tʃ ɪ˥ j aː˩
zuciyar	z ɪ˩ tʃ ɪ˩ j ɛ˥ r
zuciyarki	z ɪ˩ tʃ ɪ˩ j aː˥ ɽ c ɪ˥
zuciyarsa	z ɪ˩ tʃ ɪ˩ j aː˥ ɽ s aː˥
zuciyata	z ɪ˩ tʃ ɪ˩ j aː˥ t aː˩
zuhur	z ɪ˩ h ʊ˥ r
zukatan	z ɪ˩ k ə˥ t a˩ ŋ
zukatansu	z ɪ˩ k ə˥ t aː˥ n s ɪ˩
zulai	z ɪ˥ l aj˥
zulaitu	z ɪ˥ l aj˥ t ɪ˩
zulhajji	z ɪ˥ l h a˥ dʒ ɪ˩
zulƙida	z ɪ˩ l cʼ iː˥ d aː˩
zuma	z ɪ˩ m aː˥
zumudi	z ɪ˩ m ʊ˥ d iː˩
zumunci	z ɪ˩ m ʊ˩ n tʃ iː˥
zumuncin	z ɪ˩ m ʊ˩ n tʃ ɪ˩ ŋ
zumunta	z ɪ˩ m ʊ˥ n t aː˥
zumuntar	z ɪ˩ m ʊ˥ n t a˩ r
zundum	z ɪ˩ n d ɪ˥ m
zungur	z ɪ˩ ŋ ɡʷ ʊ˥ r
zunubi	z ɪ˩ n ɪ˥ b iː˩
zura	z ɪ˩ r aː˩
zurfafa	z ɪ˩ r ɸ aː˥
zurfi	z ɪ˩ r ɸ iː˥
zurfin	z ɪ˩ r ɸ ɪ˩ ŋ
zuriya	z ɪ˩ r ɪ˥ j aː˩
zuriyoyi	z ɪ˩ r ɪ˥ j oː˩ j ɪ˥
zuwa	z ɪ˩ w aː˥
zuwan	z ɪ˩ w a˥˦ ŋ
ƙa'ida	kʼ aː˥ ʔ ɪ˥ d aː˩
ƙa'idoji	kʼ aː˥ ʔ ɪ˥ d oː˩ dʒ iː˥
ƙa'imi	kʼ aː˥ ʔ ɪ˩ m iː˥
ƙabila	kʼ ə˩ b iː˥ l aː˩
ƙadangare	kʼ ə˩ d a˥ ŋ ɡ ə˥ ɽ eː˩
ƙaddara	kʼ a˥ d ə˩ r aː˥
ƙaddara	kʼ a˩ d ə˥ r aː˩
ƙafa	kʼ ə˥ ɸ aː˩
ƙafafu	kʼ ə˥ ɸ aː˥ ɸ ʊ˩
ƙafafuna	kʼ ə˥ ɸ aː˥ ɸ ʊ˩ n aː˥
ƙafar	kʼ ə˥ ɸ a˩ r
ƙafarka	kʼ ə˥ ɸ a˩ r k aː˥
ƙafarsa	kʼ ə˥ ɸ a˩ r aː˩
ƙagu	kʼ ə˥ ɡʷ ʊ˩
ƙaho	kʼ ə˩ h oː˥
ƙahonsa	kʼ aː˥ h oː˩ n s aː˩
ƙahonsu	kʼ aː˥ h oː˩ n s ɪ˩
ƙal	kʼ a˥ l
ƙala	kʼ aː˥ l aː˩
ƙalilan	kʼ ə˩ l iː˥ l a˥˦ ŋ
ƙalla	kʼ a˥ l aː˩
ƙamus	kʼ aː˥ m ʊ˩ s
ƙanana	kʼ ə˥ n aː˥ n aː˩
ƙananan	kʼ ə˥ n aː˥ n a˥˦ ŋ
ƙandas	kʼ a˥ n d a˥ s
ƙanƙane	kʼ a˩ ŋ kʼ ə˥ n eː˩
ƙanƙara	kʼ a˩ ŋ kʼ ə˥ r aː˩
ƙara	kʼ aː˥ r aː˩
ƙaramar	kʼ ə˩ ɽ ə˥ m ə˩ r
ƙarami	kʼ ə˩ ɽ ə˥ m iː˥
ƙaramin	kʼ ə˩ ɽ ə˥ m ɪ˥ ŋ
ƙarancin	kʼ ə˩ r a˥ n tʃ ɪ˩ ŋ
ƙarar	kʼ ə˩ ɽ r
ƙare	kʼ aː˥ ɽ eː˩
ƙarewa	kʼ ə˩ ɽ eː˥ w aː˥
ƙarfafa	kʼ a˥ r ɸ aː˥
ƙarfe	kʼ a˥ r ɸ eː˩
ƙarfi	kʼ a˥ ɽ ɸ iː˥
ƙarfin	kʼ a˥ r ɸ ɪ˩ ŋ
ƙarfinsa	kʼ a˥ r ɸ ɪ˥ n s aː˩
ƙarin	kʼ ə˩ ɽ ɪ˥ ŋ
ƙarni	kʼ a˥ r n iː˩
ƙarshe	kʼ a˥ ɽ ʃ e˩
ƙarshen	kʼ a˥ ɽ ʃ e˩ ŋ
ƙaru	kʼ ə˩ r uː˥
ƙaruwa	kʼ a˩ ɽ ʊ˥ w aː˥
ƙarya	kʼ a˥ ɽ j aː˥
ƙarƙaf	kʼ a˩ ɽ kʼ a˥ p
ƙarƙashin	kʼ a˩ ɽ kʼ ə˩ ʃ ɪ˥˦ ŋ
ƙas	kʼ a˥ s
ƙasa	kʼ ə˥ s aː˥
ƙasa	kʼ ə˥ s ə˩
ƙasan	kʼ ə˥ s a˩ ŋ
ƙasar	kʼ ə˥ s a˩ r
ƙasashe	kʼ ə˥ s ə˩ ə˥ ʃ e˥
ƙasashen	kʼ ə˥ s ə˩ ʃ eː˩ ŋ
ƙashi	kʼ ə˩ ʃ iː˥
ƙasida	kʼ ə˩ s iː˥ d aː˩
ƙato	kʼ aː˥ t oː˩
ƙaton	kʼ aː˥ t a˥ ŋ
ƙauna	kʼ aw˥ n aː˩
ƙaunar	kʼ aw˥ n a˩ r
ƙaura	kʼ aw˥ r aː˩
ƙauye	kʼ aw˥ j eː˩
ƙauyen	kʼ aw˥ j eː˥ ŋ
ƙauyenmu	kʼ aw˥ j eː˩ n m uː˩
ƙawar	kʼ aː˥ w a˥ r
ƙawaye	kʼ ə˥ w aː˩ j eː˥
ƙazaf	kʼ ə˥ z a˩ ɸ
ƙazami	kʼ ə˩ z aː˥ m iː˥
ƙazamin	kʼ ə˩ z aː˥ m ɪ˩ ŋ
ƙazanta	kʼ ə˩ z a˥˦ n t aː˥
ƙazantarsa	kʼ ə˩ z a˥˦ n t ə˩ ɽ s aː˥
ƙera	cʼ eː˩ r aː˩
ƙerere	cʼ eː˩ ɽ eː˩ ɽ eː˩
ƙetare	cʼ eː˩ t aː˥ r e˩
ƙi	cʼ ɪ˩
ƙiba	cʼ ɪ˥ b aː˩
ƙififiya	cʼ ɪ˥ ɸ ɪ˥ ɸ ɪ˥ j ɛ˥
ƙin	cʼ ɪ˥ ŋ
ƙirin	cʼ ɪ˥ ɽ ɪ˥ ŋ
ƙirji	cʼ ɪ˩ ɽ dʒ iː˥
ƙirjinsa	cʼ ɪ˩ ɽ dʒ ɪ˥ n s aː˩
ƙissa	cʼ ɪ˥ s aː˩
ƙiyasi	cʼ ɪ˩ j aː˥ s iː˩
ƙiƙam	cʼ iː˩ kʼ a˩ m
ƙoda	kʷʼ oː˥ d aː˩
ƙofa	kʷʼ oː˥ ɸ aː˩
ƙofar	kʷʼ oː˥ ɸ a˩ r
ƙofofin	kʷʼ oː˩ ɸ oː˥ ɸ ɪ˩ ŋ
ƙona	kʷʼ oː˩ n aː˩
ƙorafi	kʷʼ oː˩ ɽ aː˥ ɸ iː˩
ƙorama	kʷʼ oː˩ ɽ ə˥ m aː˩
ƙosa	kʷʼ oː˥ s aː˩
ƙosai	kʷʼ oː˥ s aj˥
ƙosau	kʷʼ oː˩ s aw˥
ƙoshinsu	kʷʼ oː˥ ʃ iː˩ n s ɪ˩
ƙoƙari	kʷʼ oː˩ kʼ ə˥ ɽ ɪ˥
ƙoƙarin	kʷʼ oː˩ kʼ ə˥ ɽ ɪ˥ ŋ
ƙoƙiƙoƙi	kʷʼ oː˥ c ɪ˩ kʷʼ oː˥ cʼ ɪ˩
ƙube	kʷʼ uː˥ b e˩
ƙudus	kʷʼ ʊ˥ d ɪ˩ s
ƙugi	kʷʼ uː˥ ɟ iː˥
ƙugiya	kʷʼ uː˥ ɟ ɪ˩ j aː˥
ƙulumi	kʷʼ uː˥ l ɪ˥ m iː˥
ƙumba	kʷʼ ʊ˩ m b aː˥
ƙunae	kʷʼ ʊ˩ n eː˩
ƙundu	kʷʼ ʊ˩ n d uː˥
ƙungiyar	kʷʼ ʊ˥ ɲ ɟ ɪ˩ j ɛ˥ r
ƙungiyarmu	kʷʼ ʊ˥ ɲ ɟ ɪ˩ j aː˥ ɽ m uː˩
ƙungiyarsa	kʷʼ ʊ˥ ɲ ɟ ɪ˩ j aː˥ ɽ s aː˥
ƙunshe	kʷʼ ʊ˥ n ʃ eː˩
ƙuntatawa	kʷʼ ʊ˥ n t aː˩ t aː˥ w aː˥
ƙurar	kʷʼ ʊ˩ r a˩ r
ƙuri'a	kʷʼ ʊ˩ r ɪ˥ ʔ aː˩
ƙursunsun	kʷʼ ʊ˩ ɽ s ɪ˩ n s ɪ˩ ŋ
ƙurungu	kʷʼ ʊ˩ ɽ ɪ˥ ŋ ɡʷ ʊ˩
ƙusa	kʷʼ ʊ˥ s aː˩
ƙut	kʷʼ ʊ˥ t
ƙuƙut	kʷʼ ʊ˥ kʷʼ ʊ˥ t
ƙwace	kʷʼ ə˥ tʃ eː˩
ƙwai	kʷʼ aj˥
ƙwallo	kʷʼ ə˥ l oː˥
ƙwallon	kʷʼ a˥ l ɔ˩ ŋ
ƙwan	kʷʼ a˥˦ ŋ
ƙwarai	kʷʼ ə˥ r aj˥
ƙwararren	kʷʼ ɽ a˥ r eː˩ ŋ
ƙwararrun	kʷʼ ɽ r ɪ˩ ŋ
ƙware	kʷʼ ɽ eː˩
ƙwarewa	kʷʼ ɽ eː˥ w aː˥
ƙwari	kʷʼ ɽ iː˥
ƙwarin	kʷʼ ɽ ɪ˥ ŋ
ƙwaya	kʷʼ ɛ˥ j aː˩
ƙwayar	kʷʼ aː˩ j ɛ˥ r
ƙwayoyin	kʷʼ aː˩ j oː˩ j ɪ˥ ŋ
ƙwaƙwalwa	kʷʼ kʷʼ l w aː˩
ƙwaƙwalwar	kʷʼ kʷʼ l w a˥ r
ƙwaƙwalwata	kʷʼ kʷʼ l w ə˥ t aː˩
ƙwya	kʷʼ j aː˩
ƙyalli	kʷʼ j ɛ˥ l iː˥
ƙyama	kʷʼ j aː˥ m aː˩
ɓace	ɓ ə˥ tʃ eː˩
ɓakutu	ɓ aː˥ kʷ ʊ˥ t ɪ˥
ɓangare	ɓ a˥ ŋ ɡ ə˥ ɽ eː˩
ɓangaren	ɓ a˥ ŋ ɡ ə˥ ɽ eː˩ ŋ
ɓangarene	ɓ a˥ ŋ ɡ ə˥ ɽ eː˩ n e˥
ɓangarori	ɓ a˥ ŋ ɡ ə˥ ɽ oː˩ ɽ iː˥
ɓangwalgwal	ɓ a˩ ŋ ɡʷ a˩ l ɡʷ a˩ l
ɓarawo	ɓ ə˩ ɽ aː˥ w oː˩
ɓata	ɓ aː˥ t aː˩
ɓaure	ɓ aw˥ ɽ eː˥
ɓaɓura	ɓ aː˥ ɓ ʊ˩ ɽ ə˩
ɓelele	ɓ eː˩ l eː˩ l eː˩
ɓeran	ɓ eː˩ r a˩ ŋ
ɓoye	ɓ oː˩ j eː˥
ɓoyewa	ɓ oː˩ j eː˥ w aː˩
ɓulla	ɓ ʊ˩ l ə˥
ɓurma	ɓ ʊ˥ ɽ m ə˥
ɗa	ɗ aː˥
ɗa'a	ɗ aː˥ ʔ aː˩
ɗabi'a	ɗ ə˩ b iː˥ ʔ aː˩
ɗabi'ar	ɗ ə˩ b iː˥ ʔ a˩ r
ɗabi'un	ɗ ə˩ b iː˥ ʔ ʊ˩ ŋ
ɗaci	ɗ ə˩ tʃ iː˥
ɗaga	ɗ aː˥ ɡ aː˥
ɗakin	ɗ aː˥ c ɪ˩ ŋ
ɗakinsa	ɗ aː˥ c ɪ˩ n s aː˩
ɗakinta	ɗ aː˥ c ɪ˥ n t aː˩
ɗalibai	ɗ aː˥ l ɪ˩ b aj˥
ɗaliban	ɗ aː˥ l ɪ˩ b a˩ ŋ
ɗalibanta	ɗ aː˥ l ɪ˩ b a˩ n t aː˥
ɗalibi	ɗ aː˥ l ɪ˩ b iː˥
ɗalibin	ɗ aː˥ l ɪ˩ b ɪ˩ ŋ
ɗan	ɗ a˥ ŋ
ɗana	ɗ aː˥ n aː˩
ɗanjuma	ɗ a˥ n dʒ uː˥ m ə˩
ɗanladi	ɗ a˥ l aː˥ d ɪ˩
ɗanlami	ɗ a˥ l aː˩ m iː˥˦
ɗansa	ɗ a˥ n s ə˩
ɗantala	ɗ a˥ n t ə˩ l aː˥
ɗanye	ɗ ɛ˥ ɲ j eː˥
ɗari	ɗ aː˥ ɽ iː˥
ɗari	ɗ ə˩ ɽ iː˥
ɗauka	ɗ aw˥ k aː˩
ɗaukar	ɗ aw˥ k a˩ r
ɗauke	ɗ aw˥ c eː˥
ɗaukeni	ɗ aw˥ c eː˥ n iː˩
ɗauki	ɗ aw˥ c iː˥
ɗauraye	ɗ aw˥ r aː˩ j eː˥
ɗaure	ɗ aw˥ ɽ eː˥
ɗawafi	ɗ ə˩ w aː˥ ɸ iː˩
ɗawisu	ɗ aː˥ w iː˥ s ɪ˩
ɗaya	ɗ ɛ˥ j ɛ˥
ɗayan	ɗ ɛ˥ j ŋ
ɗefi	ɗ eː˩ ɸ iː˥
ɗigo	ɗ ɪ˥ ɡʷ oː˩
ɗim	ɗ ɪ˥˦ m
ɗim	ɗ ɪ˩ m
ɗin	ɗ ɪ˥ ŋ
ɗina	ɗ ɪ˥ n aː˩
ɗinkin	ɗ ɪ˥ ɲ c ɪ˥ ŋ
ɗinsa	ɗ iː˥ n s aː˩
ɗorawa	ɗ oː˩ ɽ aː˥ w aː˥
ɗoyi	ɗ oː˩ j ɪ˥
ɗu	ɗ uː˩
ɗude	ɗ ʊ˩ d e˩
ɗungum	ɗ ɪ˩ ŋ ɡʷ ʊ˥ m
