(lachen)	spn
(laugh)	spn
(laughter)	spn
(lg)	spn
<eps>	sil
<lachen>	spn
<laugh>	spn
<laughter>	spn
<lg>	spn
<unk>	spn
[bracketed]	spn
[lachen]	spn
[laugh]	spn
[laughter]	spn
[lg]	spn
a	a
abo	a b o
abonement	a b o n e m e n t
abu	a b u
adresu	a d ʀ e s u
afd	a f d
africe	a f ʀ i ts e
afrika	a f ʀ i k a
afroameriskeje	a f ʀ o a m e ʀ i s k e j e
agendy	a ɡ e n d ɨ
agrarnu	a ɡ ʀ a ʀ n u
akademije	a k a d e m i j e
akademikarjow-sorabistow	a k a d e m i k a ʀʲ o w s o ʀ a b i s t o w
akademiske	a k a d e m i s k e
akceptancy	a k ts e p t a n ts ɨ
akceptować	a k ts e p t o w a tʃ
akcije	a k ts i j e
akterami	a k t e ʀ a m i
akterow	a k t e ʀ o w
aktiwisća	a k t i w i s tʃ a
aktiwitach	a k t i w i t a x
aktiwitami	a k t i w i t a m i
aktiwitow	a k t i w i t o w
aktiwity	a k t i w i t ɨ
aktiwne	a k t i w n e
aktiwni	a k t i w n i
aktiwniše	a k t i w n i ʃ e
aktiwny	a k t i w n ɨ
aktualizowała	a k t u a l i z o w a w a
aktualnje	a k t u a l nʲ e
akustikowej	a k u s t i k o w e j
ale	a l e
alejam	a l e j a m
aleje	a l e j e
aleji	a l e j i
alejowa	a l e j o w a
alfabet	a l f a b e t
alojsa	a l o j s a
alternatiwow	a l t e ʀ n a t i w o w
alternatiwu	a l t e ʀ n a t i w u
amalia	a m a l i a
ameriku	a m e ʀ i k u
američana	a m e ʀ i tʃ a n a
analyzować	a n a l ɨ z o w a tʃ
andrickeho	a n d ʀ i ts k e h o
angažement	a n ɡ a ʒ e m e n t
angažementom	a n ɡ a ʒ e m e n t o m
angažowaneho	a n ɡ a ʒ o w a n e h o
angažowanych	a n ɡ a ʒ o w a n ɨ x
angažuje	a n ɡ a ʒ u j e
ani	a n i
anna-maria	a n n a m a ʀ i a
ansambl	a n s a m b l
ansamblu	a n s a m b l u
antiki	a n t i k i
antiserbskim	a n t i s e ʀ b s k i m
app	a p p
araneskej	a ʀ a n e s k e j
archeologiske	a ʀ x e o l o ɡ i s k e
archiw	a ʀ x i w
areal	a ʀ e a l
arealu	a ʀ e a l u
argentinskej	a ʀ ɡ e n t i n s k e j
argumentami	a ʀ ɡ u m e n t a m i
atd	a t d
atleća	a t l e tʃ a
atraktiwny	a t ʀ a k t i w n ɨ
awta	a w t a
awto	a w t o
awtobiografiske	a w t o b i o ɡ ʀ a f i s k e
awtochtone	a w t o x t o n e
awtochtonych	a w t o x t o n ɨ x
awtom	a w t o m
awtor	a w t o ʀ
awtoram	a w t o ʀ a m
awtorka	a w t o ʀ k a
awtorske	a w t o ʀ s k e
aziji	a z i j i
babyje	b a b ɨ j e
babyjoweje	b a b ɨ j o w e j e
bahna	b a h n a
baje	b a j e
bajki	b a j k i
baladźe	b a l a dʒ e
balonka	b a l o n k a
baltiskej	b a l t i s k e j
bamž	b a m ʒ
bamža	b a m ʒ a
banki	b a n k i
barbiłoj	b a ʀ b i w o j
barbu	b a ʀ b u
barjerow	b a ʀʲ e ʀ o w
baroka	b a ʀ o k a
baskišćina	b a s k i ʃ tʃ i n a
baterija	b a t e ʀ i j a
baterije	b a t e ʀ i j e
bauhausa	b a u h a u s a
baćon	b a tʃ o n
baćonscy	b a tʃ o n s ts ɨ
beckmann	b e ts k m a n n
belgiskeje	b e l ɡ i s k e j e
benjamina	b e nʲ a m i n a
benje	b e nʲ e
berlina	b e ʀ l i n a
berlinje	b e ʀ l i nʲ e
berlinskej	b e ʀ l i n s k e j
berlinsku	b e ʀ l i n s k u
betlehemsku	b e t l e h e m s k u
bi-kulturneje	b i k u l t u ʀ n e j e
biblioteka	b i b l i o t e k a
biblioteku	b i b l i o t e k u
bilancujemy	b i l a n ts u j e m ɨ
bilingualnje	b i l i n ɡ u a l nʲ e
bilingualny	b i l i n ɡ u a l n ɨ
bingener	b i n ɡ e n e ʀ
biografija	b i o ɡ ʀ a f i j a
biologiska	b i o l o ɡ i s k a
biosferoweho	b i o s f e ʀ o w e h o
biosferowym	b i o s f e ʀ o w ɨ m
biotona	b i o t o n a
biotonu	b i o t o n u
biskopam	b i s k o p a m
biskopstwje	b i s k o p s t wʲ e
bitwy	b i t w ɨ
bjez	bʲ e z
bjezdwěla	bʲ e z d w ɪ l a
bjezposrědnje	bʲ e z p o s ʀ ɪ d nʲ e
bjezposrědny	bʲ e z p o s ʀ ɪ d n ɨ
bjezwuhladnym	bʲ e z w u h l a d n ɨ m
bjezwuměniće	bʲ e z w u m ɪ n i tʃ e
bjezwuwzaćnje	bʲ e z w u w z a tʃ nʲ e
blackout	b l a ts k o u t
blida	b l i d a
blidarske	b l i d a ʀ s k e
blido	b l i d o
blisko	b l i s k o
bliskosć	b l i s k o s tʃ
bliža	b l i ʒ a
blogu	b l o ɡ u
bobáňovci	b o b a nʲ o v ts i
boha	b o h a
bohow	b o h o w
bohužel	b o h u ʒ e l
boja	b o j a
bokom	b o k o m
bokow	b o k o w
boku	b o k u
boli	b o l i
boliwiskej	b o l i w i s k e j
bolostna	b o l o s t n a
borkowach	b o ʀ k o w a x
bow	b o w
bože	b o ʒ e
božeje	b o ʒ e j e
božim	b o ʒ i m
božu	b o ʒ u
braniborska	b ʀ a n i b o ʀ s k a
braniborskeho	b ʀ a n i b o ʀ s k e h o
braniborskej	b ʀ a n i b o ʀ s k e j
braniborskeje	b ʀ a n i b o ʀ s k e j e
braniborskich	b ʀ a n i b o ʀ s k i x
braniborsku	b ʀ a n i b o ʀ s k u
branšow	b ʀ a n ʃ o w
bratr	b ʀ a t ʀ
bratra	b ʀ a t ʀ a
bratrowska	b ʀ a t ʀ o w s k a
bratrowskej	b ʀ a t ʀ o w s k e j
brać	b ʀ a tʃ
brała	b ʀ a w a
braška	b ʀ a ʃ k a
bremerhaven	b ʀ e m e ʀ h a v e n
bretschneiderec	b ʀ e ts x n e i d e ʀ e ts
britaniskeje	b ʀ i t a n i s k e j e
britiske	b ʀ i t i s k e
brjazynska	b ʀʲ a z ɨ n s k a
bronjo	b ʀ o nʲ o
brošurow	b ʀ o ʃ u ʀ o w
brunicoweje	b ʀ u n i ts o w e j e
brunicowu	b ʀ u n i ts o w u
brunicowych	b ʀ u n i ts o w ɨ x
brunicy	b ʀ u n i ts ɨ
brutalneho	b ʀ u t a l n e h o
brězan	b ʀ ɪ z a n
brězana	b ʀ ɪ z a n a
brězanej	b ʀ ɪ z a n e j
brězowčenjo	b ʀ ɪ z o w tʃ e nʲ o
bu	b u
bubnowarjow	b u b n o w a ʀʲ o w
buchu	b u x u
budu	b u d u
budyska	b u d ɨ s k a
budyske	b u d ɨ s k e
budyski	b u d ɨ s k i
budyskich	b u d ɨ s k i x
budyskim	b u d ɨ s k i m
budyšin	b u d ɨ ʃ i n
budyšina	b u d ɨ ʃ i n a
budyšinje	b u d ɨ ʃ i nʲ e
budyšinkom	b u d ɨ ʃ i n k o m
budyšinom	b u d ɨ ʃ i n o m
budyšinčenjo	b u d ɨ ʃ i n tʃ e nʲ o
budźe	b u dʒ e
budźeće	b u dʒ e tʃ e
budźeš	b u dʒ e ʃ
budźtej	b u dʒ t e j
bukecach	b u k e ts a x
bukej	b u k e j
bukoweje	b u k o w e j e
bul	b u l
bulwarizacije	b u l w a ʀ i z a ts i j e
bunclach	b u n ts l a x
burow	b u ʀ o w
busom	b u s o m
busowych	b u s o w ɨ x
busta	b u s t a
by	b ɨ
bych	b ɨ x
bychmoj	b ɨ x m o j
bychmy	b ɨ x m ɨ
bychu	b ɨ x u
bydlachu	b ɨ d l a x u
bydlacy	b ɨ d l a ts ɨ
bydlacych	b ɨ d l a ts ɨ x
bydlenja	b ɨ d l e nʲ a
bydlenje	b ɨ d l e nʲ e
bydlić	b ɨ d l i tʃ
bydlił	b ɨ d l i w
bytosć	b ɨ t o s tʃ
bywa	b ɨ w a
bywšej	b ɨ w ʃ e j
być	b ɨ tʃ
był	b ɨ w
była	b ɨ w a
było	b ɨ w o
byłoj	b ɨ w o j
byštej	b ɨ ʃ t e j
bóle	b ʊ l e
bórkowska	b ʊ ʀ k o w s k a
bórze	b ʊ ʀ z e
bě	b ɪ
běch	b ɪ x
běchmy	b ɪ x m ɨ
běchu	b ɪ x u
běhu	b ɪ h u
běrny	b ɪ ʀ n ɨ
běrow	b ɪ ʀ o w
běłeje	b ɪ w e j e
běše	b ɪ ʃ e
běštaj	b ɪ ʃ t a j
běžeše	b ɪ ʒ e ʃ e
běži	b ɪ ʒ i
błudźenkow	b w u dʒ e n k o w
błyskami	b w ɨ s k a m i
błótach	b w ʊ t a x
cailliau	ts a i l l i a u
ceciliji	ts e ts i l i j i
centralne	ts e n t ʀ a l n e
centralneje	ts e n t ʀ a l n e j e
centralnu	ts e n t ʀ a l n u
centralnym	ts e n t ʀ a l n ɨ m
centrum	ts e n t ʀ u m
centrumje	ts e n t ʀ u mʲ e
charakteristiske	x a ʀ a k t e ʀ i s t i s k e
charakterizuje	x a ʀ a k t e ʀ i z u j e
chce	x ts e
chcedźa	x ts e dʒ a
chcemoj	x ts e m o j
chcemy	x ts e m ɨ
chcemy-li	x ts e m ɨ l i
chcetaj	x ts e t a j
chcetej	x ts e t e j
chceće	x ts e tʃ e
chceš	x ts e ʃ
chcu	x ts u
chcych	x ts ɨ x
chcychmy	x ts ɨ x m ɨ
chcyli	x ts ɨ l i
chcył	x ts ɨ w
chcyła	x ts ɨ w a
chcyłoj	x ts ɨ w o j
chcyše	x ts ɨ ʃ e
chcyštej	x ts ɨ ʃ t e j
chelno	x e l n o
chibazo	x i b a z o
chile	x i l e
chinjenjo	x i nʲ e nʲ o
chlěba	x l ɪ b a
chlěbom	x l ɪ b o m
chodźi	x o dʒ i
chodźić	x o dʒ i tʃ
chodźił	x o dʒ i w
cholowy	x o l o w ɨ
chora	x o ʀ a
chorowaći	x o ʀ o w a tʃ i
chorownje	x o ʀ o w nʲ e
chory	x o ʀ ɨ
choćebuska	x o tʃ e b u s k a
choćebuskeho	x o tʃ e b u s k e h o
choćebuskim	x o tʃ e b u s k i m
choćebuzom	x o tʃ e b u z o m
choćebuzu	x o tʃ e b u z u
christian	x ʀ i s t i a n
chrósćic	x ʀ ʊ s tʃ i ts
chrósćicach	x ʀ ʊ s tʃ i ts a x
chróšćanskim	x ʀ ʊ ʃ tʃ a n s k i m
chróšćenjo	x ʀ ʊ ʃ tʃ e nʲ o
chutne	x u t n e
chutnje	x u t nʲ e
chwile	x w i l e
chódnik	x ʊ d n i k
chór	x ʊ ʀ
chórje	x ʊ ʀʲ e
chórowe	x ʊ ʀ o w e
chětro	x ɪ t ʀ o
chěže	x ɪ ʒ e
chěžkarjo	x ɪ ʒ k a ʀʲ o
chěžnych	x ɪ ʒ n ɨ x
chěžu	x ɪ ʒ u
chłostajomne	x w o s t a j o m n e
chłostanskich	x w o s t a n s k i x
chłódkojty	x w ʊ d k o j t ɨ
chłódnosć	x w ʊ d n o s tʃ
chłódźa	x w ʊ dʒ a
chłódźaki	x w ʊ dʒ a k i
conje	ts o nʲ e
cosima	ts o s i m a
cunjo	ts u nʲ o
cuzby	ts u z b ɨ
cuzeho	ts u z e h o
cuzy	ts u z ɨ
cykwinskich	ts ɨ k w i n s k i x
cyle	ts ɨ l e
cyril	ts ɨ ʀ i l
cyrila	ts ɨ ʀ i l a
cyrkej	ts ɨ ʀ k e j
cyrkwi	ts ɨ ʀ k w i
cyrkwinski	ts ɨ ʀ k w i n s k i
cyrkwinskim	ts ɨ ʀ k w i n s k i m
cyrkwinu	ts ɨ ʀ k w i n u
cyrkwje	ts ɨ ʀ k wʲ e
cyrkwjow	ts ɨ ʀ k wʲ o w
cyrobu	ts ɨ ʀ o b u
cyrčenje	ts ɨ ʀ tʃ e nʲ e
cyłe	ts ɨ w e
cyłeho	ts ɨ w e h o
cyłeje	ts ɨ w e j e
cyłemu	ts ɨ w e m u
cyłk	ts ɨ w k
cyłkej	ts ɨ w k e j
cyłkownje	ts ɨ w k o w nʲ e
cyłodnjowske	ts ɨ w o d nʲ o w s k e
cyłostatnu	ts ɨ w o s t a t n u
cyłu	ts ɨ w u
cyłych	ts ɨ w ɨ x
cyłym	ts ɨ w ɨ m
dachu	d a x u
dajće	d a j tʃ e
dale	d a l e
dalekubłanja	d a l e k u b w a nʲ a
dalekubłanje	d a l e k u b w a nʲ e
dalekubłać	d a l e k u b w a tʃ
daloko	d a l o k o
dalokostudiju	d a l o k o s t u d i j u
dalša	d a l ʃ a
dalše	d a l ʃ e
dalšej	d a l ʃ e j
dalšemu	d a l ʃ e m u
dalši	d a l ʃ i
dalšich	d a l ʃ i x
dalšim	d a l ʃ i m
dalšimi	d a l ʃ i m i
dar	d a ʀ
dariki	d a ʀ i k i
darili	d a ʀ i l i
darimy	d a ʀ i m ɨ
daritej	d a ʀ i t e j
dariła	d a ʀ i w a
dariš	d a ʀ i ʃ
darištaj	d a ʀ i ʃ t a j
darjene	d a ʀʲ e n e
darmotnje	d a ʀ m o t nʲ e
datami	d a t a m i
datow	d a t o w
datoweje	d a t o w e j e
datuma	d a t u m a
daty	d a t ɨ
dawa	d a w a
dawaše	d a w a ʃ e
dawida	d a w i d a
dawka	d a w k a
dawno	d a w n o
dać	d a tʃ
debata	d e b a t a
debjenki	d e bʲ e n k i
debjenku	d e bʲ e n k u
decembra	d e ts e m b ʀ a
decentralnje	d e ts e n t ʀ a l nʲ e
definuje	d e f i n u j e
delegatnej	d e l e ɡ a t n e j
delegaća	d e l e ɡ a tʃ a
delegowanje	d e l e ɡ o w a nʲ e
delikty	d e l i k t ɨ
delnim	d e l n i m
delnja	d e l nʲ a
delnjej	d e l nʲ e j
delnjeje	d e l nʲ e j e
delnjoserbowki	d e l nʲ o s e ʀ b o w k i
delnjoserbsce	d e l nʲ o s e ʀ b s ts e
delnjoserbskeho	d e l nʲ o s e ʀ b s k e h o
delnjoserbšćina	d e l nʲ o s e ʀ b ʃ tʃ i n a
delnjoserbšćiny	d e l nʲ o s e ʀ b ʃ tʃ i n ɨ
delphiju	d e l p h i j u
demografisku	d e m o ɡ ʀ a f i s k u
demokratije	d e m o k ʀ a t i j e
demokratiskemu	d e m o k ʀ a t i s k e m u
demokratiski	d e m o k ʀ a t i s k i
demonstraciji	d e m o n s t ʀ a ts i j i
derje	d e ʀʲ e
desce	d e s ts e
dezastrozny	d e z a s t ʀ o z n ɨ
dešnjanska	d e ʃ nʲ a n s k a
dešnje	d e ʃ nʲ e
dhabija	d h a b i j a
dialog	d i a l o ɡ
dialoga	d i a l o ɡ a
diana	d i a n a
dietmar	d i e t m a ʀ
diferencowane	d i f e ʀ e n ts o w a n e
diferencowanej	d i f e ʀ e n ts o w a n e j
diferencowanosći	d i f e ʀ e n ts o w a n o s tʃ i
diferencować	d i f e ʀ e n ts o w a tʃ
diferencujo	d i f e ʀ e n ts u j o
digitalizacija	d i ɡ i t a l i z a ts i j a
digitalizaciji	d i ɡ i t a l i z a ts i j i
digitalnje	d i ɡ i t a l nʲ e
digitalny	d i ɡ i t a l n ɨ
digitalnymi	d i ɡ i t a l n ɨ m i
diktaturu	d i k t a t u ʀ u
direktne	d i ʀ e k t n e
direktneje	d i ʀ e k t n e j e
direktnje	d i ʀ e k t nʲ e
direktor	d i ʀ e k t o ʀ
direktora	d i ʀ e k t o ʀ a
dirk	d i ʀ k
diskusija	d i s k u s i j a
diskusije	d i s k u s i j e
diskusijny	d i s k u s i j n ɨ
diskusiju	d i s k u s i j u
diskutabelny	d i s k u t a b e l n ɨ
diskutowachu	d i s k u t o w a x u
diskutować	d i s k u t o w a tʃ
diskutuje	d i s k u t u j e
dispoziciji	d i s p o z i ts i j i
dla	d l a
dlěje	d l ɪ j e
dnja	d nʲ a
dnjach	d nʲ a x
dnjej	d nʲ e j
dnjow	d nʲ o w
dnjowym	d nʲ o w ɨ m
dnju	d nʲ u
dny	d n ɨ
do	d o
doba	d o b a
dobje	d o bʲ e
dobra	d o b ʀ a
dobre	d o b ʀ e
dobro	d o b ʀ o
dobropisow	d o b ʀ o p i s o w
dobrošec	d o b ʀ o ʃ e ts
dobry	d o b ʀ ɨ
dobu	d o b u
dobywanje	d o b ɨ w a nʲ e
dobyće	d o b ɨ tʃ e
dobyćer	d o b ɨ tʃ e ʀ
dobyću	d o b ɨ tʃ u
dobył	d o b ɨ w
dochody	d o x o d ɨ
docpěc	d o ts p ɪ ts
docpěć	d o ts p ɪ tʃ
docyła	d o ts ɨ w a
doda	d o d a
dodźěłać	d o dʒ ɪ w a tʃ
dogmatiske	d o ɡ m a t i s k e
dohlad	d o h l a d
dohladowanje	d o h l a d o w a nʲ e
dohromady	d o h ʀ o m a d ɨ
dojednali	d o j e d n a l i
dojednaneho	d o j e d n a n e h o
dojednać	d o j e d n a tʃ
dokelž	d o k e l ʒ
dokument	d o k u m e n t
dokumentacija	d o k u m e n t a ts i j a
dokumentow	d o k u m e n t o w
dokumentować	d o k u m e n t o w a tʃ
dokumentował	d o k u m e n t o w a w
dokumenty	d o k u m e n t ɨ
dokónčili	d o k ʊ n tʃ i l i
dokładnje	d o k w a d nʲ e
dokładny	d o k w a d n ɨ
dom	d o m
doma	d o m a
domach	d o m a x
domchowanka	d o m x o w a n k a
domizniske	d o m i z n i s k e
domiznu	d o m i z n u
domizny	d o m i z n ɨ
domjace	d o mʲ a ts e
domjacnosćow	d o mʲ a ts n o s tʃ o w
domje	d o mʲ e
domoj	d o m o j
domom	d o m o m
domowina	d o m o w i n a
domowinje	d o m o w i nʲ e
domowiny	d o m o w i n ɨ
domskim	d o m s k i m
donjesli	d o nʲ e s l i
dopis	d o p i s
dopokazach	d o p o k a z a x
dopokazać	d o p o k a z a tʃ
dopomina	d o p o m i n a
dopominaja	d o p o m i n a j a
dopominajo	d o p o m i n a j o
dopominaše	d o p o m i n a ʃ e
dopomni	d o p o m n i
doporučenja	d o p o ʀ u tʃ e nʲ a
doprědka	d o p ʀ ɪ d k a
dopóznaća	d o p ʊ z n a tʃ a
doraznišo	d o ʀ a z n i ʃ o
dorost	d o ʀ o s t
dorostowych	d o ʀ o s t o w ɨ x
dorosćena	d o ʀ o s tʃ e n a
dorosćeny	d o ʀ o s tʃ e n ɨ
dosaha	d o s a h a
dosahaja	d o s a h a j a
dosahajcy	d o s a h a j ts ɨ
dospołna	d o s p o w n a
dospołnje	d o s p o w nʲ e
dospołnosće	d o s p o w n o s tʃ e
dostojnu	d o s t o j n u
dosć	d o s tʃ
dotal	d o t a l
dotalne	d o t a l n e
dotalnej	d o t a l n e j
dotalnym	d o t a l n ɨ m
dowola	d o w o l a
dowolene	d o w o l e n e
dowoli	d o w o l i
dowolowe	d o w o l o w e
dowěri	d o w ɪ ʀ i
dowěrić	d o w ɪ ʀ i tʃ
dowěry	d o w ɪ ʀ ɨ
dołhej	d o w h e j
dołhi	d o w h i
dołhim	d o w h i m
dołho	d o w h o
dołholětna	d o w h o l ɪ t n a
dołhu	d o w h u
dožiwich	d o ʒ i w i x
dožiwichu	d o ʒ i w i x u
dožiwili	d o ʒ i w i l i
dožiwić	d o ʒ i w i tʃ
dožiwjeja	d o ʒ i wʲ e j a
dožiwjenja	d o ʒ i wʲ e nʲ a
dožiwjenjach	d o ʒ i wʲ e nʲ a x
dožiwjenje	d o ʒ i wʲ e nʲ e
dožiwjenskim	d o ʒ i wʲ e n s k i m
dr	d ʀ
drasta	d ʀ a s t a
drastowe	d ʀ a s t o w e
drastu	d ʀ a s t u
drasty	d ʀ a s t ɨ
drje	d ʀʲ e
drjewa	d ʀʲ e w a
drjewom	d ʀʲ e w o m
drježdźan	d ʀʲ e ʒ dʒ a n
drježdźanach	d ʀʲ e ʒ dʒ a n a x
drježdźany-mišnjo	d ʀʲ e ʒ dʒ a n ɨ m i ʃ nʲ o
drohotne	d ʀ o h o t n e
druhdy	d ʀ u h d ɨ
druhdźe	d ʀ u h dʒ e
druhe	d ʀ u h e
druhej	d ʀ u h e j
druheje	d ʀ u h e j e
druhi	d ʀ u h i
druhich	d ʀ u h i x
druhim	d ʀ u h i m
druhu	d ʀ u h u
druzy	d ʀ u z ɨ
družin	d ʀ u ʒ i n
družinje	d ʀ u ʒ i nʲ e
družinow	d ʀ u ʒ i n o w
dróha	d ʀ ʊ h a
dróhi	d ʀ ʊ h i
dróhow	d ʀ ʊ h o w
dróze	d ʀ ʊ z e
du	d u
duby	d u b ɨ
duch	d u x
duchej	d u x e j
duchom	d u x o m
duchowno-kulturny	d u x o w n o k u l t u ʀ n ɨ
duchownym	d u x o w n ɨ m
duchownymi	d u x o w n ɨ m i
duchu	d u x u
duli	d u l i
durje	d u ʀʲ e
durjow	d u ʀʲ o w
dušu	d u ʃ u
dwaceći	d w a ts e tʃ i
dwaj	d w a j
dwanateho	d w a n a t e h o
dwanaće	d w a n a tʃ e
dweju	d w e j u
dworje	d w o ʀʲ e
dworowe	d w o ʀ o w e
dwurěčne	d w u ʀ ɪ tʃ n e
dwurěčnej	d w u ʀ ɪ tʃ n e j
dwurěčnje	d w u ʀ ɪ tʃ nʲ e
dwurěčny	d w u ʀ ɪ tʃ n ɨ
dwurěčnych	d w u ʀ ɪ tʃ n ɨ x
dwutydźenskim	d w u t ɨ dʒ e n s k i m
dwójce	d w ʊ j ts e
dwójnej	d w ʊ j n e j
dwór	d w ʊ ʀ
dwórnišćowej	d w ʊ ʀ n i ʃ tʃ o w e j
dwě	d w ɪ
dwělować	d w ɪ l o w a tʃ
dwěmaj	d w ɪ m a j
dynamisce	d ɨ n a m i s ts e
dypa	d ɨ p a
dypki	d ɨ p k i
dypkow	d ɨ p k o w
dypku	d ɨ p k u
dypornak	d ɨ p o ʀ n a k
dypornaka	d ɨ p o ʀ n a k a
dyrbi	d ɨ ʀ b i
dyrbimy	d ɨ ʀ b i m ɨ
dyrbiš	d ɨ ʀ b i ʃ
dyrbja	d ɨ ʀ bʲ a
dyrbjachmy	d ɨ ʀ bʲ a x m ɨ
dyrbjachu	d ɨ ʀ bʲ a x u
dyrbjał	d ɨ ʀ bʲ a w
dyrbjeli	d ɨ ʀ bʲ e l i
dyrbješe	d ɨ ʀ bʲ e ʃ e
dyrbještaj	d ɨ ʀ bʲ e ʃ t a j
dyrbju	d ɨ ʀ bʲ u
dyrdomdej	d ɨ ʀ d o m d e j
dóstach	d ʊ s t a x
dóstachu	d ʊ s t a x u
dóstali	d ʊ s t a l i
dóstanje-li	d ʊ s t a nʲ e l i
dóstanješ	d ʊ s t a nʲ e ʃ
dóstanu	d ʊ s t a n u
dóstawaja	d ʊ s t a w a j a
dóstawaše	d ʊ s t a w a ʃ e
dóstał	d ʊ s t a w
dóstała	d ʊ s t a w a
dóstało	d ʊ s t a w o
dóńdu	d ʊ nʲ d u
dóńdźe	d ʊ nʲ dʒ e
dóńć	d ʊ nʲ tʃ
dóšli	d ʊ ʃ l i
dóšła	d ʊ ʃ w a
dóšło	d ʊ ʃ w o
dźak	dʒ a k
dźakuju	dʒ a k u j u
dźe	dʒ e
dźensa	dʒ e n s a
dźensniše	dʒ e n s n i ʃ e
dźeržało	dʒ e ʀ ʒ a w o
dźesaty	dʒ e s a t ɨ
dźesać	dʒ e s a tʃ
dźewjateje	dʒ e wʲ a t e j e
dźeń	dʒ e nʲ
dźeš	dʒ e ʃ
dźi	dʒ i
dźiwa	dʒ i w a
dźiwadle	dʒ i w a d l e
dźiwadła	dʒ i w a d w a
dźiwadło	dʒ i w a d w o
dźiwadłowa	dʒ i w a d w o w a
dźiwaja	dʒ i w a j a
dźiwać	dʒ i w a tʃ
dźiwiny	dʒ i w i n ɨ
dźiwje	dʒ i wʲ e
dźowka	dʒ o w k a
dźě	dʒ ɪ
dźěch	dʒ ɪ x
dźědojo	dʒ ɪ d o j o
dźědowe	dʒ ɪ d o w e
dźěl	dʒ ɪ l
dźěla	dʒ ɪ l a
dźěle	dʒ ɪ l e
dźělenje	dʒ ɪ l e nʲ e
dźělenju	dʒ ɪ l e nʲ u
dźělili	dʒ ɪ l i l i
dźělić	dʒ ɪ l i tʃ
dźěliš	dʒ ɪ l i ʃ
dźělnych	dʒ ɪ l n ɨ x
dźělow	dʒ ɪ l o w
dźěra	dʒ ɪ ʀ a
dźěrku	dʒ ɪ ʀ k u
dźěsća	dʒ ɪ s tʃ a
dźěwin	dʒ ɪ w i n
dźěwinjenjow	dʒ ɪ w i nʲ e nʲ o w
dźěćaca	dʒ ɪ tʃ a ts a
dźěćace	dʒ ɪ tʃ a ts e
dźěćaceje	dʒ ɪ tʃ a ts e j e
dźěćacym	dʒ ɪ tʃ a ts ɨ m
dźěćacymi	dʒ ɪ tʃ a ts ɨ m i
dźěćatstwa	dʒ ɪ tʃ a ts t w a
dźěći	dʒ ɪ tʃ i
dźěćimi	dʒ ɪ tʃ i m i
dźěćiny	dʒ ɪ tʃ i n ɨ
dźěćo	dʒ ɪ tʃ o
dźěćom	dʒ ɪ tʃ o m
dźěła	dʒ ɪ w a
dźěłach	dʒ ɪ w a x
dźěłaja	dʒ ɪ w a j a
dźěłakmana	dʒ ɪ w a k m a n a
dźěłali	dʒ ɪ w a l i
dźěłami	dʒ ɪ w a m i
dźěłamy	dʒ ɪ w a m ɨ
dźěłarnistwa	dʒ ɪ w a ʀ n i s t w a
dźěłarnička	dʒ ɪ w a ʀ n i tʃ k a
dźěłarničkach	dʒ ɪ w a ʀ n i tʃ k a x
dźěłarnički	dʒ ɪ w a ʀ n i tʃ k i
dźěłarničkow	dʒ ɪ w a ʀ n i tʃ k o w
dźěławosć	dʒ ɪ w a w o s tʃ
dźěławosće	dʒ ɪ w a w o s tʃ e
dźěłać	dʒ ɪ w a tʃ
dźěłało	dʒ ɪ w a w o
dźěło	dʒ ɪ w o
dźěłodawar	dʒ ɪ w o d a w a ʀ
dźěłowa	dʒ ɪ w o w a
dźěłowe	dʒ ɪ w o w e
dźěłoweho	dʒ ɪ w o w e h o
dźěłoweje	dʒ ɪ w o w e j e
dźěłowu	dʒ ɪ w o w u
dźěłowy	dʒ ɪ w o w ɨ
dźěłowych	dʒ ɪ w o w ɨ x
dźěše	dʒ ɪ ʃ e
e-mail	e m a i l
e-mailu	e m a i l u
efekt	e f e k t
efektiwnych	e f e k t i w n ɨ x
eficiencu	e f i ts i e n ts u
eficientnu	e f i ts i e n t n u
egyptowskej	e ɡ ɨ p t o w s k e j
ekologiske	e k o l o ɡ i s k e
ekosystemow	e k o s ɨ s t e m o w
eksistencielny	e k s i s t e n ts i e l n ɨ
ekskomunikacije	e k s k o m u n i k a ts i j e
ekskomunikuje	e k s k o m u n i k u j e
ekskursije	e k s k u ʀ s i j e
eksota	e k s o t a
eksplicitnje	e k s p l i ts i t nʲ e
eksponaty	e k s p o n a t ɨ
ekspozicija	e k s p o z i ts i j a
ekstremizm	e k s t ʀ e m i z m
ekumeniske	e k u m e n i s k e
elektroniskeho	e l e k t ʀ o n i s k e h o
elektroniskich	e l e k t ʀ o n i s k i x
element	e l e m e n t
elementy	e l e m e n t ɨ
energiju	e n e ʀ ɡ i j u
europjan	e u ʀ o pʲ a n
europje	e u ʀ o pʲ e
europske	e u ʀ o p s k e
europski	e u ʀ o p s k i
europskich	e u ʀ o p s k i x
europy	e u ʀ o p ɨ
eurow	e u ʀ o w
ewaluacija	e w a l u a ts i j a
ewaluacije	e w a l u a ts i j e
ewaluěrować	e w a l u ɪ ʀ o w a tʃ
ewangelistow	e w a n ɡ e l i s t o w
ewangelscy	e w a n ɡ e l s ts ɨ
ewangelska	e w a n ɡ e l s k a
ewangelskeje	e w a n ɡ e l s k e j e
ewangelskich	e w a n ɡ e l s k i x
ewentualnych	e w e n t u a l n ɨ x
fachowa	f a x o w a
fachowc	f a x o w ts
fachoweho	f a x o w e h o
fachowych	f a x o w ɨ x
facit	f a ts i t
fakt	f a k t
fakty	f a k t ɨ
farar	f a ʀ a ʀ
fatalnje	f a t a l nʲ e
faworizowała	f a w o ʀ i z o w a w a
faworizuje	f a w o ʀ i z u j e
februarje	f e b ʀ u a ʀʲ e
federalistiska	f e d e ʀ a l i s t i s k a
feedback	f e e d b a ts k
festiwal	f e s t i w a l
festiwalu	f e s t i w a l u
figury	f i ɡ u ʀ ɨ
finala	f i n a l a
financielnje	f i n a n ts i e l nʲ e
financne	f i n a n ts n e
financnu	f i n a n ts n u
financnym	f i n a n ts n ɨ m
financowanje	f i n a n ts o w a nʲ e
financowanju	f i n a n ts o w a nʲ u
firmy	f i ʀ m ɨ
fokusu	f o k u s u
fokusuje	f o k u s u j e
folklornym	f o l k l o ʀ n ɨ m
folkloru	f o l k l o ʀ u
fond	f o n d
fondsa	f o n d s a
fontanowu	f o n t a n o w u
fontany	f o n t a n ɨ
forma	f o ʀ m a
formam	f o ʀ m a m
formaće	f o ʀ m a tʃ e
formje	f o ʀ mʲ e
formu	f o ʀ m u
formulacije	f o ʀ m u l a ts i j e
formuluja	f o ʀ m u l u j a
formy	f o ʀ m ɨ
fotograf	f o t o ɡ ʀ a f
fotomechaniske	f o t o m e x a n i s k e
foće	f o tʃ e
frakcijow	f ʀ a k ts i j o w
fraku	f ʀ a k u
franciskus	f ʀ a n ts i s k u s
franklin	f ʀ a n k l i n
franklina	f ʀ a n k l i n a
franksko-bayerskim	f ʀ a n k s k o b a ɨ e ʀ s k i m
fraunhoferskeho	f ʀ a u n h o f e ʀ s k e h o
frazeologiski	f ʀ a z e o l o ɡ i s k i
frazeologizmow	f ʀ a z e o l o ɡ i z m o w
freytag	f ʀ e ɨ t a ɡ
frinkolateje	f ʀ i n k o l a t e j e
frinkoliła	f ʀ i n k o l i w a
frizišćina	f ʀ i z i ʃ tʃ i n a
fungowaše	f u n ɡ o w a ʃ e
funguja	f u n ɡ u j a
funguje	f u n ɡ u j e
funkcije	f u n k ts i j e
funkciji	f u n k ts i j i
funkciju	f u n k ts i j u
funkcionarami	f u n k ts i o n a ʀ a m i
galeriju	ɡ a l e ʀ i j u
galicišćina	ɡ a l i ts i ʃ tʃ i n a
garantiju	ɡ a ʀ a n t i j u
garantuje	ɡ a ʀ a n t u j e
garderobu	ɡ a ʀ d e ʀ o b u
gastronomojo	ɡ a s t ʀ o n o m o j o
gelsenkirchen	ɡ e l s e n k i ʀ x e n
gelšćina	ɡ e l ʃ tʃ i n a
generacije	ɡ e n e ʀ a ts i j e
generacijow	ɡ e n e ʀ a ts i j o w
generalnu	ɡ e n e ʀ a l n u
genetiskeje	ɡ e n e t i s k e j e
gerald	ɡ e ʀ a l d
gerharta	ɡ e ʀ h a ʀ t a
gestapo	ɡ e s t a p o
gipsa	ɡ i p s a
gitarje	ɡ i t a ʀʲ e
gitaru	ɡ i t a ʀ u
glashütte	ɡ l a s h u t t e
globalizacija	ɡ l o b a l i z a ts i j a
gmejna	ɡ m e j n a
gmejnam	ɡ m e j n a m
gmejnje	ɡ m e j nʲ e
gmejnscy	ɡ m e j n s ts ɨ
gmejnskeje	ɡ m e j n s k e j e
gmejnskich	ɡ m e j n s k i x
gmejnu	ɡ m e j n u
gmejny	ɡ m e j n ɨ
google	ɡ o o ɡ l e
gramatice	ɡ ʀ a m a t i ts e
gramatiske	ɡ ʀ a m a t i s k e
gratulaciju	ɡ ʀ a t u l a ts i j u
graty	ɡ ʀ a t ɨ
gremij	ɡ ʀ e m i j
gremijow	ɡ ʀ e m i j o w
gremiju	ɡ ʀ e m i j u
grjekojo	ɡ ʀʲ e k o j o
grjekskej	ɡ ʀʲ e k s k e j
grjekskich	ɡ ʀʲ e k s k i x
grjekskim	ɡ ʀʲ e k s k i m
gromaźe	ɡ ʀ o m a ʒ e
grólmusec	ɡ ʀ ʊ l m u s e ts
gymnaziast	ɡ ɨ m n a z i a s t
gymnazij	ɡ ɨ m n a z i j
gymnazija	ɡ ɨ m n a z i j a
gymnazije	ɡ ɨ m n a z i j e
haj	h a j
hajenje	h a j e nʲ e
hajenjom	h a j e nʲ o m
hajenju	h a j e nʲ u
haji	h a j i
hajić	h a j i tʃ
hajki	h a j k i
hajko	h a j k o
hajkom	h a j k o m
hakle	h a k l e
halštrowa	h a l ʃ t ʀ o w a
halštrowska	h a l ʃ t ʀ o w s k a
hamburgu	h a m b u ʀ ɡ u
hamor	h a m o ʀ
hamorskim	h a m o ʀ s k i m
hana	h a n a
hanka	h a n k a
hanušoweje	h a n u ʃ o w e j e
hanza	h a n z a
haru	h a ʀ u
hasnyć	h a s n ɨ tʃ
hasy	h a s ɨ
hatnych	h a t n ɨ x
haty	h a t ɨ
hauptmannoweho	h a u p t m a n n o w e h o
haće	h a tʃ e
hač	h a tʃ
hačrunjež	h a tʃ ʀ u nʲ e ʒ
hašenje	h a ʃ e nʲ e
hašenskej	h a ʃ e n s k e j
hdy	h d ɨ
hdyž	h d ɨ ʒ
hdźe	h dʒ e
hdźež	h dʒ e ʒ
hdźežkuli	h dʒ e ʒ k u l i
heji	h e j i
hendrichecach	h e n d ʀ i x e ts a x
herbstwa	h e ʀ b s t w a
hermanecach	h e ʀ m a n e ts a x
hewak	h e w a k
hibanja	h i b a nʲ a
hibanje	h i b a nʲ e
hibanjow	h i b a nʲ o w
hibanju	h i b a nʲ u
hida	h i d a
hinak	h i n a k
hinaše	h i n a ʃ e
historiskej	h i s t o ʀ i s k e j
hić	h i tʃ
hišće	h i ʃ tʃ e
hižo	h i ʒ o
hladajo	h l a d a j o
hladajće	h l a d a j tʃ e
hladanje	h l a d a nʲ e
hladanju	h l a d a nʲ u
hladać	h l a d a tʃ
hladaš	h l a d a ʃ
hnydom	h n ɨ d o m
hněw	h n ɪ w
hnězdo	h n ɪ z d o
hněžko	h n ɪ ʒ k o
hober	h o b e ʀ
hoberska	h o b e ʀ s k a
hoberski	h o b e ʀ s k i
hodam	h o d a m
hodowne	h o d o w n e
hodownym	h o d o w n ɨ m
hodźa	h o dʒ a
hodźeli	h o dʒ e l i
hodźeć	h o dʒ e tʃ
hodźi	h o dʒ i
hodźinske	h o dʒ i n s k e
hodźiny	h o dʒ i n ɨ
hola	h o l a
holcy	h o l ts ɨ
horach	h o ʀ a x
horicont	h o ʀ i ts o n t
horiny	h o ʀ i n ɨ
horješe	h o ʀʲ e ʃ e
hornim	h o ʀ n i m
hornja	h o ʀ nʲ a
hornjej	h o ʀ nʲ e j
hornjeje	h o ʀ nʲ e j e
hornjoserbsce	h o ʀ nʲ o s e ʀ b s ts e
hornjoserbski	h o ʀ nʲ o s e ʀ b s k i
hornjoserbskich	h o ʀ nʲ o s e ʀ b s k i x
hornjoserbšćina	h o ʀ nʲ o s e ʀ b ʃ tʃ i n a
hornjołužiska	h o ʀ nʲ o w u ʒ i s k a
horow	h o ʀ o w
hory	h o ʀ ɨ
hospodarsce	h o s p o d a ʀ s ts e
hospodarske	h o s p o d a ʀ s k e
hospodarskeho	h o s p o d a ʀ s k e h o
hospodarskim	h o s p o d a ʀ s k i m
hospodarskosć	h o s p o d a ʀ s k o s tʃ
hospodarstwa	h o s p o d a ʀ s t w a
hospodarstwo	h o s p o d a ʀ s t w o
hospodliwosć	h o s p o d l i w o s tʃ
hosćenca	h o s tʃ e n ts a
hosćencach	h o s tʃ e n ts a x
hosći	h o s tʃ i
hosćićeljo	h o s tʃ i tʃ e l j o
hosćo	h o s tʃ o
hotelownicy	h o t e l o w n i ts ɨ
hotowa	h o t o w a
hotowy	h o t o w ɨ
howjazeho	h o wʲ a z e h o
hołym	h o w ɨ m
hońtwje	h o nʲ t wʲ e
hońtwu	h o nʲ t w u
hońtwy	h o nʲ t w ɨ
hraja	h ʀ a j a
hraje	h ʀ a j e
hrajerjo	h ʀ a j e ʀʲ o
hrajkanje	h ʀ a j k a nʲ e
hrajkanske	h ʀ a j k a n s k e
hrajkać	h ʀ a j k a tʃ
hrajne	h ʀ a j n e
hranicu	h ʀ a n i ts u
hranicy	h ʀ a n i ts ɨ
hrać	h ʀ a tʃ
hraću	h ʀ a tʃ u
hrib	h ʀ i b
hrimanjom	h ʀ i m a nʲ o m
hriwnow	h ʀ i w n o w
hrjebjach	h ʀʲ e bʲ a x
hrocha	h ʀ o x a
hromadu	h ʀ o m a d u
hromadźa	h ʀ o m a dʒ a
hromadźe	h ʀ o m a dʒ e
hromadźili	h ʀ o m a dʒ i l i
hrono	h ʀ o n o
hrozy	h ʀ o z ɨ
hru	h ʀ u
hry	h ʀ ɨ
hródźu	h ʀ ʊ dʒ u
hrózbnu	h ʀ ʊ z b n u
hubjene	h u bʲ e n e
hubjenych	h u bʲ e n ɨ x
hubkowaše	h u b k o w a ʃ e
hudźbnik	h u dʒ b n i k
hudźbny	h u dʒ b n ɨ
hudźbnym	h u dʒ b n ɨ m
hudźbu	h u dʒ b u
hudźi	h u dʒ i
humusa	h u m u s a
husto	h u s t o
hwězdam	h w ɪ z d a m
hwězdu	h w ɪ z d u
hygieniskich	h ɨ ɡ i e n i s k i x
hódnotu	h ʊ d n o t u
hódnoća	h ʊ d n o tʃ a
hódnoćenja	h ʊ d n o tʃ e nʲ a
hódnoćenje	h ʊ d n o tʃ e nʲ e
hódnoćić	h ʊ d n o tʃ i tʃ
hódnoćiće	h ʊ d n o tʃ i tʃ e
hórce	h ʊ ʀ ts e
hórje	h ʊ ʀʲ e
hórki	h ʊ ʀ k i
hórnicy	h ʊ ʀ n i ts ɨ
hórnik	h ʊ ʀ n i k
hórnistwo	h ʊ ʀ n i s t w o
hóstny	h ʊ s t n ɨ
hóčki	h ʊ tʃ k i
hłodom	h w o d o m
hłosakmanych	h w o s a k m a n ɨ x
hłosować	h w o s o w a tʃ
hłosowała	h w o s o w a w a
hłosy	h w o s ɨ
hłowje	h w o wʲ e
hłowna	h w o w n a
hłowne	h w o w n e
hłownej	h w o w n e j
hłowneje	h w o w n e j e
hłownje	h w o w nʲ e
hłownohamtske	h w o w n o h a m ts k e
hłownym	h w o w n ɨ m
hłubokej	h w u b o k e j
hłubši	h w u b ʃ i
hłupa	h w u p a
hłupak	h w u p a k
hłós	h w ʊ s
ideje	i d e j e
idejemi	i d e j e m i
identity	i d e n t i t ɨ
ilegalnym	i l e ɡ a l n ɨ m
imersije	i m e ʀ s i j e
indianskeje	i n d i a n s k e j e
indigeny	i n d i ɡ e n ɨ
indiwidualnemu	i n d i w i d u a l n e m u
inflacije	i n f l a ts i j e
informacija	i n f o ʀ m a ts i j a
informacije	i n f o ʀ m a ts i j e
informaciske	i n f o ʀ m a ts i s k e
informaciski	i n f o ʀ m a ts i s k i
informaciskim	i n f o ʀ m a ts i s k i m
informował	i n f o ʀ m o w a w
informuje	i n f o ʀ m u j e
informujemy	i n f o ʀ m u j e m ɨ
infrastrukturu	i n f ʀ a s t ʀ u k t u ʀ u
infrastruktury	i n f ʀ a s t ʀ u k t u ʀ ɨ
iniciatiwa	i n i ts i a t i w a
iniciatiwu	i n i ts i a t i w u
iniciatiwy	i n i ts i a t i w ɨ
iniciatorow	i n i ts i a t o ʀ o w
inowacija	i n o w a ts i j a
inscenacijach	i n s ts e n a ts i j a x
inscenaciju	i n s ts e n a ts i j u
insitut	i n s i t u t
insolwencu	i n s o l w e n ts u
instalacija	i n s t a l a ts i j a
instalaciju	i n s t a l a ts i j u
institucija	i n s t i t u ts i j a
institucijemi	i n s t i t u ts i j e m i
institucijow	i n s t i t u ts i j o w
institucionelnych	i n s t i t u ts i o n e l n ɨ x
institut	i n s t i t u t
instituta	i n s t i t u t a
integrowane	i n t e ɡ ʀ o w a n e
intensiwna	i n t e n s i w n a
intensiwne	i n t e n s i w n e
intensiwnych	i n t e n s i w n ɨ x
interaktiwnych	i n t e ʀ a k t i w n ɨ x
interdisciplinarnje	i n t e ʀ d i s ts i p l i n a ʀ nʲ e
interdisciplinarny	i n t e ʀ d i s ts i p l i n a ʀ n ɨ
interkulturelnemu	i n t e ʀ k u l t u ʀ e l n e m u
internat	i n t e ʀ n a t
internata	i n t e ʀ n a t a
internatneje	i n t e ʀ n a t n e j e
internatni	i n t e ʀ n a t n i
internaće	i n t e ʀ n a tʃ e
internet	i n t e ʀ n e t
internetna	i n t e ʀ n e t n a
internetnej	i n t e ʀ n e t n e j
interneće	i n t e ʀ n e tʃ e
inwesticije	i n w e s t i ts i j e
inwesticijow	i n w e s t i ts i j o w
inwesticisku	i n w e s t i ts i s k u
inwestiwne	i n w e s t i w n e
inwestor	i n w e s t o ʀ
inwestorow	i n w e s t o ʀ o w
inwestujemy	i n w e s t u j e m ɨ
iršćina	i ʀ ʃ tʃ i n a
italsce	i t a l s ts e
italskej	i t a l s k e j
italskeje	i t a l s k e j e
italsku	i t a l s k u
ja	j a
jabłuka	j a b w u k a
jadrowej	j a d ʀ o w e j
jako	j a k o
jamje	j a mʲ e
jamow	j a m o w
jamy	j a m ɨ
jan	j a n
janej	j a n e j
jank	j a n k
janu	j a n u
januar	j a n u a ʀ
janšojc	j a n ʃ o j ts
japoštoł	j a p o ʃ t o w
japoštołaj	j a p o ʃ t o w a j
japoštołam	j a p o ʃ t o w a m
japoštołstwo	j a p o ʃ t o w s t w o
jara	j a ʀ a
jasne	j a s n e
jasnička	j a s n i tʃ k a
jasnje	j a s nʲ e
jasny	j a s n ɨ
jasnym	j a s n ɨ m
je	j e
jedna	j e d n a
jednanja	j e d n a nʲ a
jednanje	j e d n a nʲ e
jednanjow	j e d n a nʲ o w
jednanski	j e d n a n s k i
jednanskim	j e d n a n s k i m
jednansku	j e d n a n s k u
jednać	j e d n a tʃ
jednaćel	j e d n a tʃ e l
jednaćela	j e d n a tʃ e l a
jednaćelej	j e d n a tʃ e l e j
jedne	j e d n e
jednej	j e d n e j
jednoho	j e d n o h o
jednore	j e d n o ʀ e
jednorje	j e d n o ʀʲ e
jednotliwca	j e d n o t l i w ts a
jednotliwe	j e d n o t l i w e
jednotliweho	j e d n o t l i w e h o
jednotliwych	j e d n o t l i w ɨ x
jednotliwym	j e d n o t l i w ɨ m
jednu	j e d n u
jednych	j e d n ɨ x
jednym	j e d n ɨ m
jedyn	j e d ɨ n
jeho	j e h o
jej	j e j
jeje	j e j e
jejkami	j e j k a m i
jejko	j e j k o
jejkom	j e j k o m
jejkow	j e j k o w
jeju	j e j u
jelenjowe	j e l e nʲ o w e
jeli	j e l i
jemu	j e m u
jenacy	j e n a ts ɨ
jendźelšćinje	j e n dʒ e l ʃ tʃ i nʲ e
jeničke	j e n i tʃ k e
jeno	j e n o
jenož	j e n o ʒ
jewi	j e w i
jewišću	j e w i ʃ tʃ u
jich	j i x
jim	j i m
jimaj	j i m a j
jonnyja	j o n n ɨ j a
josepha	j o s e p h a
jowle	j o w l e
jstwy	j s t w ɨ
jstwě	j s t w ɪ
ju	j u
julian	j u l i a n
junior-rangerow	j u n i o ʀ ʀ a n ɡ e ʀ o w
juristiskim	j u ʀ i s t i s k i m
jurja	j u ʀʲ a
jurjej	j u ʀʲ e j
jurorow	j u ʀ o ʀ o w
jury	j u ʀ ɨ
jutrow	j u t ʀ o w
jutrowne	j u t ʀ o w n e
jutrownu	j u t ʀ o w n u
jutrownych	j u t ʀ o w n ɨ x
jutrońčku	j u t ʀ o nʲ tʃ k u
jutry	j u t ʀ ɨ
jutře	j u tʃ e
jutřišeje	j u tʃ i ʃ e j e
južna	j u ʒ n a
južne	j u ʒ n e
jón	j ʊ n
jónu	j ʊ n u
jěchaja	j ɪ x a j a
jěchanje	j ɪ x a nʲ e
jěchać	j ɪ x a tʃ
jědła	j ɪ d w a
jědźechu	j ɪ dʒ e x u
jědźemoj	j ɪ dʒ e m o j
jědźeštej	j ɪ dʒ e ʃ t e j
jěsć	j ɪ s tʃ
jěwy-marje	j ɪ w ɨ m a ʀʲ e
jězba	j ɪ z b a
jězbne	j ɪ z b n e
jězbu	j ɪ z b u
jězby	j ɪ z b ɨ
jězdnjomaj	j ɪ z d nʲ o m a j
jězdźence	j ɪ z dʒ e n ts e
jězor	j ɪ z o ʀ
jězorina	j ɪ z o ʀ i n a
jězoru	j ɪ z o ʀ u
jězus	j ɪ z u s
k	k
kabaretowe	k a b a ʀ e t o w e
kabat	k a b a t
kabinet	k a b i n e t
kabineta	k a b i n e t a
kafeterije	k a f e t e ʀ i j e
kajke	k a j k e
kajkež	k a j k e ʒ
kajki	k a j k i
kajkimi	k a j k i m i
kajku	k a j k u
kak	k a k
kameradkam	k a m e ʀ a d k a m
kamjenje	k a mʲ e nʲ e
kamjenjej	k a mʲ e nʲ e j
kamjenska	k a mʲ e n s k a
kamjentneho	k a mʲ e n t n e h o
kamjeń	k a mʲ e nʲ
kamora	k a m o ʀ a
kamorje	k a m o ʀʲ e
kamory	k a m o ʀ ɨ
kandidat	k a n d i d a t
kandidatow	k a n d i d a t o w
kandidaća	k a n d i d a tʃ a
kapało	k a p a w o
kapitlu	k a p i t l u
kartki	k a ʀ t k i
karty	k a ʀ t ɨ
kasy	k a s ɨ
katalanšćina	k a t a l a n ʃ tʃ i n a
katedrala	k a t e d ʀ a l a
katedraly	k a t e d ʀ a l ɨ
kategorijam	k a t e ɡ o ʀ i j a m
kategorisce	k a t e ɡ o ʀ i s ts e
katolska	k a t o l s k a
katolskej	k a t o l s k e j
katolskeje	k a t o l s k e j e
katolski	k a t o l s k i
katolskich	k a t o l s k i x
katolsku	k a t o l s k u
kawči	k a w tʃ i
kački	k a tʃ k i
kała	k a w a
kaž	k a ʒ
ke	k e
kedźbować	k e dʒ b o w a tʃ
kedźbu	k e dʒ b u
kedźbuje	k e dʒ b u j e
kedźbyhódne	k e dʒ b ɨ h ʊ d n e
kejžorscy	k e j ʒ o ʀ s ts ɨ
kelcha	k e l x a
keltam	k e l t a m
kemše	k e m ʃ e
kenclije	k e n ts l i j e
kilian	k i l i a n
kisałeho	k i s a w e h o
kita	k i t a
kito	k i t o
kiž	k i ʒ
klamje	k l a mʲ e
klankami	k l a n k a m i
klanku	k l a n k u
klaus	k l a u s
klimoweho	k l i m o w e h o
klimowi	k l i m o w i
klimu	k l i m u
klimy	k l i m ɨ
klocki	k l o ts k i
klub	k l u b
kluč	k l u tʃ
kluče	k l u tʃ e
klučikowu	k l u tʃ i k o w u
klučowych	k l u tʃ o w ɨ x
klóšter	k l ʊ ʃ t e ʀ
klóšterskej	k l ʊ ʃ t e ʀ s k e j
klětu	k l ɪ t u
kmana	k m a n a
kmane	k m a n e
kmanosćow	k m a n o s tʃ o w
kmanych	k m a n ɨ x
kniha	k n i h a
kniharnja	k n i h a ʀ nʲ a
knihi	k n i h i
knihować	k n i h o w a tʃ
knihu	k n i h u
knihuje	k n i h u j e
knize	k n i z e
knižku	k n i ʒ k u
knižne	k n i ʒ n e
knjez	k nʲ e z
knjeza	k nʲ e z a
knježerstwa	k nʲ e ʒ e ʀ s t w a
knježerstwo	k nʲ e ʒ e ʀ s t w o
knježerstwoweho	k nʲ e ʒ e ʀ s t w o w e h o
koalicija	k o a l i ts i j a
koaliciju	k o a l i ts i j u
koaliciske	k o a l i ts i s k e
koaliciskich	k o a l i ts i s k i x
kofejowej	k o f e j o w e j
koho	k o h o
kolegami	k o l e ɡ a m i
kolegialnym	k o l e ɡ i a l n ɨ m
koleginami	k o l e ɡ i n a m i
kolektiwneho	k o l e k t i w n e h o
kolesom	k o l e s o m
kolesowanju	k o l e s o w a nʲ u
kolesowanski	k o l e s o w a n s k i
kolesowarskimi	k o l e s o w a ʀ s k i m i
kombinacije	k o m b i n a ts i j e
komisija	k o m i s i j a
komisije	k o m i s i j e
komisiju	k o m i s i j u
komornik	k o m o ʀ n i k
kompetencu	k o m p e t e n ts u
kompetency	k o m p e t e n ts ɨ
kompleks	k o m p l e k s
kompleksej	k o m p l e k s e j
kompleksny	k o m p l e k s n ɨ
kompletnu	k o m p l e t n u
komuna	k o m u n a
komunalne	k o m u n a l n e
komunalneho	k o m u n a l n e h o
komunalnych	k o m u n a l n ɨ x
komunalnym	k o m u n a l n ɨ m
komunam	k o m u n a m
komunikacija	k o m u n i k a ts i j a
komunikacije	k o m u n i k a ts i j e
komunikaciju	k o m u n i k a ts i j u
komunikaciski	k o m u n i k a ts i s k i
komunow	k o m u n o w
komuny	k o m u n ɨ
koncepciju	k o n ts e p ts i j u
koncept	k o n ts e p t
koncepta	k o n ts e p t a
koncerna	k o n ts e ʀ n a
koncert	k o n ts e ʀ t
koncertach	k o n ts e ʀ t a x
koncertneho	k o n ts e ʀ t n e h o
koncertneje	k o n ts e ʀ t n e j e
koncipowanju	k o n ts i p o w a nʲ u
kondicije	k o n d i ts i j e
konferencow	k o n f e ʀ e n ts o w
konferency	k o n f e ʀ e n ts ɨ
konfesionelnym	k o n f e s i o n e l n ɨ m
konfirmaciske	k o n f i ʀ m a ts i s k e
konflikty	k o n f l i k t ɨ
kongresa	k o n ɡ ʀ e s a
kongresy	k o n ɡ ʀ e s ɨ
konik	k o n i k
konja	k o nʲ a
konjach	k o nʲ a x
konjacu	k o nʲ a ts u
konje	k o nʲ e
konjow	k o nʲ o w
konkretizowana	k o n k ʀ e t i z o w a n a
konkretne	k o n k ʀ e t n e
konkretnje	k o n k ʀ e t nʲ e
konkretnych	k o n k ʀ e t n ɨ x
konkurowacymaj	k o n k u ʀ o w a ts ɨ m a j
konsens	k o n s e n s
konsonant	k o n s o n a n t
konstruktiwnej	k o n s t ʀ u k t i w n e j
kontakt	k o n t a k t
kontaktowymi	k o n t a k t o w ɨ m i
kontakty	k o n t a k t ɨ
kontrolu	k o n t ʀ o l u
kooperaciji	k o o p e ʀ a ts i j i
koordinować	k o o ʀ d i n o w a tʃ
kopańca	k o p a nʲ ts a
kopańcu	k o p a nʲ ts u
kopf	k o p f
korbika	k o ʀ b i k a
korporaciju	k o ʀ p o ʀ a ts i j u
korpus	k o ʀ p u s
korutanscy	k o ʀ u t a n s ts ɨ
korčmarka	k o ʀ tʃ m a ʀ k a
kotole	k o t o l e
kotraž	k o t ʀ a ʒ
kotre	k o t ʀ e
kotrehož	k o t ʀ e h o ʒ
kotrejž	k o t ʀ e j ʒ
kotrež	k o t ʀ e ʒ
kotru	k o t ʀ u
kotruž	k o t ʀ u ʒ
kotrychž	k o t ʀ ɨ x ʒ
kotryž	k o t ʀ ɨ ʒ
kotřiž	k o tʃ i ʒ
kowarjec	k o w a ʀʲ e ts
kozel	k o z e l
koło	k o w o
kołpa	k o w p a
košle	k o ʃ l e
kože	k o ʒ e
krabata	k ʀ a b a t a
kraj	k ʀ a j
kraja	k ʀ a j a
kraje	k ʀ a j e
krajin	k ʀ a j i n
krajina	k ʀ a j i n a
krajinow	k ʀ a j i n o w
krajinu	k ʀ a j i n u
krajiny	k ʀ a j i n ɨ
krajna	k ʀ a j n a
krajneho	k ʀ a j n e h o
krajnej	k ʀ a j n e j
krajneje	k ʀ a j n e j e
krajnoradny	k ʀ a j n o ʀ a d n ɨ
krajny	k ʀ a j n ɨ
krajow	k ʀ a j o w
kraju	k ʀ a j u
kralec	k ʀ a l e ts
kralej	k ʀ a l e j
kralestwje	k ʀ a l e s t wʲ e
kralestwo	k ʀ a l e s t w o
krasnje	k ʀ a s nʲ e
krasnym	k ʀ a s n ɨ m
kreatiwnych	k ʀ e a t i w n ɨ x
kredity	k ʀ e d i t ɨ
kretschmer	k ʀ e ts x m e ʀ
kretschmera	k ʀ e ts x m e ʀ a
kriterij	k ʀ i t e ʀ i j
kritiku	k ʀ i t i k u
kritisce	k ʀ i t i s ts e
kritiske	k ʀ i t i s k e
kritiskemu	k ʀ i t i s k e m u
kritizowaše	k ʀ i t i z o w a ʃ e
krok	k ʀ o k
krokawow	k ʀ o k a w o w
krokawu	k ʀ o k a w u
kromje	k ʀ o mʲ e
kromy	k ʀ o m ɨ
kroči	k ʀ o tʃ i
kruchi	k ʀ u x i
kruha	k ʀ u h a
krute	k ʀ u t e
krutu	k ʀ u t u
kruty	k ʀ u t ɨ
kruwow	k ʀ u w o w
kruće	k ʀ u tʃ e
kružk	k ʀ u ʒ k
krydu	k ʀ ɨ d u
krytej	k ʀ ɨ t e j
krótki	k ʀ ʊ t k i
krótko	k ʀ ʊ t k o
krótkostawiznu	k ʀ ʊ t k o s t a w i z n u
króć	k ʀ ʊ tʃ
kubłanišća	k u b w a n i ʃ tʃ a
kubłanišćam	k u b w a n i ʃ tʃ a m
kubłanja	k u b w a nʲ a
kubłanje	k u b w a nʲ e
kubłanske	k u b w a n s k e
kubłanskeho	k u b w a n s k e h o
kubłansko-politiske	k u b w a n s k o p o l i t i s k e
kubłarja	k u b w a ʀʲ a
kubłarka	k u b w a ʀ k a
kubłać	k u b w a tʃ
kubłaše	k u b w a ʃ e
kubšic	k u b ʃ i ts
kulił	k u l i w
kultura	k u l t u ʀ a
kulturje	k u l t u ʀʲ e
kulturne	k u l t u ʀ n e
kulturneho	k u l t u ʀ n e h o
kulturnej	k u l t u ʀ n e j
kulturnu	k u l t u ʀ n u
kulturny	k u l t u ʀ n ɨ
kulturnych	k u l t u ʀ n ɨ x
kulturnym	k u l t u ʀ n ɨ m
kulturow	k u l t u ʀ o w
kulturu	k u l t u ʀ u
kultury	k u l t u ʀ ɨ
kultus	k u l t u s
kumštna	k u m ʃ t n a
kupanskej	k u p a n s k e j
kupcow	k u p ts o w
kupić	k u p i tʃ
kupił	k u p i w
kupiła	k u p i w a
kursa	k u ʀ s a
kursach	k u ʀ s a x
kursaj	k u ʀ s a j
kursistow	k u ʀ s i s t o w
kursu	k u ʀ s u
kuzłarja	k u z w a ʀʲ a
kwalifikacije	k w a l i f i k a ts i j e
kwalifikaciji	k w a l i f i k a ts i j i
kwalifikaciju	k w a l i f i k a ts i j u
kwalifikować	k w a l i f i k o w a tʃ
kwalifikowaše	k w a l i f i k o w a ʃ e
kwalita	k w a l i t a
kwalitu	k w a l i t u
kwality	k w a l i t ɨ
kwartety	k w a ʀ t e t ɨ
kwas	k w a s
kwasny	k w a s n ɨ
kwasom	k w a s o m
kwićom	k w i tʃ o m
kwěćel	k w ɪ tʃ e l
kónc	k ʊ n ts
kónca	k ʊ n ts a
kóncej	k ʊ n ts e j
kóncowku	k ʊ n ts o w k u
kóncu	k ʊ n ts u
kónčin	k ʊ n tʃ i n
kónčina	k ʊ n tʃ i n a
kónčinach	k ʊ n tʃ i n a x
kónčiny	k ʊ n tʃ i n ɨ
kónčnej	k ʊ n tʃ n e j
kóstki	k ʊ s t k i
kóčce	k ʊ tʃ ts e
kóčka	k ʊ tʃ k a
kóčku	k ʊ tʃ k u
kóštow	k ʊ ʃ t o w
kóšty	k ʊ ʃ t ɨ
kóžde	k ʊ ʒ d e
kóždeho	k ʊ ʒ d e h o
kóždej	k ʊ ʒ d e j
kóždeje	k ʊ ʒ d e j e
kóždemu	k ʊ ʒ d e m u
kóždežkuli	k ʊ ʒ d e ʒ k u l i
kóždolětnu	k ʊ ʒ d o l ɪ t n u
kóždu	k ʊ ʒ d u
kóždy	k ʊ ʒ d ɨ
kóždym	k ʊ ʒ d ɨ m
köpping	k o p p i n ɡ
kładźe	k w a dʒ e
kłobuki	k w o b u k i
křesćanku	k ʃ e s tʃ a n k u
křesćanscy	k ʃ e s tʃ a n s ts ɨ
křesćansku	k ʃ e s tʃ a n s k u
křesćenjo	k ʃ e s tʃ e nʲ o
křiwje	k ʃ i wʲ e
křižerjo	k ʃ i ʒ e ʀʲ o
křižerski	k ʃ i ʒ e ʀ s k i
křižowanišćo	k ʃ i ʒ o w a n i ʃ tʃ o
laduš	l a d u ʃ
lajskich	l a j s k i x
lampow	l a m p o w
lawskich	l a w s k i x
lačnotu	l a tʃ n o t u
lego-kamjenje	l e ɡ o k a mʲ e nʲ e
leibnizowy	l e i b n i z o w ɨ
lejnom	l e j n o m
lekciji	l e k ts i j i
leksika	l e k s i k a
lekturje	l e k t u ʀʲ e
lećałoj	l e tʃ a w o j
lećeć	l e tʃ e tʃ
leža	l e ʒ a
ležeše	l e ʒ e ʃ e
leži	l e ʒ i
ležownostne	l e ʒ o w n o s t n e
liberalni	l i b e ʀ a l n i
liga	l i ɡ a
limasowu	l i m a s o w u
linguistice	l i n ɡ u i s t i ts e
linguistisce	l i n ɡ u i s t i s ts e
lipju	l i pʲ u
lipsku	l i p s k u
lipšćanskej	l i p ʃ tʃ a n s k e j
lipšćanski	l i p ʃ tʃ a n s k i
list	l i s t
listow	l i s t o w
listowych	l i s t o w ɨ x
listy	l i s t ɨ
lisćina	l i s tʃ i n a
lisćinje	l i s tʃ i nʲ e
lisćiny	l i s tʃ i n ɨ
literaturje	l i t e ʀ a t u ʀʲ e
literaturowěda	l i t e ʀ a t u ʀ o w ɪ d a
liča	l i tʃ a
ličba	l i tʃ b a
ličbu	l i tʃ b u
liči	l i tʃ i
ličił	l i tʃ i w
lochce	l o x ts e
lochkich	l o x k i x
lochko	l o x k o
lokalnych	l o k a l n ɨ x
loni	l o n i
lorenc	l o ʀ e n ts
lorenca	l o ʀ e n ts a
lońšeho	l o nʲ ʃ e h o
lubja	l u bʲ a
lubosć	l u b o s tʃ
lubosće	l u b o s tʃ e
lubosći	l u b o s tʃ i
lubowaše	l u b o w a ʃ e
luboznje	l u b o z nʲ e
lud	l u d
ludej	l u d e j
ludnosć	l u d n o s tʃ
ludom	l u d o m
ludowa	l u d o w a
ludoweje	l u d o w e j e
ludowy	l u d o w ɨ
ludowym	l u d o w ɨ m
ludu	l u d u
ludy	l u d ɨ
ludźi	l u dʒ i
ludźo	l u dʒ o
ludźom	l u dʒ o m
lutowarnje	l u t o w a ʀ nʲ e
lutować	l u t o w a tʃ
lód	l ʊ d
lóšt	l ʊ ʃ t
lóštne	l ʊ ʃ t n e
lóštnymi	l ʊ ʃ t n ɨ m i
lědma	l ɪ d m a
lěhwo	l ɪ h w o
lěkarskeho	l ɪ k a ʀ s k e h o
lěnja	l ɪ nʲ a
lěpje	l ɪ pʲ e
lěpša	l ɪ p ʃ a
lěpšina	l ɪ p ʃ i n a
lěpšiny	l ɪ p ʃ i n ɨ
lěpšu	l ɪ p ʃ u
lěsa	l ɪ s a
lěsej	l ɪ s e j
lěsnym	l ɪ s n ɨ m
lěsu	l ɪ s u
lěsy	l ɪ s ɨ
lět	l ɪ t
lěta	l ɪ t a
lětach	l ɪ t a x
lětachu	l ɪ t a x u
lětami	l ɪ t a m i
lětdźesatkach	l ɪ t dʒ e s a t k a x
lětdźesatkami	l ɪ t dʒ e s a t k a m i
lětnich	l ɪ t n i x
lětnika	l ɪ t n i k a
lětnje	l ɪ t nʲ e
lěto	l ɪ t o
lětom	l ɪ t o m
lětsa	l ɪ ts a
lětstotka	l ɪ ts t o t k a
lětstotkach	l ɪ ts t o t k a x
lětstotku	l ɪ ts t o t k u
lětuša	l ɪ t u ʃ a
lětušej	l ɪ t u ʃ e j
lětuši	l ɪ t u ʃ i
lěwica	l ɪ w i ts a
lěće	l ɪ tʃ e
lěćny	l ɪ tʃ n ɨ
lěćo	l ɪ tʃ o
lěću	l ɪ tʃ u
ma	m a
maja	m a j a
majka	m a j k a
maksimalnje	m a k s i m a l nʲ e
malinka	m a l i n k a
malinkowa	m a l i n k o w a
mam	m a m
mamoj	m a m o j
mamy	m a m ɨ
management	m a n a ɡ e m e n t
mandźelskaj	m a n dʒ e l s k a j
mandźelskim	m a n dʒ e l s k i m
mandźelstwow	m a n dʒ e l s t w o w
manfred	m a n f ʀ e d
manufaktura	m a n u f a k t u ʀ a
mapje	m a pʲ e
mapu	m a p u
mari	m a ʀ i
mariju	m a ʀ i j u
mariny	m a ʀ i n ɨ
marja	m a ʀʲ a
marje	m a ʀʲ e
mark	m a ʀ k
markantne	m a ʀ k a n t n e
markej	m a ʀ k e j
marketinga	m a ʀ k e t i n ɡ a
masiwnych	m a s i w n ɨ x
masterskeho	m a s t e ʀ s k e h o
masterski	m a s t e ʀ s k i
masteru	m a s t e ʀ u
mataj	m a t a j
material	m a t e ʀ i a l
maturje	m a t u ʀʲ e
mazane	m a z a n e
mać	m a tʃ
maćeri	m a tʃ e ʀ i
maćerju	m a tʃ e ʀʲ u
maćernorěčne	m a tʃ e ʀ n o ʀ ɪ tʃ n e
maćernorěčny	m a tʃ e ʀ n o ʀ ɪ tʃ n ɨ
maćeršćiny	m a tʃ e ʀ ʃ tʃ i n ɨ
maćicy	m a tʃ i ts ɨ
maćiznu	m a tʃ i z n u
małe	m a w e
mało	m a w o
małoměstach	m a w o m ɪ s t a x
małych	m a w ɨ x
maśica	m a ʃ i ts a
maš	m a ʃ
mašiny	m a ʃ i n ɨ
meble	m e b l e
medialnych	m e d i a l n ɨ x
medicina	m e d i ts i n a
medicinu	m e d i ts i n u
medijemi	m e d i j e m i
medijoweje	m e d i j o w e j e
meje	m e j e
mejemjetanja	m e j e mʲ e t a nʲ a
meju	m e j u
metod	m e t o d
metoda	m e t o d a
metodu	m e t o d u
metodźe	m e t o dʒ e
mi	m i
michael	m i x a e l
michał	m i x a w
mikławša	m i k w a w ʃ a
milinarnja	m i l i n a ʀ nʲ a
milinarnje	m i l i n a ʀ nʲ e
milinarnjow	m i l i n a ʀ nʲ o w
milinu	m i l i n u
milionowe	m i l i o n o w e
miliony	m i l i o n ɨ
minister	m i n i s t e ʀ
ministerka	m i n i s t e ʀ k a
ministerskim	m i n i s t e ʀ s k i m
ministerstwa	m i n i s t e ʀ s t w a
ministerstwo	m i n i s t e ʀ s t w o
ministerstwom	m i n i s t e ʀ s t w o m
ministrow	m i n i s t ʀ o w
minjene	m i nʲ e n e
minjeny	m i nʲ e n ɨ
minjenych	m i nʲ e n ɨ x
misionarojo	m i s i o n a ʀ o j o
mitri	m i t ʀ i
miłoraz	m i w o ʀ a z
miłoraza	m i w o ʀ a z a
miłorazu	m i w o ʀ a z u
miłosćiwje	m i w o s tʃ i wʲ e
mišterki	m i ʃ t e ʀ k i
mištra	m i ʃ t ʀ a
mjasa	mʲ a s a
mje	mʲ e
mjena	mʲ e n a
mjenje	mʲ e nʲ e
mjenka	mʲ e n k a
mjeno	mʲ e n o
mjenom	mʲ e n o m
mjenowachu	mʲ e n o w a x u
mjenowali	mʲ e n o w a l i
mjenowane	mʲ e n o w a n e
mjenowaneho	mʲ e n o w a n e h o
mjenowanej	mʲ e n o w a n e j
mjenowaneje	mʲ e n o w a n e j e
mjenowanym	mʲ e n o w a n ɨ m
mjenowaše	mʲ e n o w a ʃ e
mjenujcy	mʲ e n u j ts ɨ
mjertyn	mʲ e ʀ t ɨ n
mjerzanje	mʲ e ʀ z a nʲ e
mjez	mʲ e z
mjezami	mʲ e z a m i
mjezsobne	mʲ e z s o b n e
mjezsobnu	mʲ e z s o b n u
mjeztym	mʲ e z t ɨ m
mjezy	mʲ e z ɨ
mjezykomunalne	mʲ e z ɨ k o m u n a l n e
mjezynarodne	mʲ e z ɨ n a ʀ o d n e
mjezynarodny	mʲ e z ɨ n a ʀ o d n ɨ
mjezypřekročace	mʲ e z ɨ p ʃ e k ʀ o tʃ a ts e
mjeńše	mʲ e nʲ ʃ e
mjeńši	mʲ e nʲ ʃ i
mjeńšich	mʲ e nʲ ʃ i x
mjeńšin	mʲ e nʲ ʃ i n
mjeńšina	mʲ e nʲ ʃ i n a
mjeńšinje	mʲ e nʲ ʃ i nʲ e
mjeńšinowe	mʲ e nʲ ʃ i n o w e
mjeńšinoweho	mʲ e nʲ ʃ i n o w e h o
mjeńšinowy	mʲ e nʲ ʃ i n o w ɨ
mjeńšinowych	mʲ e nʲ ʃ i n o w ɨ x
mjeńšinu	mʲ e nʲ ʃ i n u
mjeńšiny	mʲ e nʲ ʃ i n ɨ
mješicach	mʲ e ʃ i ts a x
mni	m n i
mnje	m nʲ e
mnohe	m n o h e
mnohich	m n o h i x
mnohimi	m n o h i m i
mnoho	m n o h o
mnohostronske	m n o h o s t ʀ o n s k e
mnohotnosć	m n o h o t n o s tʃ
mnohotnosće	m n o h o t n o s tʃ e
mnozy	m n o z ɨ
mobilizował	m o b i l i z o w a w
mocach	m o ts a x
mocow	m o ts o w
mocu	m o ts u
mocy	m o ts ɨ
model	m o d e l
modelowy	m o d e l o w ɨ
moderator	m o d e ʀ a t o ʀ
moderna	m o d e ʀ n a
moderne	m o d e ʀ n e
modernizacije	m o d e ʀ n i z a ts i j e
modernje	m o d e ʀ nʲ e
modernu	m o d e ʀ n u
moderny	m o d e ʀ n ɨ
modernymi	m o d e ʀ n ɨ m i
moja	m o j a
moje	m o j e
mojej	m o j e j
mojemu	m o j e m u
mojich	m o j i x
moluje	m o l u j e
moluju	m o l u j u
morjo	m o ʀʲ o
morju	m o ʀʲ u
mosćikach	m o s tʃ i k a x
motiwom	m o t i w o m
motiwować	m o t i w o w a tʃ
mróčele	m ʀ ʊ tʃ e l e
mucha	m u x a
mudrych	m u d ʀ ɨ x
muka	m u k a
mulkec	m u l k e ts
multimedialnu	m u l t i m e d i a l n u
murjow	m u ʀʲ o w
murju	m u ʀʲ u
muster	m u s t e ʀ
muzej	m u z e j
muzeja	m u z e j a
mužacym	m u ʒ a ts ɨ m
mužam	m u ʒ a m
muži	m u ʒ i
mužom	m u ʒ o m
my	m ɨ
myjadła	m ɨ j a d w a
myjerni	m ɨ j e ʀ n i
mysl	m ɨ s l
mysle	m ɨ s l e
myslene	m ɨ s l e n e
myslili	m ɨ s l i l i
myslimy	m ɨ s l i m ɨ
mysličce	m ɨ s l i tʃ ts e
myslow	m ɨ s l o w
myslu	m ɨ s l u
myto	m ɨ t o
mytom	m ɨ t o m
mytowane	m ɨ t o w a n e
myš	m ɨ ʃ
móc	m ʊ ts
mócnarstwje	m ʊ ts n a ʀ s t wʲ e
mócnje	m ʊ ts nʲ e
móhli	m ʊ h l i
móhł	m ʊ h w
móhła	m ʊ h w a
móhło	m ʊ h w o
móhłoj	m ʊ h w o j
mój	m ʊ j
mótku	m ʊ t k u
móža	m ʊ ʒ a
móžachmoj	m ʊ ʒ a x m o j
móže	m ʊ ʒ e
móžemy	m ʊ ʒ e m ɨ
móžetej	m ʊ ʒ e t e j
móžeće	m ʊ ʒ e tʃ e
móžeš	m ʊ ʒ e ʃ
móžeše	m ʊ ʒ e ʃ e
móžeštej	m ʊ ʒ e ʃ t e j
móžna	m ʊ ʒ n a
móžne	m ʊ ʒ n e
móžno	m ʊ ʒ n o
móžnosć	m ʊ ʒ n o s tʃ
móžnosće	m ʊ ʒ n o s tʃ e
móžnosći	m ʊ ʒ n o s tʃ i
móžnosćow	m ʊ ʒ n o s tʃ o w
móžu	m ʊ ʒ u
mějachmy	m ɪ j a x m ɨ
mějachu	m ɪ j a x u
měješe	m ɪ j e ʃ e
měještaj	m ɪ j e ʃ t a j
měještej	m ɪ j e ʃ t e j
mějićel	m ɪ j i tʃ e l
měli	m ɪ l i
měnja	m ɪ nʲ a
měnjachu	m ɪ nʲ a x u
měnjatych	m ɪ nʲ a t ɨ x
měnjenja	m ɪ nʲ e nʲ a
měnjenje	m ɪ nʲ e nʲ e
měnjenjow	m ɪ nʲ e nʲ o w
měr	m ɪ ʀ
měri	m ɪ ʀ i
měritka	m ɪ ʀ i t k a
měrja	m ɪ ʀʲ a
měrje	m ɪ ʀʲ e
měrliweho	m ɪ ʀ l i w e h o
měrćina	m ɪ ʀ tʃ i n a
měsac	m ɪ s a ts
měsacach	m ɪ s a ts a x
měsacow	m ɪ s a ts o w
měsacy	m ɪ s a ts ɨ
města	m ɪ s t a
městach	m ɪ s t a x
městam	m ɪ s t a m
městna	m ɪ s t n a
městnach	m ɪ s t n a x
městnam	m ɪ s t n a m
městnje	m ɪ s t nʲ e
městno	m ɪ s t n o
městnosć	m ɪ s t n o s tʃ
městnosćach	m ɪ s t n o s tʃ a x
městnosće	m ɪ s t n o s tʃ e
městnow	m ɪ s t n o w
město	m ɪ s t o
městomaj	m ɪ s t o m a j
městopředsydaj	m ɪ s t o p ʃ e d s ɨ d a j
městopředsydka	m ɪ s t o p ʃ e d s ɨ d k a
městow	m ɪ s t o w
městu	m ɪ s t u
měsćanske	m ɪ s tʃ a n s k e
měsćanskim	m ɪ s tʃ a n s k i m
měsće	m ɪ s tʃ e
měto	m ɪ t o
měć	m ɪ tʃ
měł	m ɪ w
měła	m ɪ w a
měło	m ɪ w o
měłoj	m ɪ w o j
měšniske	m ɪ ʃ n i s k e
měšćanosta	m ɪ ʃ tʃ a n o s t a
měšćanosty	m ɪ ʃ tʃ a n o s t ɨ
měšćanska	m ɪ ʃ tʃ a n s k a
měšćanskeho	m ɪ ʃ tʃ a n s k e h o
měšćanskich	m ɪ ʃ tʃ a n s k i x
młoda	m w o d a
młode	m w o d e
młodeho	m w o d e h o
młodemu	m w o d e m u
młodostni	m w o d o s t n i
młodostnych	m w o d o s t n ɨ x
młodostnymi	m w o d o s t n ɨ m i
młodych	m w o d ɨ x
młodymi	m w o d ɨ m i
młodźi	m w o dʒ i
młodźina	m w o dʒ i n a
młodźinje	m w o dʒ i nʲ e
młodźinske	m w o dʒ i n s k e
młodźinski	m w o dʒ i n s k i
młodźinu	m w o dʒ i n u
młodźiny	m w o dʒ i n ɨ
mšu	m ʃ u
na	n a
nabok	n a b o k
nabožiny	n a b o ʒ i n ɨ
nabožne	n a b o ʒ n e
nabožno-narodne	n a b o ʒ n o n a ʀ o d n e
nabožny	n a b o ʒ n ɨ
nabudźe	n a b u dʒ e
nabyć	n a b ɨ tʃ
nachila	n a x i l a
nachribjetnik	n a x ʀ i bʲ e t n i k
nachwilneho	n a x w i l n e h o
nacionalsocialistiskim	n a ts i o n a l s o ts i a l i s t i s k i m
nacionalsocializma	n a ts i o n a l s o ts i a l i z m a
nad	n a d
nadal	n a d a l
nadawk	n a d a w k
nadawka	n a d a w k a
nadawkach	n a d a w k a x
nadawkam	n a d a w k a m
nadawkami	n a d a w k a m i
nadawki	n a d a w k i
nadawkow	n a d a w k o w
nadawku	n a d a w k u
nadběhi	n a d b ɪ h i
nadebor	n a d e b o ʀ
nadobo	n a d o b o
nadpadam	n a d p a d a m
nadpadne	n a d p a d n e
nadpadnyli	n a d p a d n ɨ l i
nadróžnu	n a d ʀ ʊ ʒ n u
nadźije	n a dʒ i j e
nadźijeja	n a dʒ i j e j a
nadźijomnje	n a dʒ i j o m nʲ e
nadźiju	n a dʒ i j u
nadźěłać	n a dʒ ɪ w a tʃ
nahlady	n a h l a d ɨ
nahromadźenych	n a h ʀ o m a dʒ e n ɨ x
najbóle	n a j b ʊ l e
najdale	n a j d a l e
najdlěši	n a j d l ɪ ʃ i
najebać	n a j e b a tʃ
najlěpje	n a j l ɪ pʲ e
najlěpšu	n a j l ɪ p ʃ u
najmjeńše	n a j mʲ e nʲ ʃ e
najmjeńši	n a j mʲ e nʲ ʃ i
najmłódši	n a j m w ʊ d ʃ i
najnowše	n a j n o w ʃ e
najprjedy	n a j p ʀʲ e d ɨ
najstarše	n a j s t a ʀ ʃ e
najstaršim	n a j s t a ʀ ʃ i m
naju	n a j u
najwažniši	n a j w a ʒ n i ʃ i
najwjace	n a j wʲ a ts e
najwjetša	n a j wʲ e tʃ a
najwjetše	n a j wʲ e tʃ e
najwjetši	n a j wʲ e tʃ i
najwjetšich	n a j wʲ e tʃ i x
najwuši	n a j w u ʃ i
najwyše	n a j w ɨ ʃ e
najwyšej	n a j w ɨ ʃ e j
najwšelakoriše	n a j w ʃ e l a k o ʀ i ʃ e
najznaćišim	n a j z n a tʃ i ʃ i m
nakupowanskeho	n a k u p o w a n s k e h o
nakupować	n a k u p o w a tʃ
nakładne	n a k w a d n e
nakładnistwje	n a k w a d n i s t wʲ e
nakładźe	n a k w a dʒ e
naležnosć	n a l e ʒ n o s tʃ
naležnosćach	n a l e ʒ n o s tʃ a x
naležnosće	n a l e ʒ n o s tʃ e
naležnosći	n a l e ʒ n o s tʃ i
naliču	n a l i tʃ u
nalutowarni	n a l u t o w a ʀ n i
nalutowarnje	n a l u t o w a ʀ nʲ e
nalěwo	n a l ɪ w o
nalěću	n a l ɪ tʃ u
nam	n a m
namaka	n a m a k a
namakaja	n a m a k a j a
namakamy	n a m a k a m ɨ
namakane	n a m a k a n e
namakanku	n a m a k a n k u
namakać	n a m a k a tʃ
namakaće	n a m a k a tʃ e
namakał	n a m a k a w
namakała	n a m a k a w a
namakaš	n a m a k a ʃ
namjet	n a mʲ e t
namjetej	n a mʲ e t e j
namjetowała	n a mʲ e t o w a w a
namjetuja	n a mʲ e t u j a
namjety	n a mʲ e t ɨ
namołwi	n a m o w w i
namołwja	n a m o w wʲ a
namołwu	n a m o w w u
namóc	n a m ʊ ts
nan	n a n
nana	n a n a
nanej	n a n e j
napadnosćach	n a p a d n o s tʃ a x
napinace	n a p i n a ts e
napinacy	n a p i n a ts ɨ
napisa	n a p i s a
napisy	n a p i s ɨ
napjate	n a pʲ a t e
napjatosću	n a pʲ a t o s tʃ u
napjaty	n a pʲ a t ɨ
napjatym	n a pʲ a t ɨ m
napjeće	n a pʲ e tʃ e
napojemi	n a p o j e m i
naprawa	n a p ʀ a w a
naprawami	n a p ʀ a w a m i
naprawo	n a p ʀ a w o
naprawu	n a p ʀ a w u
naprawy	n a p ʀ a w ɨ
naprašowanja	n a p ʀ a ʃ o w a nʲ a
napřećo	n a p ʃ e tʃ o
naraz	n a ʀ a z
naroda	n a ʀ o d a
narodne	n a ʀ o d n e
narodnej	n a ʀ o d n e j
narodninski	n a ʀ o d n i n s k i
narodnopolitiske	n a ʀ o d n o p o l i t i s k e
narodnosćow	n a ʀ o d n o s tʃ o w
narodnu	n a ʀ o d n u
narodny	n a ʀ o d n ɨ
narodnych	n a ʀ o d n ɨ x
narodnym	n a ʀ o d n ɨ m
narodźena	n a ʀ o dʒ e n a
narodźili	n a ʀ o dʒ i l i
narodźiło	n a ʀ o dʒ i w o
narok	n a ʀ o k
narokom	n a ʀ o k o m
naročny	n a ʀ o tʃ n ɨ
narunanska	n a ʀ u n a n s k a
narěčenje	n a ʀ ɪ tʃ e nʲ e
narěčow	n a ʀ ɪ tʃ o w
nas	n a s
naslědnu	n a s l ɪ d n u
naslědnych	n a s l ɪ d n ɨ x
nasta	n a s t a
nastachu	n a s t a x u
nastajenje	n a s t a j e nʲ e
nastajeny	n a s t a j e n ɨ
nastajili	n a s t a j i l i
nastawa	n a s t a w a
nastawace	n a s t a w a ts e
nastawaše	n a s t a w a ʃ e
nastawka	n a s t a w k a
nastawkow	n a s t a w k o w
nastać	n a s t a tʃ
nastał	n a s t a w
nastorki	n a s t o ʀ k i
nastorčił	n a s t o ʀ tʃ i w
nastroje	n a s t ʀ o j e
nastupa	n a s t u p a
nastupajo	n a s t u p a j o
nastupi	n a s t u p i
nastupja	n a s t u pʲ a
natwarej	n a t w a ʀ e j
natwarić	n a t w a ʀ i tʃ
nawjazać	n a wʲ a z a tʃ
nawjazała	n a wʲ a z a w a
nawjedować	n a wʲ e d o w a tʃ
nawoda	n a w o d a
nawodow	n a w o d o w
nawopačne	n a w o p a tʃ n e
nawoči	n a w o tʃ i
nawuknjenje	n a w u k nʲ e nʲ e
nawuknu	n a w u k n u
nawukny	n a w u k n ɨ
nawuknychu	n a w u k n ɨ x u
nawuknyłoj	n a w u k n ɨ w o j
nazhonjenja	n a z h o nʲ e nʲ a
nazhonjenjach	n a z h o nʲ e nʲ a x
nazhonjenjow	n a z h o nʲ e nʲ o w
nazymje	n a z ɨ mʲ e
nazymskich	n a z ɨ m s k i x
naćahować	n a tʃ a h o w a tʃ
naćisk	n a tʃ i s k
naćisku	n a tʃ i s k u
načasnych	n a tʃ a s n ɨ x
načinić	n a tʃ i n i tʃ
načinja	n a tʃ i nʲ a
nałožk	n a w o ʒ k
nałožka	n a w o ʒ k a
nałožkami	n a w o ʒ k a m i
nałožkej	n a w o ʒ k e j
nałožki	n a w o ʒ k i
nałožkow	n a w o ʒ k o w
nałožowanje	n a w o ʒ o w a nʲ e
nałožować	n a w o ʒ o w a tʃ
nałožuje	n a w o ʒ u j e
naš	n a ʃ
naša	n a ʃ a
naše	n a ʃ e
našeho	n a ʃ e h o
našej	n a ʃ e j
našeje	n a ʃ e j e
našich	n a ʃ i x
našim	n a ʃ i m
našli	n a ʃ l i
našu	n a ʃ u
negatiwna	n e ɡ a t i w n a
negatiwne	n e ɡ a t i w n e
neple	n e p l e
nic	n i ts
nich	n i x
nichtó	n i x t ʊ
nihdy	n i h d ɨ
nikoho	n i k o h o
nikomu	n i k o m u
nim	n i m
nima	n i m a
nimaja	n i m a j a
nimale	n i m a l e
nimam	n i m a m
nimamy	n i m a m ɨ
nimi	n i m i
nimo	n i m o
niwow	n i w o w
niwowje	n i w o wʲ e
ničo	n i tʃ o
nižozemske	n i ʒ o z e m s k e
nižozemskeje	n i ʒ o z e m s k e j e
nje	nʲ e
njebjom	nʲ e bʲ o m
njebudźeće	nʲ e b u dʒ e tʃ e
njeby	nʲ e b ɨ
njebychmy	nʲ e b ɨ x m ɨ
njebě	nʲ e b ɪ
njeběše	nʲ e b ɪ ʃ e
njechornja	nʲ e x o ʀ nʲ a
njedawno	nʲ e d a w n o
njedopokazuja	nʲ e d o p o k a z u j a
njedosahace	nʲ e d o s a h a ts e
njedowěra	nʲ e d o w ɪ ʀ a
njedožiwi	nʲ e d o ʒ i w i
njedósta	nʲ e d ʊ s t a
njedźela	nʲ e dʒ e l a
njedźeli	nʲ e dʒ e l i
njedźelu	nʲ e dʒ e l u
njedźěleše	nʲ e dʒ ɪ l e ʃ e
njeeksistuje	nʲ e e k s i s t u j e
njeho	nʲ e h o
njehodźi	nʲ e h o dʒ i
njehraje	nʲ e h ʀ a j e
njehódnoći	nʲ e h ʊ d n o tʃ i
njehódnoćił	nʲ e h ʊ d n o tʃ i w
njej	nʲ e j
njeje	nʲ e j e
njejsmy	nʲ e j s m ɨ
njejstaj	nʲ e j s t a j
njejstej	nʲ e j s t e j
njejsu	nʲ e j s u
njejsy	nʲ e j s ɨ
njejsym	nʲ e j s ɨ m
njejsće	nʲ e j s tʃ e
njeličomne	nʲ e l i tʃ o m n e
njeličomnymi	nʲ e l i tʃ o m n ɨ m i
njemjetaj	nʲ e mʲ e t a j
njemodlće	nʲ e m o d l tʃ e
njemóža	nʲ e m ʊ ʒ a
njemóže	nʲ e m ʊ ʒ e
njemóžemoj	nʲ e m ʊ ʒ e m o j
njemóžemy	nʲ e m ʊ ʒ e m ɨ
njemóžu	nʲ e m ʊ ʒ u
njeměješe	nʲ e m ɪ j e ʃ e
njeměli	nʲ e m ɪ l i
njeměł	nʲ e m ɪ w
njenahladnu	nʲ e n a h l a d n u
njenamakaš	nʲ e n a m a k a ʃ
njenastanu	nʲ e n a s t a n u
njenawjaza	nʲ e n a wʲ a z a
njepile	nʲ e p i l e
njepilic	nʲ e p i l i ts
njepodpisachmoj	nʲ e p o d p i s a x m o j
njepomha	nʲ e p o m h a
njeposrědnje	nʲ e p o s ʀ ɪ d nʲ e
njepraj	nʲ e p ʀ a j
njepřećelej	nʲ e p ʃ e tʃ e l e j
njepřećelske	nʲ e p ʃ e tʃ e l s k e
njepřijomne	nʲ e p ʃ i j o m n e
njepřijomnych	nʲ e p ʃ i j o m n ɨ x
njepřitomnosće	nʲ e p ʃ i t o m n o s tʃ e
njereakcija	nʲ e ʀ e a k ts i j a
njerjana	nʲ e ʀʲ a n a
njerozsudźeni	nʲ e ʀ o z s u dʒ e n i
njeskutki	nʲ e s k u t k i
njeskutkuje	nʲ e s k u t k u j e
njesmě	nʲ e s m ɪ
njesmědźa	nʲ e s m ɪ dʒ a
njesmědźachu	nʲ e s m ɪ dʒ a x u
njesměrnje	nʲ e s m ɪ ʀ nʲ e
njesposrědkujemy	nʲ e s p o s ʀ ɪ d k u j e m ɨ
njesylni	nʲ e s ɨ l n i
njetrjebachu	nʲ e t ʀʲ e b a x u
njetrjebamy	nʲ e t ʀʲ e b a m ɨ
njetrjebataj	nʲ e t ʀʲ e b a t a j
njetrjebaš	nʲ e t ʀʲ e b a ʃ
njetworja	nʲ e t w o ʀʲ a
njewidźeše	nʲ e w i dʒ e ʃ e
njewobstejachu	nʲ e w o b s t e j a x u
njewola	nʲ e w o l a
njewotwisna	nʲ e w o t w i s n a
njewotwisnosć	nʲ e w o t w i s n o s tʃ
njewuwija	nʲ e w u w i j a
njewužiwa	nʲ e w u ʒ i w a
njewědomje	nʲ e w ɪ d o mʲ e
njewěm	nʲ e w ɪ m
njewěri	nʲ e w ɪ ʀ i
njewšědny	nʲ e w ʃ ɪ d n ɨ
njezakonsku	nʲ e z a k o n s k u
njezapřijima	nʲ e z a p ʃ i j i m a
njeznaja	nʲ e z n a j a
njeznataj	nʲ e z n a t a j
nječinješe	nʲ e tʃ i nʲ e ʃ e
nječińtej	nʲ e tʃ i nʲ t e j
njeńdźe	nʲ e nʲ dʒ e
nju	nʲ u
nochcedźa	n o x ts e dʒ a
nochcetaj	n o x ts e t a j
nochcyše	n o x ts ɨ ʃ e
nocy	n o ts ɨ
nohajcy	n o h a j ts ɨ
nohu	n o h u
nominowanej	n o m i n o w a n e j
nominowaštej	n o m i n o w a ʃ t e j
normalitu	n o ʀ m a l i t u
normalnych	n o ʀ m a l n ɨ x
nosu	n o s u
nosy	n o s ɨ
nowa	n o w a
nowak	n o w a k
nowaka	n o w a k a
nowe	n o w e
noweho	n o w e h o
nowej	n o w e j
noweje	n o w e j e
nowelěrowanje	n o w e l ɪ ʀ o w a nʲ e
nowelěruje	n o w e l ɪ ʀ u j e
nowember	n o w e m b e ʀ
nowembra	n o w e m b ʀ a
nowemu	n o w e m u
nowin	n o w i n
nowinarjow	n o w i n a ʀʲ o w
nowinarskej	n o w i n a ʀ s k e j
nowiny	n o w i n ɨ
nowoprodukowane	n o w o p ʀ o d u k o w a n e
nowotwórbow	n o w o t w ʊ ʀ b o w
nowowučer	n o w o w u tʃ e ʀ
nowozałožene	n o w o z a w o ʒ e n e
nowu	n o w u
nowy	n o w ɨ
nowych	n o w ɨ x
nowym	n o w ɨ m
nowymi	n o w ɨ m i
noze	n o z e
nošachu	n o ʃ a x u
nošerja	n o ʃ e ʀʲ a
nošerjemi	n o ʃ e ʀʲ e m i
nošerjow	n o ʃ e ʀʲ o w
nošerstwa	n o ʃ e ʀ s t w a
nošerstwo	n o ʃ e ʀ s t w o
nošerstwom	n o ʃ e ʀ s t w o m
nudle	n u d l e
nuk	n u k
nutř	n u tʃ
nutřkowne	n u tʃ k o w n e
nutřkowneje	n u tʃ k o w n e j e
nutřkownosć	n u tʃ k o w n o s tʃ
nuznje	n u z nʲ e
nuzy	n u z ɨ
nykusa	n ɨ k u s a
nykusow	n ɨ k u s o w
nyča	n ɨ tʃ a
nyšpor	n ɨ ʃ p o ʀ
nyšporje	n ɨ ʃ p o ʀʲ e
nóc	n ʊ ts
nóžki	n ʊ ʒ k i
něchtó	n ɪ x t ʊ
něhdy	n ɪ h d ɨ
něhdyše	n ɪ h d ɨ ʃ e
něhdyšeho	n ɪ h d ɨ ʃ e h o
něhdźe	n ɪ h dʒ e
někajke	n ɪ k a j k e
někajkej	n ɪ k a j k e j
někoho	n ɪ k o h o
někotre	n ɪ k o t ʀ e
někotremužkuli	n ɪ k o t ʀ e m u ʒ k u l i
někotrych	n ɪ k o t ʀ ɨ x
někotrym	n ɪ k o t ʀ ɨ m
někotrymi	n ɪ k o t ʀ ɨ m i
němcam	n ɪ m ts a m
němcow	n ɪ m ts o w
němsce	n ɪ m s ts e
němska	n ɪ m s k a
němske	n ɪ m s k e
němskej	n ɪ m s k e j
němskeje	n ɪ m s k e j e
němski	n ɪ m s k i
němskim	n ɪ m s k i m
němsko-česki	n ɪ m s k o tʃ e s k i
němsku	n ɪ m s k u
němčinu	n ɪ m tʃ i n u
nětko	n ɪ t k o
nětčiši	n ɪ t tʃ i ʃ i
něčeho	n ɪ tʃ e h o
něšto	n ɪ ʃ t o
něštožkuli	n ɪ ʃ t o ʒ k u l i
objektach	o bʲ e k t a x
objektiwniše	o bʲ e k t i w n i ʃ e
ochranow	o x ʀ a n o w
ochranowa	o x ʀ a n o w a
ochranowska	o x ʀ a n o w s k a
odyseji	o d ɨ s e j i
ofensiwy	o f e n s i w ɨ
oficialne	o f i ts i a l n e
oficialnej	o f i ts i a l n e j
oficialnym	o f i ts i a l n ɨ m
oktobra	o k t o b ʀ a
oktobru	o k t o b ʀ u
oldtimerowe	o l d t i m e ʀ o w e
online	o n l i n e
online-peticija	o n l i n e p e t i ts i j a
online-pruwowanja	o n l i n e p ʀ u w o w a nʲ a
online-wersiji	o n l i n e w e ʀ s i j i
online-wotuma	o n l i n e w o t u m a
opciju	o p ts i j u
optikarjej	o p t i k a ʀʲ e j
optimistiska	o p t i m i s t i s k a
orchestrje	o ʀ x e s t ʀʲ e
organ	o ʀ ɡ a n
organizacija	o ʀ ɡ a n i z a ts i j a
organizaciju	o ʀ ɡ a n i z a ts i j u
organizatoriske	o ʀ ɡ a n i z a t o ʀ i s k e
organizatorisku	o ʀ ɡ a n i z a t o ʀ i s k u
organizuje	o ʀ ɡ a n i z u j e
organizujetej	o ʀ ɡ a n i z u j e t e j
organow	o ʀ ɡ a n o w
orientowane	o ʀ i e n t o w a n e
orientuja	o ʀ i e n t u j a
ortodoksnej	o ʀ t o d o k s n e j
ortografiskich	o ʀ t o ɡ ʀ a f i s k i x
pachoł	p a x o w
pad	p a d
padlowachu	p a d l o w a x u
padźe	p a dʒ e
pak	p a k
panama	p a n a m a
panamaska	p a n a m a s k a
panamačanow	p a n a m a tʃ a n o w
papagajika	p a p a ɡ a j i k a
papjera	p a pʲ e ʀ a
papjernikarja	p a pʲ e ʀ n i k a ʀʲ a
papjeru	p a pʲ e ʀ u
paralelnje	p a ʀ a l e l nʲ e
parka	p a ʀ k a
parkach	p a ʀ k a x
parkow	p a ʀ k o w
parku	p a ʀ k u
parlamenta	p a ʀ l a m e n t a
participaciju	p a ʀ t i ts i p a ts i j u
partner	p a ʀ t n e ʀ
partnera	p a ʀ t n e ʀ a
partnerojo	p a ʀ t n e ʀ o j o
partnerow	p a ʀ t n e ʀ o w
party	p a ʀ t ɨ
paru	p a ʀ u
pastwje	p a s t wʲ e
pasć	p a s tʃ
pawk	p a w k
pawšala	p a w ʃ a l a
pawšalnje	p a w ʃ a l nʲ e
paćerjach	p a tʃ e ʀʲ a x
pačenje	p a tʃ e nʲ e
pačenosći	p a tʃ e n o s tʃ i
pedagogiskej	p e d a ɡ o ɡ i s k e j
pensijach	p e n s i j a x
personal	p e ʀ s o n a l
personalne	p e ʀ s o n a l n e
personalnje	p e ʀ s o n a l nʲ e
perspektiwy	p e ʀ s p e k t i w ɨ
pesticidow	p e s t i ts i d o w
petra	p e t ʀ a
pije	p i j e
pilnje	p i l nʲ e
pincy	p i n ts ɨ
pirmasens	p i ʀ m a s e n s
pisachu	p i s a x u
pisajće	p i s a j tʃ e
pisana	p i s a n a
pisanej	p i s a n e j
pisanska	p i s a n s k a
pisać	p i s a tʃ
pisał	p i s a w
pisaše	p i s a ʃ e
pismikow	p i s m i k o w
pismje	p i s mʲ e
pismo	p i s m o
pisomnje	p i s o m nʲ e
pisomnych	p i s o m n ɨ x
pić	p i tʃ
pjata	pʲ a t a
pjateho	pʲ a t e h o
pjatk	pʲ a t k
pjecow	pʲ e ts o w
pjecy	pʲ e ts ɨ
pjekarnja	pʲ e k a ʀ nʲ a
pjenjez	pʲ e nʲ e z
pjenjezy	pʲ e nʲ e z ɨ
pjenježnu	pʲ e nʲ e ʒ n u
pjeć	pʲ e tʃ
pjećiny	pʲ e tʃ i n ɨ
pječa	pʲ e tʃ a
pječenu	pʲ e tʃ e n u
plahowanje	p l a h o w a nʲ e
plan	p l a n
plana	p l a n a
planeće	p l a n e tʃ e
planje	p l a nʲ e
planowane	p l a n o w a n e
planowanemu	p l a n o w a n e m u
planowanja	p l a n o w a nʲ a
planowanje	p l a n o w a nʲ e
planowarjo	p l a n o w a ʀʲ o
planuje	p l a n u j e
plany	p l a n ɨ
plincy	p l i n ts ɨ
plusnikecami	p l u s n i k e ts a m i
plusnikečanskim	p l u s n i k e tʃ a n s k i m
po	p o
poboku	p o b o k u
pobožnu	p o b o ʒ n u
pobrachowacych	p o b ʀ a x o w a ts ɨ x
pochada	p o x a d a
pochadźa	p o x a dʒ a
pochadźeja	p o x a dʒ e j a
pod	p o d
poda	p o d a
podajmy	p o d a j m ɨ
podate	p o d a t e
podatej	p o d a t e j
podawa	p o d a w a
podawataj	p o d a w a t a j
podawk	p o d a w k
podała	p o d a w a
podaštaj	p o d a ʃ t a j
podeńdźenjow	p o d e nʲ dʒ e nʲ o w
podkłasć	p o d k w a s tʃ
podlěši	p o d l ɪ ʃ i
podobna	p o d o b n a
podobne	p o d o b n e
podobnej	p o d o b n e j
podobnje	p o d o b nʲ e
podobny	p o d o b n ɨ
podpisać	p o d p i s a tʃ
podpěra	p o d p ɪ ʀ a
podpěramy	p o d p ɪ ʀ a m ɨ
podpěrać	p o d p ɪ ʀ a tʃ
podpěru	p o d p ɪ ʀ u
podpěruje	p o d p ɪ ʀ u j e
podpěrujemy	p o d p ɪ ʀ u j e m ɨ
podpěrujetaj	p o d p ɪ ʀ u j e t a j
podpěruju	p o d p ɪ ʀ u j u
podzemske	p o d z e m s k e
podłožki	p o d w o ʒ k i
podłu	p o d w u
podšmórny	p o d ʃ m ʊ ʀ n ɨ
podšmórnyło	p o d ʃ m ʊ ʀ n ɨ w o
podźěl	p o dʒ ɪ l
pohanscy	p o h a n s ts ɨ
pohanske	p o h a n s k e
pohladajtaj	p o h l a d a j t a j
pohladny	p o h l a d n ɨ
pohonč	p o h o n tʃ
pohosćować	p o h o s tʃ o w a tʃ
pohłubšić	p o h w u b ʃ i tʃ
pojědźemoj	p o j ɪ dʒ e m o j
pojědźemy	p o j ɪ dʒ e m ɨ
pokaza	p o k a z a
pokazach	p o k a z a x
pokazaja	p o k a z a j a
pokazać	p o k a z a tʃ
pokazki	p o k a z k i
pokazuja	p o k a z u j a
pokazuje	p o k a z u j e
pokročowanje	p o k ʀ o tʃ o w a nʲ e
pokročować	p o k ʀ o tʃ o w a tʃ
pola	p o l a
polarnym	p o l a ʀ n ɨ m
polcy	p o l ts ɨ
policije	p o l i ts i j e
politice	p o l i t i ts e
politikar	p o l i t i k a ʀ
politikarjo	p o l i t i k a ʀʲ o
politiki	p o l i t i k i
politiske	p o l i t i s k e
politiskej	p o l i t i s k e j
politiski	p o l i t i s k i
politiskich	p o l i t i s k i x
politisku	p o l i t i s k u
poliwki	p o l i w k i
polu	p o l u
polěpšenje	p o l ɪ p ʃ e nʲ e
polěpšić	p o l ɪ p ʃ i tʃ
pomha	p o m h a
pomhać	p o m h a tʃ
pomhaše	p o m h a ʃ e
pomjenowanja	p o mʲ e n o w a nʲ a
pomjenowanje	p o mʲ e n o w a nʲ e
pomjeńšił	p o mʲ e nʲ ʃ i w
pomnik	p o m n i k
pomoc	p o m o ts
pomocnik	p o m o ts n i k
pomocnych	p o m o ts n ɨ x
pomocu	p o m o ts u
pomocy	p o m o ts ɨ
ponowić	p o n o w i tʃ
ponowjenja	p o n o wʲ e nʲ a
poněčim	p o n ɪ tʃ i m
popołdnjo	p o p o w d nʲ o
popołdnju	p o p o w d nʲ u
poprawom	p o p ʀ a w o m
pora	p o ʀ a
poradźi	p o ʀ a dʒ i
poradźowace	p o ʀ a dʒ o w a ts e
poradźować	p o ʀ a dʒ o w a tʃ
poražce	p o ʀ a ʒ ts e
porjad	p o ʀʲ a d
porjadej	p o ʀʲ a d e j
porjadne	p o ʀʲ a d n e
porjadny	p o ʀʲ a d n ɨ
porjadow	p o ʀʲ a d o w
porjedźe	p o ʀʲ e dʒ e
porjeńšenju	p o ʀʲ e nʲ ʃ e nʲ u
porno	p o ʀ n o
porodow	p o ʀ o d o w
porodźe	p o ʀ o dʒ e
porokuja	p o ʀ o k u j a
poručić	p o ʀ u tʃ i tʃ
poschodźe	p o s x o dʒ e
posedźenja	p o s e dʒ e nʲ a
posedźenjach	p o s e dʒ e nʲ a x
posedźenje	p o s e dʒ e nʲ e
posedźenju	p o s e dʒ e nʲ u
poskaj	p o s k a j
poskitk	p o s k i t k
poskitkej	p o s k i t k e j
poskitki	p o s k i t k i
poskitkom	p o s k i t k o m
poskitkomaj	p o s k i t k o m a j
poskitkow	p o s k i t k o w
poskitkowe	p o s k i t k o w e
poskićeja	p o s k i tʃ e j a
poskićeć	p o s k i tʃ e tʃ
poskići	p o s k i tʃ i
poskićimy	p o s k i tʃ i m ɨ
poskićiło	p o s k i tʃ i w o
poslednemu	p o s l e d n e m u
posledni	p o s l e d n i
poslednim	p o s l e d n i m
poslednje	p o s l e d nʲ e
posole	p o s o l e
posoł	p o s o w
pospyt	p o s p ɨ t
pospyty	p o s p ɨ t ɨ
posrědkowanju	p o s ʀ ɪ d k o w a nʲ u
posrědkuje	p o s ʀ ɪ d k u j e
posrědkujemy	p o s ʀ ɪ d k u j e m ɨ
postajenja	p o s t a j e nʲ a
postajenjemi	p o s t a j e nʲ e m i
postajenjow	p o s t a j e nʲ o w
postajenu	p o s t a j e n u
postaji	p o s t a j i
postajichu	p o s t a j i x u
postajić	p o s t a j i tʃ
postupowanje	p o s t u p o w a nʲ e
postupować	p o s t u p o w a tʃ
postupuje	p o s t u p u j e
poswjećili	p o s wʲ e tʃ i l i
posłownje	p o s w o w nʲ e
potajnstwa	p o t a j n s t w a
potencielnymi	p o t e n ts i e l n ɨ m i
potom	p o t o m
potrjeba	p o t ʀʲ e b a
potrjebach	p o t ʀʲ e b a x
potrjeby	p o t ʀʲ e b ɨ
potrjecheni	p o t ʀʲ e x e n i
potrjecheny	p o t ʀʲ e x e n ɨ
potrjechi	p o t ʀʲ e x i
potrěbnosćach	p o t ʀ ɪ b n o s tʃ a x
potwjerdźili	p o t wʲ e ʀ dʒ i l i
potłóćowanje	p o t w ʊ tʃ o w a nʲ e
powostanki	p o w o s t a n k i
powołanjach	p o w o w a nʲ a x
powołanje	p o w o w a nʲ e
powołanjom	p o w o w a nʲ o m
powołanskej	p o w o w a n s k e j
powójnskim	p o w ʊ j n s k i m
powěda	p o w ɪ d a
powědać	p o w ɪ d a tʃ
powědała	p o w ɪ d a w a
powědkow	p o w ɪ d k o w
powěstny	p o w ɪ s t n ɨ
powěsć	p o w ɪ s tʃ
powěsće	p o w ɪ s tʃ e
powěsću	p o w ɪ s tʃ u
powšitkownje	p o w ʃ i t k o w nʲ e
pozadkom	p o z a d k o m
pozběhuja	p o z b ɪ h u j a
pozdźe	p o z dʒ e
pozdźišo	p o z dʒ i ʃ o
pozhubja	p o z h u bʲ a
poziciju	p o z i ts i j u
pozitiwnje	p o z i t i w nʲ e
pozitiwnym	p o z i t i w n ɨ m
poćahowace	p o tʃ a h o w a ts e
poćahowane	p o tʃ a h o w a n e
poćahuje	p o tʃ a h u j e
poćeše	p o tʃ e ʃ e
počesćenje	p o tʃ e s tʃ e nʲ e
počinaše	p o tʃ i n a ʃ e
poł	p o w
połdra	p o w d ʀ a
połlěće	p o w l ɪ tʃ e
połna	p o w n a
połne	p o w n e
połnej	p o w n e j
połnje	p o w nʲ e
połnocy	p o w n o ts ɨ
połoženje	p o w o ʒ e nʲ e
połoženju	p o w o ʒ e nʲ u
połožił	p o w o ʒ i w
połožiła	p o w o ʒ i w a
połožiłoj	p o w o ʒ i w o j
połožištaj	p o w o ʒ i ʃ t a j
požadanje	p o ʒ a d a nʲ e
požadarjemi	p o ʒ a d a ʀʲ e m i
požadosćach	p o ʒ a d o s tʃ a x
požadosću	p o ʒ a d o s tʃ u
prajach	p ʀ a j a x
prajachmoj	p ʀ a j a x m o j
prajene	p ʀ a j e n e
praji	p ʀ a j i
prajił	p ʀ a j i w
prajiłoj	p ʀ a j i w o j
prajo	p ʀ a j o
praju	p ʀ a j u
praktikował	p ʀ a k t i k o w a w
praktisce	p ʀ a k t i s ts e
praktiskeje	p ʀ a k t i s k e j e
prastarych	p ʀ a s t a ʀ ɨ x
prawa	p ʀ a w a
prawe	p ʀ a w e
prawej	p ʀ a w e j
prawicarski	p ʀ a w i ts a ʀ s k i
prawidłownje	p ʀ a w i d w o w nʲ e
prawje	p ʀ a wʲ e
prawniske	p ʀ a w n i s k e
prawniskej	p ʀ a w n i s k e j
prawnisku	p ʀ a w n i s k u
prawo	p ʀ a w o
prawow	p ʀ a w o w
prawu	p ʀ a w u
prawy	p ʀ a w ɨ
prawych	p ʀ a w ɨ x
prawym	p ʀ a w ɨ m
praze	p ʀ a z e
praša	p ʀ a ʃ a
prašach	p ʀ a ʃ a x
prašamy	p ʀ a ʃ a m ɨ
prašenja	p ʀ a ʃ e nʲ a
prašenjach	p ʀ a ʃ e nʲ a x
prašenje	p ʀ a ʃ e nʲ e
prašenjemi	p ʀ a ʃ e nʲ e m i
prašenju	p ʀ a ʃ e nʲ u
pražene	p ʀ a ʒ e n e
precedencny	p ʀ e ts e d e n ts n ɨ
premier	p ʀ e m i e ʀ
premierministra	p ʀ e m i e ʀ m i n i s t ʀ a
premjery	p ʀ e mʲ e ʀ ɨ
prewentiwne	p ʀ e w e n t i w n e
prezencu	p ʀ e z e n ts u
prezentaciju	p ʀ e z e n t a ts i j u
prezentnej	p ʀ e z e n t n e j
prezentnišu	p ʀ e z e n t n i ʃ u
prezentować	p ʀ e z e n t o w a tʃ
prezentowaše	p ʀ e z e n t o w a ʃ e
prezentuje	p ʀ e z e n t u j e
prezes	p ʀ e z e s
prezident	p ʀ e z i d e n t
prezidentom	p ʀ e z i d e n t o m
prezidijej	p ʀ e z i d i j e j
preč	p ʀ e tʃ
primicy	p ʀ i m i ts ɨ
princip	p ʀ i n ts i p
prioritu	p ʀ i o ʀ i t u
priwatny	p ʀ i w a t n ɨ
priwatnych	p ʀ i w a t n ɨ x
prjedawšich	p ʀʲ e d a w ʃ i x
prjedy	p ʀʲ e d ɨ
problem	p ʀ o b l e m
problemach	p ʀ o b l e m a x
problematiski	p ʀ o b l e m a t i s k i
problemy	p ʀ o b l e m ɨ
probow	p ʀ o b o w
probowemu	p ʀ o b o w e m u
procentow	p ʀ o ts e n t o w
proces	p ʀ o ts e s
procesijónom	p ʀ o ts e s i j ʊ n o m
procesion	p ʀ o ts e s i o n
proch	p ʀ o x
prochsrěbak	p ʀ o x s ʀ ɪ b a k
produkuje	p ʀ o d u k u j e
program	p ʀ o ɡ ʀ a m
programa	p ʀ o ɡ ʀ a m a
programatiskeho	p ʀ o ɡ ʀ a m a t i s k e h o
programje	p ʀ o ɡ ʀ a mʲ e
programom	p ʀ o ɡ ʀ a m o m
programy	p ʀ o ɡ ʀ a m ɨ
projekt	p ʀ o j e k t
projekta	p ʀ o j e k t a
projektach	p ʀ o j e k t a x
projektaj	p ʀ o j e k t a j
projektami	p ʀ o j e k t a m i
projektom	p ʀ o j e k t o m
projektow	p ʀ o j e k t o w
projektowa	p ʀ o j e k t o w a
projektowe	p ʀ o j e k t o w e
projektoweho	p ʀ o j e k t o w e h o
projektowych	p ʀ o j e k t o w ɨ x
projekty	p ʀ o j e k t ɨ
proletarka	p ʀ o l e t a ʀ k a
promocije	p ʀ o m o ts i j e
prospekty	p ʀ o s p e k t ɨ
prosy	p ʀ o s ɨ
prosył	p ʀ o s ɨ w
prosće	p ʀ o s tʃ e
protestowali	p ʀ o t e s t o w a l i
protesty	p ʀ o t e s t ɨ
protokola	p ʀ o t o k o l a
protokoluja	p ʀ o t o k o l u j a
prowincy	p ʀ o w i n ts ɨ
prošu	p ʀ o ʃ u
pruskich	p ʀ u s k i x
pruwowanjow	p ʀ u w o w a nʲ o w
pruwowanske	p ʀ u w o w a n s k e
pruwować	p ʀ u w o w a tʃ
pruwuje	p ʀ u w u j e
pruwujomnje	p ʀ u w u j o m nʲ e
próca	p ʀ ʊ ts a
prócowanja	p ʀ ʊ ts o w a nʲ a
prócowanje	p ʀ ʊ ts o w a nʲ e
prócowanju	p ʀ ʊ ts o w a nʲ u
prócuje	p ʀ ʊ ts u j e
próstwa	p ʀ ʊ s t w a
próstwam	p ʀ ʊ s t w a m
próstwu	p ʀ ʊ s t w u
próstwy	p ʀ ʊ s t w ɨ
prózdninach	p ʀ ʊ z d n i n a x
prěc	p ʀ ɪ ts
prědku	p ʀ ɪ d k u
prěne	p ʀ ɪ n e
prěni	p ʀ ɪ n i
prěnich	p ʀ ɪ n i x
prěnim	p ʀ ɪ n i m
prěnja	p ʀ ɪ nʲ a
prěnje	p ʀ ɪ nʲ e
prěnjemu	p ʀ ɪ nʲ e m u
prěnjorjadnje	p ʀ ɪ nʲ o ʀʲ a d nʲ e
ptači	p t a tʃ i
ptačim	p t a tʃ i m
ptačka	p t a tʃ k a
ptačkam	p t a tʃ k a m
ptačokwasneho	p t a tʃ o k w a s n e h o
publikaciski	p u b l i k a ts i s k i
pukotać	p u k o t a tʃ
putał	p u t a w
putnicy	p u t n i ts ɨ
puć	p u tʃ
pućach	p u tʃ a x
pućniki	p u tʃ n i k i
pućowacy	p u tʃ o w a ts ɨ
pućowanske	p u tʃ o w a n s k e
pućowanskej	p u tʃ o w a n s k e j
pućowanskimi	p u tʃ o w a n s k i m i
puću	p u tʃ u
pušći	p u ʃ tʃ i
pyta	p ɨ t a
pytaj	p ɨ t a j
pytaja	p ɨ t a j a
pytanju	p ɨ t a nʲ u
pytaše	p ɨ t a ʃ e
pódla	p ʊ d l a
pódy	p ʊ d ɨ
pój	p ʊ j
pólšćinje	p ʊ l ʃ tʃ i nʲ e
póndźelach	p ʊ n dʒ e l a x
póńdu	p ʊ nʲ d u
pčołarka	p tʃ o w a ʀ k a
pčołka	p tʃ o w k a
pěskowej	p ɪ s k o w e j
pěstowarnje	p ɪ s t o w a ʀ nʲ e
pěstowarnju	p ɪ s t o w a ʀ nʲ u
pěstować	p ɪ s t o w a tʃ
pěši	p ɪ ʃ i
płatom	p w a t o m
płaća	p w a tʃ a
płaći	p w a tʃ i
płaćiwosć	p w a tʃ i w o s tʃ
płaćiwosće	p w a tʃ i w o s tʃ e
płaćiwych	p w a tʃ i w ɨ x
płaćić	p w a tʃ i tʃ
płodoslěd	p w o d o s l ɪ d
płotowčina	p w o t o w tʃ i n a
płoty	p w o t ɨ
płódne	p w ʊ d n e
płódnej	p w ʊ d n e j
płódnosće	p w ʊ d n o s tʃ e
přebysławej	p ʃ e b ɨ s w a w e j
přebywanišća	p ʃ e b ɨ w a n i ʃ tʃ a
přeběži	p ʃ e b ɪ ʒ i
přeco	p ʃ e ts o
před	p ʃ e d
předaloko	p ʃ e d a l o k o
předawarjow	p ʃ e d a w a ʀʲ o w
předchadźacym	p ʃ e d x a dʒ a ts ɨ m
předewzaća	p ʃ e d e w z a tʃ a
předewzaćow	p ʃ e d e w z a tʃ o w
předewšěm	p ʃ e d e w ʃ ɪ m
předležacy	p ʃ e d l e ʒ a ts ɨ
předležeć	p ʃ e d l e ʒ e tʃ
předleži	p ʃ e d l e ʒ i
předmjet	p ʃ e d mʲ e t
předmjetach	p ʃ e d mʲ e t a x
předmjetow	p ʃ e d mʲ e t o w
předpis	p ʃ e d p i s
předpisy	p ʃ e d p i s ɨ
předpołoža	p ʃ e d p o w o ʒ a
předpołoženym	p ʃ e d p o w o ʒ e n ɨ m
předpołožili	p ʃ e d p o w o ʒ i l i
předstajamy	p ʃ e d s t a j a m ɨ
předstajeneho	p ʃ e d s t a j e n e h o
předstajenje	p ʃ e d s t a j e nʲ e
předstajenju	p ʃ e d s t a j e nʲ u
předstajeny	p ʃ e d s t a j e n ɨ
předstaji	p ʃ e d s t a j i
předstajichu	p ʃ e d s t a j i x u
předstajić	p ʃ e d s t a j i tʃ
předstajiłoj	p ʃ e d s t a j i w o j
předstawy	p ʃ e d s t a w ɨ
předsudkow	p ʃ e d s u d k o w
předsyda	p ʃ e d s ɨ d a
předsydka	p ʃ e d s ɨ d k a
předsydstwa	p ʃ e d s ɨ d s t w a
předsydstwo	p ʃ e d s ɨ d s t w o
předsydstwu	p ʃ e d s ɨ d s t w u
předsydu	p ʃ e d s ɨ d u
předsydy	p ʃ e d s ɨ d ɨ
předwidźane	p ʃ e d w i dʒ a n e
předčitaj	p ʃ e d tʃ i t a j
předšulske	p ʃ e d ʃ u l s k e
předšulskich	p ʃ e d ʃ u l s k i x
předźěłane	p ʃ e dʒ ɪ w a n e
předźěłanje	p ʃ e dʒ ɪ w a nʲ e
předźěłać	p ʃ e dʒ ɪ w a tʃ
přehlad	p ʃ e h l a d
přehladać	p ʃ e h l a d a tʃ
přehladce	p ʃ e h l a d ts e
přehladka	p ʃ e h l a d k a
přeje	p ʃ e j e
přejemy	p ʃ e j e m ɨ
překročić	p ʃ e k ʀ o tʃ i tʃ
překwapja	p ʃ e k w a pʲ a
překwapjaca	p ʃ e k w a pʲ a ts a
překwapjenka	p ʃ e k w a pʲ e n k a
překwapjenku	p ʃ e k w a pʲ e n k u
přemało	p ʃ e m a w o
přemysłoweho	p ʃ e m ɨ s w o w e h o
přemysłowych	p ʃ e m ɨ s w o w ɨ x
přemóžena	p ʃ e m ʊ ʒ e n a
přeměniło	p ʃ e m ɪ n i w o
přenajachu	p ʃ e n a j a x u
přenjesenym	p ʃ e nʲ e s e n ɨ m
přenjesć	p ʃ e nʲ e s tʃ
přenocowali	p ʃ e n o ts o w a l i
přenocować	p ʃ e n o ts o w a tʃ
přepodaty	p ʃ e p o d a t ɨ
přepodać	p ʃ e p o d a tʃ
přepokazuje	p ʃ e p o k a z u j e
přeprosyli	p ʃ e p ʀ o s ɨ l i
přeprosyć	p ʃ e p ʀ o s ɨ tʃ
přeprosyła	p ʃ e p ʀ o s ɨ w a
přeprošeni	p ʃ e p ʀ o ʃ e n i
přeprošenja	p ʃ e p ʀ o ʃ e nʲ a
přeprošenje	p ʃ e p ʀ o ʃ e nʲ e
přeprošeny	p ʃ e p ʀ o ʃ e n ɨ
přepruwować	p ʃ e p ʀ u w o w a tʃ
přepruwujomna	p ʃ e p ʀ u w u j o m n a
přepytowanja	p ʃ e p ɨ t o w a nʲ a
přepytowanje	p ʃ e p ɨ t o w a nʲ e
přepławom	p ʃ e p w a w o m
přerjadować	p ʃ e ʀʲ a d o w a tʃ
přesadźenje	p ʃ e s a dʒ e nʲ e
přesadźenjom	p ʃ e s a dʒ e nʲ o m
přesadźenju	p ʃ e s a dʒ e nʲ u
přesadźiłoj	p ʃ e s a dʒ i w o j
přesadźowanja	p ʃ e s a dʒ o w a nʲ a
přesahowaca	p ʃ e s a h o w a ts a
přesahowacy	p ʃ e s a h o w a ts ɨ
přestaja	p ʃ e s t a j a
přestajichu	p ʃ e s t a j i x u
přestawku	p ʃ e s t a w k u
přesuwali	p ʃ e s u w a l i
přesydlenje	p ʃ e s ɨ d l e nʲ e
přetož	p ʃ e t o ʒ
přetworić	p ʃ e t w o ʀ i tʃ
přewjedu	p ʃ e wʲ e d u
přewjeduja	p ʃ e wʲ e d u j a
přewjedł	p ʃ e wʲ e d w
přewjedźechu	p ʃ e wʲ e dʒ e x u
přewjedźenje	p ʃ e wʲ e dʒ e nʲ e
přewjedźenju	p ʃ e wʲ e dʒ e nʲ u
přewjedźeše	p ʃ e wʲ e dʒ e ʃ e
přewjele	p ʃ e wʲ e l e
přewjesć	p ʃ e wʲ e s tʃ
přewodźeć	p ʃ e w o dʒ e tʃ
přewodźuje	p ʃ e w o dʒ u j e
přewostajenej	p ʃ e w o s t a j e n e j
přewostajić	p ʃ e w o s t a j i tʃ
přewozmje	p ʃ e w o z mʲ e
přewróće	p ʃ e w ʀ ʊ tʃ e
přewza	p ʃ e w z a
přewzam	p ʃ e w z a m
přewzać	p ʃ e w z a tʃ
přewzał	p ʃ e w z a w
přewšo	p ʃ e w ʃ o
přez	p ʃ e z
přezjedni	p ʃ e z j e d n i
přeća	p ʃ e tʃ a
přećel	p ʃ e tʃ e l
přećeljo	p ʃ e tʃ e l j o
přećelka	p ʃ e tʃ e l k a
přećelny	p ʃ e tʃ e l n ɨ
přećelow	p ʃ e tʃ e l o w
přećiwkow	p ʃ e tʃ i w k o w
přećiwnik	p ʃ e tʃ i w n i k
přećiwo	p ʃ e tʃ i w o
přeću	p ʃ e tʃ u
přełožka	p ʃ e w o ʒ k a
přełožowarjow	p ʃ e w o ʒ o w a ʀʲ o w
přežiwjenju	p ʃ e ʒ i wʲ e nʲ u
při	p ʃ i
přibrjohow	p ʃ i b ʀʲ o h o w
přiběracy	p ʃ i b ɪ ʀ a ts ɨ
přiběraja	p ʃ i b ɪ ʀ a j a
přichadźachu	p ʃ i x a dʒ a x u
přichilene	p ʃ i x i l e n e
přichod	p ʃ i x o d
přichoda	p ʃ i x o d a
přichodej	p ʃ i x o d e j
přichodne	p ʃ i x o d n e
přichodneje	p ʃ i x o d n e j e
přichodnje	p ʃ i x o d nʲ e
přichodny	p ʃ i x o d n ɨ
přichodnych	p ʃ i x o d n ɨ x
přichodnym	p ʃ i x o d n ɨ m
přichodźe	p ʃ i x o dʒ e
přidatne	p ʃ i d a t n e
přidatnje	p ʃ i d a t nʲ e
přidatnych	p ʃ i d a t n ɨ x
přidatnymaj	p ʃ i d a t n ɨ m a j
přidał	p ʃ i d a w
přidružnik	p ʃ i d ʀ u ʒ n i k
přidružnikow	p ʃ i d ʀ u ʒ n i k o w
přihotow	p ʃ i h o t o w
přihotowanje	p ʃ i h o t o w a nʲ e
přihotowanskim	p ʃ i h o t o w a n s k i m
přihotowałoj	p ʃ i h o t o w a w o j
přihotuja	p ʃ i h o t u j a
přihłosowanjom	p ʃ i h w o s o w a nʲ o m
přihłosować	p ʃ i h w o s o w a tʃ
přihłosowała	p ʃ i h w o s o w a w a
přijate	p ʃ i j a t e
přijimar	p ʃ i j i m a ʀ
přijomne	p ʃ i j o m n e
přijomnje	p ʃ i j o m nʲ e
přijědźechu	p ʃ i j ɪ dʒ e x u
přijězd	p ʃ i j ɪ z d
přijěł	p ʃ i j ɪ w
přikład	p ʃ i k w a d
přikładom	p ʃ i k w a d o m
přikłady	p ʃ i k w a d ɨ
přikładźe	p ʃ i k w a dʒ e
přiležnosći	p ʃ i l e ʒ n o s tʃ i
přilubjene	p ʃ i l u bʲ e n e
přimjenow	p ʃ i mʲ e n o w
přiměrjene	p ʃ i m ɪ ʀʲ e n e
přindźe	p ʃ i n dʒ e
přinjese	p ʃ i nʲ e s e
přinošk	p ʃ i n o ʃ k
přinoški	p ʃ i n o ʃ k i
přinošowali	p ʃ i n o ʃ o w a l i
přinošować	p ʃ i n o ʃ o w a tʃ
přinošowało	p ʃ i n o ʃ o w a w o
přinošuje	p ʃ i n o ʃ u j e
připisane	p ʃ i p i s a n e
připokazankow	p ʃ i p o k a z a n k o w
připóznateje	p ʃ i p ʊ z n a t e j e
připóznawamy	p ʃ i p ʊ z n a w a m ɨ
připóznaće	p ʃ i p ʊ z n a tʃ e
přirada	p ʃ i ʀ a d a
přirjadowane	p ʃ i ʀʲ a d o w a n e
přirjadowanju	p ʃ i ʀʲ a d o w a nʲ u
přiroda	p ʃ i ʀ o d a
přirodoškit	p ʃ i ʀ o d o ʃ k i t
přirodoškita	p ʃ i ʀ o d o ʃ k i t a
přirody	p ʃ i ʀ o d ɨ
přirodźe	p ʃ i ʀ o dʒ e
přirunowace	p ʃ i ʀ u n o w a ts e
přiručka	p ʃ i ʀ u tʃ k a
přiručki	p ʃ i ʀ u tʃ k i
přistajeni	p ʃ i s t a j e n i
přistajili	p ʃ i s t a j i l i
přistupna	p ʃ i s t u p n a
přistupne	p ʃ i s t u p n e
přiswoja	p ʃ i s w o j a
přiswojenju	p ʃ i s w o j e nʲ u
přiswojić	p ʃ i s w o j i tʃ
přiswojiła	p ʃ i s w o j i w a
přisłuša	p ʃ i s w u ʃ a
přisłušacych	p ʃ i s w u ʃ a ts ɨ x
přisłušne	p ʃ i s w u ʃ n e
přisłušnosći	p ʃ i s w u ʃ n o s tʃ i
přitomne	p ʃ i t o m n e
přitomni	p ʃ i t o m n i
přitomnostneje	p ʃ i t o m n o s t n e j e
přitomnosće	p ʃ i t o m n o s tʃ e
přitomnych	p ʃ i t o m n ɨ x
přiwabjeja	p ʃ i w a bʲ e j a
přiwjezechu	p ʃ i wʲ e z e x u
přiwobroća	p ʃ i w o b ʀ o tʃ a
přiwuznych	p ʃ i w u z n ɨ x
přiwzace	p ʃ i w z a ts e
přiwzaty	p ʃ i w z a t ɨ
přiwzaću	p ʃ i w z a tʃ u
přiwótřichu	p ʃ i w ʊ tʃ i x u
přiwšěm	p ʃ i w ʃ ɪ m
přizamknyła	p ʃ i z a m k n ɨ w a
přizjewić	p ʃ i z j e w i tʃ
přizwolene	p ʃ i z w o l e n e
přićahnyć	p ʃ i tʃ a h n ɨ tʃ
přičinu	p ʃ i tʃ i n u
přiłohi	p ʃ i w o h i
přińdu	p ʃ i nʲ d u
přińdź	p ʃ i nʲ dʒ
přińdźe	p ʃ i nʲ dʒ e
přińdźech	p ʃ i nʲ dʒ e x
přińdźechmy	p ʃ i nʲ dʒ e x m ɨ
přińdźetej	p ʃ i nʲ dʒ e t e j
přińdźeštej	p ʃ i nʲ dʒ e ʃ t e j
přińdźešće	p ʃ i nʲ dʒ e ʃ tʃ e
přińć	p ʃ i nʲ tʃ
přišoł	p ʃ i ʃ o w
přišła	p ʃ i ʃ w a
přišło	p ʃ i ʃ w o
querxenland	k v u e ʀ x e n l a n d
rabinow	ʀ a b i n o w
rada	ʀ a d a
radikalizacija	ʀ a d i k a l i z a ts i j a
radnicach	ʀ a d n i ts a x
radosć	ʀ a d o s tʃ
radow	ʀ a d o w
radu	ʀ a d u
radworja	ʀ a d w o ʀʲ a
radworju	ʀ a d w o ʀʲ u
radworske	ʀ a d w o ʀ s k e
radworskej	ʀ a d w o ʀ s k e j
radworskeju	ʀ a d w o ʀ s k e j u
radworskimi	ʀ a d w o ʀ s k i m i
rady	ʀ a d ɨ
radźe	ʀ a dʒ e
radźenje	ʀ a dʒ e nʲ e
radźimy	ʀ a dʒ i m ɨ
radźićelemi	ʀ a dʒ i tʃ e l e m i
radźićeljo	ʀ a dʒ i tʃ e l j o
radźićelow	ʀ a dʒ i tʃ e l o w
radźiła	ʀ a dʒ i w a
radźiło	ʀ a dʒ i w o
rakojdach	ʀ a k o j d a x
ramiki	ʀ a m i k i
ramiku	ʀ a m i k u
ranje	ʀ a nʲ e
rano	ʀ a n o
ratarjow	ʀ a t a ʀʲ o w
ratarske	ʀ a t a ʀ s k e
ratarskeho	ʀ a t a ʀ s k e h o
raz	ʀ a z
razaj	ʀ a z a j
razej	ʀ a z e j
razniši	ʀ a z n i ʃ i
razy	ʀ a z ɨ
reagować	ʀ e a ɡ o w a tʃ
reagowaše	ʀ e a ɡ o w a ʃ e
reagujeće	ʀ e a ɡ u j e tʃ e
realizowachu	ʀ e a l i z o w a x u
realizowanje	ʀ e a l i z o w a nʲ e
realnu	ʀ e a l n u
recyclowany	ʀ e ts ɨ ts l o w a n ɨ
redakciske	ʀ e d a k ts i s k e
redaktorka	ʀ e d a k t o ʀ k a
referenta	ʀ e f e ʀ e n t a
reformacije	ʀ e f o ʀ m a ts i j e
reformaciju	ʀ e f o ʀ m a ts i j u
region	ʀ e ɡ i o n
regiona	ʀ e ɡ i o n a
regionalna	ʀ e ɡ i o n a l n a
regionalne	ʀ e ɡ i o n a l n e
regionalneje	ʀ e ɡ i o n a l n e j e
registrować	ʀ e ɡ i s t ʀ o w a tʃ
rejach	ʀ e j a x
rejemi	ʀ e j e m i
rejow	ʀ e j o w
reju	ʀ e j u
rentu	ʀ e n t u
reparaturu	ʀ e p a ʀ a t u ʀ u
repertoira	ʀ e p e ʀ t o i ʀ a
repertoirom	ʀ e p e ʀ t o i ʀ o m
reprodukcije	ʀ e p ʀ o d u k ts i j e
republiki	ʀ e p u b l i k i
resp	ʀ e s p
respektiwnje	ʀ e s p e k t i w nʲ e
resursy	ʀ e s u ʀ s ɨ
rewitalizaciju	ʀ e w i t a l i z a ts i j u
rewizijow	ʀ e w i z i j o w
rewoluciju	ʀ e w o l u ts i j u
rewěra	ʀ e w ɪ ʀ a
rewěry	ʀ e w ɪ ʀ ɨ
rezerwata	ʀ e z e ʀ w a t a
rezerwaće	ʀ e z e ʀ w a tʃ e
rezolucije	ʀ e z o l u ts i j e
rhön	ʀ h o n
rizikach	ʀ i z i k a x
rjad	ʀʲ a d
rjadnicow	ʀʲ a d n i ts o w
rjadnicy	ʀʲ a d n i ts ɨ
rjadniskim	ʀʲ a d n i s k i m
rjadow	ʀʲ a d o w
rjadowane	ʀʲ a d o w a n e
rjadowanje	ʀʲ a d o w a nʲ e
rjadować	ʀʲ a d o w a tʃ
rjadowni	ʀʲ a d o w n i
rjadownjach	ʀʲ a d o w nʲ a x
rjaduje	ʀʲ a d u j e
rjana	ʀʲ a n a
rjane	ʀʲ a n e
rjanosć	ʀʲ a n o s tʃ
rjanosće	ʀʲ a n o s tʃ e
rjany	ʀʲ a n ɨ
rjechtaja	ʀʲ e x t a j a
rjechtanje	ʀʲ e x t a nʲ e
rjekny	ʀʲ e k n ɨ
rjemjesło	ʀʲ e mʲ e s w o
rjenje	ʀʲ e nʲ e
robert	ʀ o b e ʀ t
rohde	ʀ o h d e
rohizna	ʀ o h i z n a
rohodźe	ʀ o h o dʒ e
roma	ʀ o m a
roman	ʀ o m a n
romanow	ʀ o m a n o w
romow	ʀ o m o w
romskeho	ʀ o m s k e h o
rostlinow	ʀ o s t l i n o w
rostlinske	ʀ o s t l i n s k e
rostliny	ʀ o s t l i n ɨ
rosćacu	ʀ o s tʃ a ts u
rosće	ʀ o s tʃ e
rownoho	ʀ o w n o h o
rozbija	ʀ o z b i j a
rozdźěle	ʀ o z dʒ ɪ l e
rozdźěliła	ʀ o z dʒ ɪ l i w a
rozdźělne	ʀ o z dʒ ɪ l n e
rozestajenju	ʀ o z e s t a j e nʲ u
rozesyłarnje	ʀ o z e s ɨ w a ʀ nʲ e
rozhori	ʀ o z h o ʀ i
rozjimała	ʀ o z j i m a w a
rozkćěw	ʀ o z k tʃ ɪ w
rozmach	ʀ o z m a x
rozmnoženje	ʀ o z m n o ʒ e nʲ e
rozmołwa	ʀ o z m o w w a
rozmołwjeć	ʀ o z m o w wʲ e tʃ
rozmołwow	ʀ o z m o w w o w
rozmołwu	ʀ o z m o w w u
rozmołwy	ʀ o z m o w w ɨ
rozmyslowanja	ʀ o z m ɨ s l o w a nʲ a
rozmyslować	ʀ o z m ɨ s l o w a tʃ
rozmyslował	ʀ o z m ɨ s l o w a w
rozpalitej	ʀ o z p a l i t e j
rozprawa	ʀ o z p ʀ a w a
rozprawja	ʀ o z p ʀ a wʲ a
rozprawje	ʀ o z p ʀ a wʲ e
rozrisanja	ʀ o z ʀ i s a nʲ a
rozrisanje	ʀ o z ʀ i s a nʲ e
rozrisanjemi	ʀ o z ʀ i s a nʲ e m i
rozrjaduje	ʀ o z ʀʲ a d u j e
rozrost	ʀ o z ʀ o s t
rozsud	ʀ o z s u d
rozsuda	ʀ o z s u d a
rozsudow	ʀ o z s u d o w
rozsudy	ʀ o z s u d ɨ
rozsudźeć	ʀ o z s u dʒ e tʃ
rozsudźi	ʀ o z s u dʒ i
rozsudźił	ʀ o z s u dʒ i w
rozsudźiła	ʀ o z s u dʒ i w a
rozsudźiło	ʀ o z s u dʒ i w o
rozsudźće	ʀ o z s u dʒ tʃ e
rozumja	ʀ o z u mʲ a
rozčłonkowali	ʀ o z tʃ w o n k o w a l i
rozłama	ʀ o z w a m a
rozłoži	ʀ o z w o ʒ i
rozłožuje	ʀ o z w o ʒ u j e
rozšěriła	ʀ o z ʃ ɪ ʀ i w a
rozšěrja	ʀ o z ʃ ɪ ʀʲ a
rozšěrjene	ʀ o z ʃ ɪ ʀʲ e n e
rozšěrjenje	ʀ o z ʃ ɪ ʀʲ e nʲ e
rozšěrjenym	ʀ o z ʃ ɪ ʀʲ e n ɨ m
rozšěrjeć	ʀ o z ʃ ɪ ʀʲ e tʃ
rozžohnować	ʀ o z ʒ o h n o w a tʃ
roły	ʀ o w ɨ
rubriku	ʀ u b ʀ i k u
ruce	ʀ u ts e
rukach	ʀ u k a x
ruki	ʀ u k i
rukow	ʀ u k o w
rum	ʀ u m
ruma	ʀ u m a
rumje	ʀ u mʲ e
rumnosć	ʀ u m n o s tʃ
rumnosće	ʀ u m n o s tʃ e
rumow	ʀ u m o w
rumunska	ʀ u m u n s k a
rumy	ʀ u m ɨ
runa	ʀ u n a
runinach	ʀ u n i n a x
runinje	ʀ u n i nʲ e
runje	ʀ u nʲ e
runočasnje	ʀ u n o tʃ a s nʲ e
ruskej	ʀ u s k e j
ručež	ʀ u tʃ e ʒ
ručnej	ʀ u tʃ n e j
ryby	ʀ ɨ b ɨ
ryjo	ʀ ɨ j o
rynk	ʀ ɨ n k
rys	ʀ ɨ s
rysowanki	ʀ ɨ s o w a n k i
rytmusu	ʀ ɨ t m u s u
ryzy	ʀ ɨ z ɨ
ryćerjo	ʀ ɨ tʃ e ʀʲ o
ryćerkubler	ʀ ɨ tʃ e ʀ k u b l e ʀ
rólow	ʀ ʊ l o w
rólu	ʀ ʊ l u
róčnica	ʀ ʊ tʃ n i ts a
róžemi	ʀ ʊ ʒ e m i
róžeńće	ʀ ʊ ʒ e nʲ tʃ e
róžka	ʀ ʊ ʒ k a
rěbl	ʀ ɪ b l
rěblu	ʀ ɪ b l u
rěka	ʀ ɪ k a
rěku	ʀ ɪ k u
rěč	ʀ ɪ tʃ
rěča	ʀ ɪ tʃ a
rěčaceho	ʀ ɪ tʃ a ts e h o
rěčachu	ʀ ɪ tʃ a x u
rěčacych	ʀ ɪ tʃ a ts ɨ x
rěče	ʀ ɪ tʃ e
rěčewěda	ʀ ɪ tʃ e w ɪ d a
rěčeć	ʀ ɪ tʃ e tʃ
rěčeše	ʀ ɪ tʃ e ʃ e
rěči	ʀ ɪ tʃ i
rěčimy	ʀ ɪ tʃ i m ɨ
rěčki	ʀ ɪ tʃ k i
rěčna	ʀ ɪ tʃ n a
rěčne	ʀ ɪ tʃ n e
rěčneje	ʀ ɪ tʃ n e j e
rěčnica	ʀ ɪ tʃ n i ts a
rěčnicu	ʀ ɪ tʃ n i ts u
rěčnicy	ʀ ɪ tʃ n i ts ɨ
rěčnik	ʀ ɪ tʃ n i k
rěčnje	ʀ ɪ tʃ nʲ e
rěčnopedagogiskeho	ʀ ɪ tʃ n o p e d a ɡ o ɡ i s k e h o
rěčnu	ʀ ɪ tʃ n u
rěčny	ʀ ɪ tʃ n ɨ
rěčnych	ʀ ɪ tʃ n ɨ x
rěčnym	ʀ ɪ tʃ n ɨ m
rěčomaj	ʀ ɪ tʃ o m a j
rěčow	ʀ ɪ tʃ o w
rěču	ʀ ɪ tʃ u
sad	s a d
sadach	s a d a x
sady	s a d ɨ
sadźeć	s a dʒ e tʃ
saje	s a j e
sakska	s a k s k a
sakske	s a k s k e
sakskeho	s a k s k e h o
sakskej	s a k s k e j
sakskeje	s a k s k e j e
sakskich	s a k s k i x
sakskim	s a k s k i m
saksku	s a k s k u
salomonowej	s a l o m o n o w e j
sam	s a m
sama	s a m a
same	s a m e
sami	s a m i
samo	s a m o
samoho	s a m o h o
samopaslenym	s a m o p a s l e n ɨ m
samopječenym	s a m o pʲ e tʃ e n ɨ m
samopostajowanja	s a m o p o s t a j o w a nʲ a
samopostajowanskich	s a m o p o s t a j o w a n s k i x
samostatna	s a m o s t a t n a
samostatne	s a m o s t a t n e
samostatny	s a m o s t a t n ɨ
samozrozumliwosć	s a m o z ʀ o z u m l i w o s tʃ
samozrozumliwu	s a m o z ʀ o z u m l i w u
samsne	s a m s n e
samsnej	s a m s n e j
samsnym	s a m s n ɨ m
sandalach	s a n d a l a x
sankcije	s a n k ts i j e
saněrowane	s a n ɪ ʀ o w a n e
sapaja	s a p a j a
sarkastisce	s a ʀ k a s t i s ts e
scenach	s ts e n a x
scenami	s ts e n a m i
scenu	s ts e n u
sceny	s ts e n ɨ
schadźenje	s x a dʒ e nʲ e
schadźowanka	s x a dʒ o w a n k a
schadźuje	s x a dʒ u j e
schoriłoj	s x o ʀ i w o j
schramm	s x ʀ a m m
schubertec	s x u b e ʀ t e ts
schwali	s x w a l i
schwalił	s x w a l i w
scyła	s ts ɨ w a
sebi	s e b i
sebje	s e bʲ e
sebjewědome	s e bʲ e w ɪ d o m e
sebjewědomju	s e bʲ e w ɪ d o mʲ u
sedmy	s e d m ɨ
sedźała	s e dʒ a w a
sej	s e j
sejm	s e j m
sejma	s e j m a
sejmarja	s e j m a ʀʲ a
sejmej	s e j m e j
sejmik	s e j m i k
sekcije	s e k ts i j e
sekretariat	s e k ʀ e t a ʀ i a t
sekretariata	s e k ʀ e t a ʀ i a t a
sem	s e m
seminar	s e m i n a ʀ
seniorow	s e n i o ʀ o w
sensibelne	s e n s i b e l n e
sensibilizaciju	s e n s i b i l i z a ts i j u
septembra	s e p t e m b ʀ a
serb	s e ʀ b
serba	s e ʀ b a
serbach	s e ʀ b a x
serbam	s e ʀ b a m
serbami	s e ʀ b a m i
serbja	s e ʀ bʲ a
serbow	s e ʀ b o w
serbsce	s e ʀ b s ts e
serbscy	s e ʀ b s ts ɨ
serbska	s e ʀ b s k a
serbske	s e ʀ b s k e
serbskeho	s e ʀ b s k e h o
serbskej	s e ʀ b s k e j
serbskeje	s e ʀ b s k e j e
serbskeju	s e ʀ b s k e j u
serbskemu	s e ʀ b s k e m u
serbski	s e ʀ b s k i
serbskich	s e ʀ b s k i x
serbskim	s e ʀ b s k i m
serbskimi	s e ʀ b s k i m i
serbsko-němsku	s e ʀ b s k o n ɪ m s k u
serbskosć	s e ʀ b s k o s tʃ
serbsku	s e ʀ b s k u
serbstwa	s e ʀ b s t w a
serbstwo	s e ʀ b s t w o
serbuja	s e ʀ b u j a
serbšćina	s e ʀ b ʃ tʃ i n a
serbšćinje	s e ʀ b ʃ tʃ i nʲ e
serbšćinu	s e ʀ b ʃ tʃ i n u
serbšćiny	s e ʀ b ʃ tʃ i n ɨ
serwisowy	s e ʀ w i s o w ɨ
sewjernym	s e wʲ e ʀ n ɨ m
sezonje	s e z o nʲ e
sezony	s e z o n ɨ
showowy	s h o w o w ɨ
sintow	s i n t o w
sirin	s i ʀ i n
situacija	s i t u a ts i j a
situacije	s i t u a ts i j e
situaciju	s i t u a ts i j u
skazanka	s k a z a n k a
skazanki	s k a z a n k i
skazanskeho	s k a z a n s k e h o
skazać	s k a z a tʃ
skedźbni	s k e dʒ b n i
skedźbnja	s k e dʒ b nʲ a
skedźnosć	s k e dʒ n o s tʃ
skerje	s k e ʀʲ e
skića	s k i tʃ a
skići	s k i tʃ i
skonstituowana	s k o n s t i t u o w a n a
skopčka	s k o p tʃ k a
skoro	s k o ʀ o
skoržiće	s k o ʀ ʒ i tʃ e
skoržićelej	s k o ʀ ʒ i tʃ e l e j
skoržił	s k o ʀ ʒ i w
skoržiłoj	s k o ʀ ʒ i w o j
skruća	s k ʀ u tʃ a
skrućenja	s k ʀ u tʃ e nʲ a
skrućenju	s k ʀ u tʃ e nʲ u
skrućić	s k ʀ u tʃ i tʃ
skulojćiło	s k u l o j tʃ i w o
skulptury	s k u l p t u ʀ ɨ
skupin	s k u p i n
skupina	s k u p i n a
skupinach	s k u p i n a x
skupinje	s k u p i nʲ e
skupinku	s k u p i n k u
skupinomaj	s k u p i n o m a j
skupinow	s k u p i n o w
skupinu	s k u p i n u
skupiny	s k u p i n ɨ
skutkowanja	s k u t k o w a nʲ a
skutkowanje	s k u t k o w a nʲ e
skutkowanju	s k u t k o w a nʲ u
skutkować	s k u t k o w a tʃ
skutkowała	s k u t k o w a w a
skutkowaše	s k u t k o w a ʃ e
skutkowne	s k u t k o w n e
skutkowni	s k u t k o w n i
skutkuje	s k u t k u j e
skóncowali	s k ʊ n ts o w a l i
skóncował	s k ʊ n ts o w a w
skónčenja	s k ʊ n tʃ e nʲ a
skónčenju	s k ʊ n tʃ e nʲ u
skónčnje	s k ʊ n tʃ nʲ e
skóržbu	s k ʊ ʀ ʒ b u
składnosć	s k w a d n o s tʃ
składowachu	s k w a d o w a x u
składuja	s k w a d u j a
slepjanskeho	s l e pʲ a n s k e h o
slepjanskeje	s l e pʲ a n s k e j e
slepjanšćina	s l e pʲ a n ʃ tʃ i n a
slepoho	s l e p o h o
slepom	s l e p o m
slubjenja	s l u bʲ e nʲ a
slědowace	s l ɪ d o w a ts e
slědować	s l ɪ d o w a tʃ
slědy	s l ɪ d ɨ
slědźenišća	s l ɪ dʒ e n i ʃ tʃ a
slědźenski	s l ɪ dʒ e n s k i
smaleše	s m a l e ʃ e
smartphonach	s m a ʀ t p h o n a x
smjerd	s mʲ e ʀ d
smjertny	s mʲ e ʀ t n ɨ
smjerće	s mʲ e ʀ tʃ e
smjerći	s mʲ e ʀ tʃ i
smy	s m ɨ
smój	s m ʊ j
smě	s m ɪ
smědźa	s m ɪ dʒ a
smějo	s m ɪ j o
směmy	s m ɪ m ɨ
směrje	s m ɪ ʀʲ e
směrnicach	s m ɪ ʀ n i ts a x
směrnicu	s m ɪ ʀ n i ts u
směrowe	s m ɪ ʀ o w e
směć	s m ɪ tʃ
snadź	s n a dʒ
snano	s n a n o
sněh	s n ɪ h
so	s o
sobotu	s o b o t u
soboty	s o b o t ɨ
sobu	s o b u
sobu-	s o b u
sobudźěłaćerjo	s o b u dʒ ɪ w a tʃ e ʀʲ o
sobudźěłaćerjow	s o b u dʒ ɪ w a tʃ e ʀʲ o w
sobudźěło	s o b u dʒ ɪ w o
sobujatym	s o b u j a t ɨ m
sobupostajenja	s o b u p o s t a j e nʲ a
sobupostajowanje	s o b u p o s t a j o w a nʲ e
sobuskutkowanje	s o b u s k u t k o w a nʲ e
sobustawskej	s o b u s t a w s k e j
sobustawskich	s o b u s t a w s k i x
sobuwzaći	s o b u w z a tʃ i
socializma	s o ts i a l i z m a
socialne	s o ts i a l n e
socialnje	s o ts i a l nʲ e
socialnu	s o ts i a l n u
sokoł	s o k o w
solo-gitarist	s o l o ɡ i t a ʀ i s t
sonach	s o n a x
sonděrowanske	s o n d ɪ ʀ o w a n s k e
sonděrowanskich	s o n d ɪ ʀ o w a n s k i x
sotře	s o tʃ e
sowjo	s o wʲ o
spagat	s p a ɡ a t
spakowane	s p a k o w a n e
specielnje	s p e ts i e l nʲ e
spektrum	s p e k t ʀ u m
spi	s p i
spis	s p i s
spisa	s p i s a
spisach	s p i s a x
spisowaćel	s p i s o w a tʃ e l
spisowaćelej	s p i s o w a tʃ e l e j
spjelnili	s pʲ e l n i l i
spjelnić	s pʲ e l n i tʃ
spjelnjenje	s pʲ e l nʲ e nʲ e
spjelnjenju	s pʲ e l nʲ e nʲ u
spjećowanskeho	s pʲ e tʃ o w a n s k e h o
spjećujmy	s pʲ e tʃ u j m ɨ
spodźiwnymi	s p o dʒ i w n ɨ m i
spomjatkuje	s p o mʲ a t k u j e
spomóžne	s p o m ʊ ʒ n e
spontany	s p o n t a n ɨ
sport	s p o ʀ t
sporta	s p o ʀ t a
sportnišćo	s p o ʀ t n i ʃ tʃ o
sportowanje	s p o ʀ t o w a nʲ e
sportowni	s p o ʀ t o w n i
sportownja	s p o ʀ t o w nʲ a
spowšitkownjace	s p o w ʃ i t k o w nʲ a ts e
spočatk	s p o tʃ a t k
spočatka	s p o tʃ a t k a
społnomócnjeneho	s p o w n o m ʊ ts nʲ e n e h o
społnomócnjeny	s p o w n o m ʊ ts nʲ e n ɨ
spožči	s p o ʒ tʃ i
spožčić	s p o ʒ tʃ i tʃ
sprawnosć	s p ʀ a w n o s tʃ
sprjewine	s p ʀʲ e w i n e
sprjewja	s p ʀʲ e wʲ a
sprjewje	s p ʀʲ e wʲ e
spušćomne	s p u ʃ tʃ o m n e
spušćomnym	s p u ʃ tʃ o m n ɨ m
spytajće	s p ɨ t a j tʃ e
spytaše	s p ɨ t a ʃ e
spózna	s p ʊ z n a
spóznaješ	s p ʊ z n a j e ʃ
spóznać	s p ʊ z n a tʃ
spěchowace	s p ɪ x o w a ts e
spěchowanja	s p ɪ x o w a nʲ a
spěchowanje	s p ɪ x o w a nʲ e
spěchowanju	s p ɪ x o w a nʲ u
spěchowanskeho	s p ɪ x o w a n s k e h o
spěchować	s p ɪ x o w a tʃ
spěchuja	s p ɪ x u j a
spěchuje	s p ɪ x u j e
spěchujemy	s p ɪ x u j e m ɨ
spěw	s p ɪ w
spěwa	s p ɪ w a
spěwajo	s p ɪ w a j o
spěwam	s p ɪ w a m
spěwarjow	s p ɪ w a ʀʲ o w
spěwarkow	s p ɪ w a ʀ k o w
spěwarske	s p ɪ w a ʀ s k e
spěwać	s p ɪ w a tʃ
spěwow	s p ɪ w o w
spěwy	s p ɪ w ɨ
spěšnje	s p ɪ ʃ nʲ e
spěšnu	s p ɪ ʃ n u
spřistupnić	s p ʃ i s t u p n i tʃ
srjedu	s ʀʲ e d u
srjedźenej	s ʀʲ e dʒ e n e j
srjedźisću	s ʀʲ e dʒ i s tʃ u
srjedźišću	s ʀʲ e dʒ i ʃ tʃ u
srjedźne	s ʀʲ e dʒ n e
srjedźnej	s ʀʲ e dʒ n e j
srjedźołužiskeje	s ʀʲ e dʒ o w u ʒ i s k e j e
sroku	s ʀ o k u
srěbał	s ʀ ɪ b a w
srědk	s ʀ ɪ d k
srědki	s ʀ ɪ d k i
srědkow	s ʀ ɪ d k o w
stabilitu	s t a b i l i t u
stabilizuja	s t a b i l i z u j a
stabilne	s t a b i l n e
stadiona	s t a d i o n a
stadionej	s t a d i o n e j
staj	s t a j
stajach	s t a j a x
staji	s t a j i
stajichu	s t a j i x u
stajitej	s t a j i t e j
stajiwši	s t a j i w ʃ i
stajił	s t a j i w
stajiła	s t a j i w a
stajna	s t a j n a
stajne	s t a j n e
stajnje	s t a j nʲ e
stan	s t a n
stanje	s t a nʲ e
stanyć	s t a n ɨ tʃ
stanył	s t a n ɨ w
stara	s t a ʀ a
staramy	s t a ʀ a m ɨ
starać	s t a ʀ a tʃ
starałoj	s t a ʀ a w o j
stare	s t a ʀ e
stareho	s t a ʀ e h o
starej	s t a ʀ e j
starobje	s t a ʀ o bʲ e
starobu	s t a ʀ o b u
staroserbskich	s t a ʀ o s e ʀ b s k i x
starosće	s t a ʀ o s tʃ e
starosćow	s t a ʀ o s tʃ o w
startuj	s t a ʀ t u j
staru	s t a ʀ u
starych	s t a ʀ ɨ x
starym	s t a ʀ ɨ m
staršeju	s t a ʀ ʃ e j u
starši	s t a ʀ ʃ i
staršich	s t a ʀ ʃ i x
staršim	s t a ʀ ʃ i m
staršisku	s t a ʀ ʃ i s k u
stasiakty	s t a s i a k t ɨ
stat	s t a t
statistice	s t a t i s t i ts e
statne	s t a t n e
statneho	s t a t n e h o
statneje	s t a t n e j e
statnik	s t a t n i k
statnika	s t a t n i k a
statnu	s t a t n u
statok	s t a t o k
statoka	s t a t o k a
statoku	s t a t o k u
status	s t a t u s
statusa	s t a t u s a
statusowy	s t a t u s o w ɨ
statysacy	s t a t ɨ s a ts ɨ
stawiznach	s t a w i z n a x
stawiznam	s t a w i z n a m
stawiznami	s t a w i z n a m i
stawiznow	s t a w i z n o w
stawizny	s t a w i z n ɨ
stać	s t a tʃ
staće	s t a tʃ e
stało	s t a w o
stańće	s t a nʲ tʃ e
stej	s t e j
steja	s t e j a
stejachu	s t e j a x u
stejacu	s t e j a ts u
steješe	s t e j e ʃ e
steji	s t e j i
stejimy	s t e j i m ɨ
stejitaj	s t e j i t a j
stejiće	s t e j i tʃ e
stejišćo	s t e j i ʃ tʃ o
stejnišćo	s t e j n i ʃ tʃ o
stejo	s t e j o
stephan	s t e p h a n
stil	s t i l
sto	s t o
stolicy	s t o l i ts ɨ
stone	s t o n e
stopnjowanja	s t o p nʲ o w a nʲ a
stołp	s t o w p
strach	s t ʀ a x
strachow	s t ʀ a x o w
strachoćiwje	s t ʀ a x o tʃ i wʲ e
strakojc-nawka	s t ʀ a k o j ts n a w k a
strategije	s t ʀ a t e ɡ i j e
stron	s t ʀ o n
strona	s t ʀ o n a
stronje	s t ʀ o nʲ e
stronu	s t ʀ o n u
strony	s t ʀ o n ɨ
strowić	s t ʀ o w i tʃ
strowotniski	s t ʀ o w o t n i s k i
strowotu	s t ʀ o w o t u
strukturna	s t ʀ u k t u ʀ n a
strukturne	s t ʀ u k t u ʀ n e
strukturneje	s t ʀ u k t u ʀ n e j e
strukturnu	s t ʀ u k t u ʀ n u
strukturnych	s t ʀ u k t u ʀ n ɨ x
strukturow	s t ʀ u k t u ʀ o w
stróži	s t ʀ ʊ ʒ i
studentami	s t u d e n t a m i
studij	s t u d i j
studija	s t u d i j a
studnjemi	s t u d nʲ e m i
studowacych	s t u d o w a ts ɨ x
studowansku	s t u d o w a n s k u
stukturnosłabe	s t u k t u ʀ n o s w a b e
stupa	s t u p a
stupali	s t u p a l i
stupi	s t u p i
stwičku	s t w i tʃ k u
stwjelca	s t wʲ e l ts a
stwjelčko	s t wʲ e l tʃ k o
stworić	s t w o ʀ i tʃ
stwu	s t w u
stwě	s t w ɪ
styki	s t ɨ k i
střase	s tʃ a s e
su	s u
suchoty	s u x o t ɨ
sudniske	s u d n i s k e
sudniskeho	s u d n i s k e h o
sudnistwje	s u d n i s t wʲ e
sudnistwo	s u d n i s t w o
sudnym	s u d n ɨ m
suknjach	s u k nʲ a x
suma	s u m a
sumow	s u m o w
super	s u p e ʀ
susodka	s u s o d k a
susodne	s u s o d n e
susodźic	s u s o dʒ i ts
swinjo	s w i nʲ o
swjateho	s wʲ a t e h o
swjatemu	s wʲ a t e m u
swjatkowne	s wʲ a t k o w n e
swjatnišćo	s wʲ a t n i ʃ tʃ o
swjaty	s wʲ a t ɨ
swjatym	s wʲ a t ɨ m
swjedźenje	s wʲ e dʒ e nʲ e
swjedźenjow	s wʲ e dʒ e nʲ o w
swjedźenske	s wʲ e dʒ e n s k e
swjedźeń	s wʲ e dʒ e nʲ
swjećachu	s wʲ e tʃ a x u
swjećeše	s wʲ e tʃ e ʃ e
swjećiła	s wʲ e tʃ i w a
swobodnemu	s w o b o d n e m u
swobodnje	s w o b o d nʲ e
swobodny	s w o b o d n ɨ
swobodnym	s w o b o d n ɨ m
swobody	s w o b o d ɨ
swoje	s w o j e
swojeho	s w o j e h o
swojej	s w o j e j
swojeje	s w o j e j e
swojemu	s w o j e m u
swojich	s w o j i x
swojim	s w o j i m
swojimi	s w o j i m i
swoju	s w o j u
swój	s w ʊ j
swójba	s w ʊ j b a
swójbna	s w ʊ j b n a
swójbne	s w ʊ j b n e
swójbneho	s w ʊ j b n e h o
swójbow	s w ʊ j b o w
swójbu	s w ʊ j b u
swójby	s w ʊ j b ɨ
swójske	s w ʊ j s k e
swójskeho	s w ʊ j s k e h o
swójskej	s w ʊ j s k e j
swójskeje	s w ʊ j s k e j e
swójski	s w ʊ j s k i
swójskich	s w ʊ j s k i x
swójskim	s w ʊ j s k i m
swójskimi	s w ʊ j s k i m i
swět	s w ɪ t
swěta	s w ɪ t a
swětadalokej	s w ɪ t a d a l o k e j
swětow	s w ɪ t o w
swětoweho	s w ɪ t o w e h o
swětoweje	s w ɪ t o w e j e
swětowu	s w ɪ t o w u
swětło	s w ɪ t w o
swětłownja	s w ɪ t w o w nʲ a
swěći	s w ɪ tʃ i
swěčnik	s w ɪ tʃ n i k
sy	s ɨ
sydlenskeho	s ɨ d l e n s k e h o
sydlenski	s ɨ d l e n s k i
sydlenskim	s ɨ d l e n s k i m
sydlišća	s ɨ d l i ʃ tʃ a
sydlišćo	s ɨ d l i ʃ tʃ o
sydny	s ɨ d n ɨ
sydom	s ɨ d o m
sydło	s ɨ d w o
sylne	s ɨ l n e
sylnić	s ɨ l n i tʃ
sylnišo	s ɨ l n i ʃ o
sylnje	s ɨ l nʲ e
sylny	s ɨ l n ɨ
sylzy	s ɨ l z ɨ
sym	s ɨ m
symbioza	s ɨ m b i o z a
symbol	s ɨ m b o l
symboliske	s ɨ m b o l i s k e
sympatiski	s ɨ m p a t i s k i
syn	s ɨ n
syna	s ɨ n a
synej	s ɨ n e j
synergije	s ɨ n e ʀ ɡ i j e
syntetizować	s ɨ n t e t i z o w a tʃ
system	s ɨ s t e m
syć	s ɨ tʃ
syće	s ɨ tʃ e
syći	s ɨ tʃ i
sće	s tʃ e
sćenja	s tʃ e nʲ a
sćenju	s tʃ e nʲ u
sćěhi	s tʃ ɪ h i
sćěhowace	s tʃ ɪ h o w a ts e
sćěhował	s tʃ ɪ h o w a w
sćěhowała	s tʃ ɪ h o w a w a
sćěhowało	s tʃ ɪ h o w a w o
sćěhuj	s tʃ ɪ h u j
sčasom	s tʃ a s o m
słabšich	s w a b ʃ i x
sławny	s w a w n ɨ
sławnych	s w a w n ɨ x
słodej	s w o d e j
słodźa	s w o dʒ a
słodźi	s w o dʒ i
słomy	s w o m ɨ
słowa	s w o w a
słowach	s w o w a x
słowaksku	s w o w a k s k u
słowami	s w o w a m i
słowjanskeho	s w o wʲ a n s k e h o
słowjanskej	s w o wʲ a n s k e j
słowje	s w o wʲ e
słowjency	s w o wʲ e n ts ɨ
słowjenjo	s w o wʲ e nʲ o
słownik	s w o w n i k
słownikami	s w o w n i k a m i
słuchatka	s w u x a t k a
słuchać	s w u x a tʃ
słuchał	s w u x a w
słuchała	s w u x a w a
słuša	s w u ʃ a
słušatej	s w u ʃ a t e j
słušeja	s w u ʃ e j a
słušeštej	s w u ʃ e ʃ t e j
słužbje	s w u ʒ bʲ e
słuži	s w u ʒ i
słužić	s w u ʒ i tʃ
słužobnu	s w u ʒ o b n u
słyšała	s w ɨ ʃ a w a
słyšeli	s w ɨ ʃ e l i
słyšeć	s w ɨ ʃ e tʃ
słyšeše	s w ɨ ʃ e ʃ e
słyšiš	s w ɨ ʃ i ʃ
słód	s w ʊ d
słódkosćow	s w ʊ d k o s tʃ o w
słónca	s w ʊ n ts a
słónco	s w ʊ n ts o
słónčko	s w ʊ n tʃ k o
słónčnymi	s w ʊ n tʃ n ɨ m i
tachantska	t a x a n ts k a
tachantskim	t a x a n ts k i m
tafle	t a f l e
taflu	t a f l u
tajke	t a j k e
tajkeje	t a j k e j e
tajki	t a j k i
tajkich	t a j k i x
tajku	t a j k u
tak	t a k
takle	t a k l e
takrjec	t a k ʀʲ e ts
tale	t a l e
tam	t a m
tamniša	t a m n i ʃ a
tamny	t a m n ɨ
tamnych	t a m n ɨ x
tarifow	t a ʀ i f o w
te	t e
tebje	t e bʲ e
technika	t e x n i k a
technikar	t e x n i k a ʀ
techniku	t e x n i k u
techniskim	t e x n i s k i m
tehdom	t e h d o m
tehdy	t e h d ɨ
tehdyša	t e h d ɨ ʃ a
tehdyšich	t e h d ɨ ʃ i x
tele	t e l e
telewizijneho	t e l e w i z i j n e h o
telko	t e l k o
tema	t e m a
tematiku	t e m a t i k u
tematizuje	t e m a t i z u j e
temje	t e mʲ e
temu	t e m u
tendenca	t e n d e n ts a
teologije	t e o l o ɡ i j e
tepjeneje	t e pʲ e n e j e
terenje	t e ʀ e nʲ e
termin	t e ʀ m i n
test	t e s t
testowy	t e s t o w ɨ
tesće	t e s tʃ e
tež	t e ʒ
titulom	t i t u l o m
to	t o
tobole	t o b o l e
tobołku	t o b o w k u
tobołu	t o b o w u
toflach	t o f l a x
toho	t o h o
tohodla	t o h o d l a
tohorunja	t o h o ʀ u nʲ a
tola	t o l a
tole	t o l e
tomaš	t o m a ʃ
tomaša	t o m a ʃ a
tomu	t o m u
tomule	t o m u l e
tonu	t o n u
tony	t o n ɨ
torhošću	t o ʀ h o ʃ tʃ u
towarstwa	t o w a ʀ s t w a
towarstwami	t o w a ʀ s t w a m i
towarstwo	t o w a ʀ s t w o
towarstwow	t o w a ʀ s t w o w
towarstwowy	t o w a ʀ s t w o w ɨ
towaršliwosć	t o w a ʀ ʃ l i w o s tʃ
towaršnostne	t o w a ʀ ʃ n o s t n e
towaršnostneho	t o w a ʀ ʃ n o s t n e h o
towaršnostnych	t o w a ʀ ʃ n o s t n ɨ x
towaršnosće	t o w a ʀ ʃ n o s tʃ e
towaršnosći	t o w a ʀ ʃ n o s tʃ i
tołsta	t o w s t a
tošu	t o ʃ u
trabijow	t ʀ a b i j o w
trada	t ʀ a d a
tradicije	t ʀ a d i ts i j e
tradicijow	t ʀ a d i ts i j o w
tradiciju	t ʀ a d i ts i j u
trajace	t ʀ a j a ts e
trajne	t ʀ a j n e
trajnje	t ʀ a j nʲ e
transparentny	t ʀ a n s p a ʀ e n t n ɨ
transport	t ʀ a n s p o ʀ t
transportabelna	t ʀ a n s p o ʀ t a b e l n a
transportuje	t ʀ a n s p o ʀ t u j e
trasy	t ʀ a s ɨ
trawmatizaciju	t ʀ a w m a t i z a ts i j u
trawy	t ʀ a w ɨ
trać	t ʀ a tʃ
trjeba	t ʀʲ e b a
trjebachu	t ʀʲ e b a x u
trjebam	t ʀʲ e b a m
trjebamy	t ʀʲ e b a m ɨ
trjebaš	t ʀʲ e b a ʃ
trjebinski	t ʀʲ e b i n s k i
trjebjeńcy	t ʀʲ e bʲ e nʲ ts ɨ
trjenja	t ʀʲ e nʲ a
trochu	t ʀ o x u
troski	t ʀ o s k i
trudla	t ʀ u d l a
tróšku	t ʀ ʊ ʃ k u
tróštuja	t ʀ ʊ ʃ t u j a
trěbne	t ʀ ɪ b n e
trěbnu	t ʀ ɪ b n u
trěbny	t ʀ ɪ b n ɨ
trěbnych	t ʀ ɪ b n ɨ x
tu	t u
tu-	t u
tuchwilne	t u x w i l n e
tuchwilnja	t u x w i l nʲ a
tuchwilu	t u x w i l u
tudy	t u d ɨ
tukawy	t u k a w ɨ
tule	t u l e
turistami	t u ʀ i s t a m i
turistiske	t u ʀ i s t i s k e
turisća	t u ʀ i s tʃ a
turizm	t u ʀ i z m
turizma	t u ʀ i z m a
tuta	t u t a
tute	t u t e
tutej	t u t e j
tuteje	t u t e j e
tutoho	t u t o h o
tutomu	t u t o m u
tutu	t u t u
tutych	t u t ɨ x
tutym	t u t ɨ m
tutón	t u t ʊ n
tući	t u tʃ i
tuž	t u ʒ
twar	t w a ʀ
twarjenje	t w a ʀʲ e nʲ e
twarjenjow	t w a ʀʲ e nʲ o w
twarske	t w a ʀ s k e
twarski	t w a ʀ s k i
twarskich	t w a ʀ s k i x
twjerdźiznu	t wʲ e ʀ dʒ i z n u
twjerdźizny	t wʲ e ʀ dʒ i z n ɨ
twoja	t w o j a
twoje	t w o j e
twojeho	t w o j e h o
twojej	t w o j e j
twoju	t w o j u
twori	t w o ʀ i
tworili	t w o ʀ i l i
tworja	t w o ʀʲ a
tworjenja	t w o ʀʲ e nʲ a
tworjenje	t w o ʀʲ e nʲ e
tworjenju	t w o ʀʲ e nʲ u
tworješe	t w o ʀʲ e ʃ e
twornju	t w o ʀ nʲ u
twory	t w o ʀ ɨ
twórbu	t w ʊ ʀ b u
twórby	t w ʊ ʀ b ɨ
ty	t ɨ
tych	t ɨ x
tydźenja	t ɨ dʒ e nʲ a
tydźenje	t ɨ dʒ e nʲ e
tydźenjej	t ɨ dʒ e nʲ e j
tydźenjow	t ɨ dʒ e nʲ o w
tydźenskeje	t ɨ dʒ e n s k e j e
tydźeń	t ɨ dʒ e nʲ
tyfus	t ɨ f u s
tykń	t ɨ k nʲ
tym	t ɨ m
typami	t ɨ p a m i
tysac	t ɨ s a ts
tyzki	t ɨ z k i
tójšto	t ʊ j ʃ t o
tón	t ʊ n
tónle	t ʊ n l e
tónraz	t ʊ n ʀ a z
tči	t tʃ i
třepotajo	tʃ e p o t a j o
třeći	tʃ e tʃ i
tři	tʃ i
třo	tʃ o
třoch	tʃ o x
třěchi	tʃ ɪ x i
třěšna	tʃ ɪ ʃ n a
třěšneho	tʃ ɪ ʃ n e h o
uniforměrowanje	u n i f o ʀ m ɪ ʀ o w a nʲ e
unija	u n i j a
uniwersita	u n i w e ʀ s i t a
uniwersity	u n i w e ʀ s i t ɨ
uniwersiće	u n i w e ʀ s i tʃ e
w	w
wabić	w a b i tʃ
wabja	w a bʲ a
wabjenja	w a bʲ e nʲ a
waju	w a j u
waliziskej	w a l i z i s k e j
walizišćina	w a l i z i ʃ tʃ i n a
wam	w a m
wamaj	w a m a j
wariacije	w a ʀ i a ts i j e
warić	w a ʀ i tʃ
warješe	w a ʀʲ e ʃ e
waršawy	w a ʀ ʃ a w ɨ
was	w a s
wačoka	w a tʃ o k a
waše	w a ʃ e
wašeje	w a ʃ e j e
wašemu	w a ʃ e m u
waši	w a ʃ i
wašnje	w a ʃ nʲ e
wašnjom	w a ʃ nʲ o m
wašu	w a ʃ u
wažna	w a ʒ n a
wažne	w a ʒ n e
wažnej	w a ʒ n e j
wažnemu	w a ʒ n e m u
wažni	w a ʒ n i
wažnosć	w a ʒ n o s tʃ
wažny	w a ʒ n ɨ
wažnych	w a ʒ n ɨ x
wažnymi	w a ʒ n ɨ m i
we	w e
web	w e b
web-strony	w e b s t ʀ o n ɨ
werner	w e ʀ n e ʀ
wersiju	w e ʀ s i j u
wida	w i d a
wide	w i d e
widejowe	w i d e j o w e
widom	w i d o m
widźach	w i dʒ a x
widźała	w i dʒ a w a
widźałoj	w i dʒ a w o j
widźeć	w i dʒ e tʃ
widźeše	w i dʒ e ʃ e
widźeštaj	w i dʒ e ʃ t a j
widźi	w i dʒ i
widźiš	w i dʒ i ʃ
wikach	w i k a x
wino	w i n o
winowata	w i n o w a t a
winowatosć	w i n o w a t o s tʃ
wirtha	w i ʀ t h a
witaj-projekt	w i t a j p ʀ o j e k t
witani	w i t a n i
witatej	w i t a t e j
witać	w i t a tʃ
wizije	w i z i j e
wjac	wʲ a ts
wjace	wʲ a ts e
wjacerěčnosć	wʲ a ts e ʀ ɪ tʃ n o s tʃ
wjacorych	wʲ a ts o ʀ ɨ x
wjacorym	wʲ a ts o ʀ ɨ m
wjedli	wʲ e d l i
wjednicy	wʲ e d n i ts ɨ
wjednika	wʲ e d n i k a
wjednikow	wʲ e d n i k o w
wjednistwa	wʲ e d n i s t w a
wjednistwo	wʲ e d n i s t w o
wjedrje	wʲ e d ʀʲ e
wjedu	wʲ e d u
wjedźene	wʲ e dʒ e n e
wjedźenje	wʲ e dʒ e nʲ e
wjele	wʲ e l e
wjelk	wʲ e l k
wjelki	wʲ e l k i
wjerbnje	wʲ e ʀ b nʲ e
wjerška	wʲ e ʀ ʃ k a
wjerški	wʲ e ʀ ʃ k i
wjeršku	wʲ e ʀ ʃ k u
wjesce	wʲ e s ts e
wjesele	wʲ e s e l e
wjeseleše	wʲ e s e l e ʃ e
wjeseli	wʲ e s e l i
wjeselili	wʲ e s e l i l i
wjeseliće	wʲ e s e l i tʃ e
wjeselił	wʲ e s e l i w
wjeselo	wʲ e s e l o
wjeselom	wʲ e s e l o m
wjeselu	wʲ e s e l u
wjeska	wʲ e s k a
wjeski	wʲ e s k i
wjesne	wʲ e s n e
wjesnej	wʲ e s n e j
wjesnjanosta	wʲ e s nʲ a n o s t a
wjesnjanosty	wʲ e s nʲ a n o s t ɨ
wjesny	wʲ e s n ɨ
wjesnych	wʲ e s n ɨ x
wjesnym	wʲ e s n ɨ m
wjesoły	wʲ e s o w ɨ
wjesć	wʲ e s tʃ
wjetša	wʲ e tʃ a
wjetše	wʲ e tʃ e
wjetši	wʲ e tʃ i
wjetšich	wʲ e tʃ i x
wjetšina	wʲ e tʃ i n a
wječor	wʲ e tʃ o ʀ
wječoru	wʲ e tʃ o ʀ u
wnučki	w n u tʃ k i
wo	w o
wob	w o b
wobaj	w o b a j
wobaraja	w o b a ʀ a j a
wobchad	w o b x a d
wobchadneje	w o b x a d n e j e
wobchadźe	w o b x a dʒ e
wobchadźemy	w o b x a dʒ e m ɨ
wobchodźe	w o b x o dʒ e
wobchodźomnu	w o b x o dʒ o m n u
wobchowa	w o b x o w a
wobdateje	w o b d a t e j e
wobdźěleni	w o b dʒ ɪ l e n i
wobdźělenje	w o b dʒ ɪ l e nʲ e
wobdźělenych	w o b dʒ ɪ l e n ɨ x
wobdźěleše	w o b dʒ ɪ l e ʃ e
wobdźělili	w o b dʒ ɪ l i l i
wobdźělić	w o b dʒ ɪ l i tʃ
wobdźělił	w o b dʒ ɪ l i w
wobdźělnicy	w o b dʒ ɪ l n i ts ɨ
wobdźělnikami	w o b dʒ ɪ l n i k a m i
wobdźělnikow	w o b dʒ ɪ l n i k o w
wobeju	w o b e j u
wobfrinkoleše	w o b f ʀ i n k o l e ʃ e
wobhladać	w o b h l a d a tʃ
wobhladuja	w o b h l a d u j a
wobhonjeja	w o b h o nʲ e j a
wobhospodarja	w o b h o s p o d a ʀʲ a
wobhospodarjenja	w o b h o s p o d a ʀʲ e nʲ a
wobhospodarjenje	w o b h o s p o d a ʀʲ e nʲ e
wobjed	w o bʲ e d
wobjednachu	w o bʲ e d n a x u
wobjedu	w o bʲ e d u
wobkedźbowachu	w o b k e dʒ b o w a x u
wobkedźbować	w o b k e dʒ b o w a tʃ
wobkedźbował	w o b k e dʒ b o w a w
wobkedźbuje	w o b k e dʒ b u j e
wobkedźbujemy	w o b k e dʒ b u j e m ɨ
wobknježenje	w o b k nʲ e ʒ e nʲ e
wobkrućenjom	w o b k ʀ u tʃ e nʲ o m
wobkuzłać	w o b k u z w a tʃ
wobličena	w o b l i tʃ e n a
woblubowaniša	w o b l u b o w a n i ʃ a
woblubowany	w o b l u b o w a n ɨ
woblěhowaneje	w o b l ɪ h o w a n e j e
woblěhuja	w o b l ɪ h u j a
wobmjezowanej	w o b mʲ e z o w a n e j
wobnowjena	w o b n o wʲ e n a
wobnowjenja	w o b n o wʲ e nʲ a
wobohaćeja	w o b o h a tʃ e j a
wobornik	w o b o ʀ n i k
wobornikam	w o b o ʀ n i k a m
wobory	w o b o ʀ ɨ
wobraz	w o b ʀ a z
wobrazow	w o b ʀ a z o w
wobrazu	w o b ʀ a z u
wobrazy	w o b ʀ a z ɨ
wobroćili	w o b ʀ o tʃ i l i
wobsadźi	w o b s a dʒ i
wobsah	w o b s a h
wobsahow	w o b s a h o w
wobsahowje	w o b s a h o wʲ e
wobsahu	w o b s a h u
wobsahuje	w o b s a h u j e
wobstarać	w o b s t a ʀ a tʃ
wobstatk	w o b s t a t k
wobstatki	w o b s t a t k i
wobstatkom	w o b s t a t k o m
wobsteja	w o b s t e j a
wobstejace	w o b s t e j a ts e
wobsteješe	w o b s t e j e ʃ e
wobsteji	w o b s t e j i
wobstejnosćow	w o b s t e j n o s tʃ o w
wobswědča	w o b s w ɪ d tʃ a
wobswět	w o b s w ɪ t
wobswětlene	w o b s w ɪ t l e n e
wobswětowej	w o b s w ɪ t o w e j
wobswětowych	w o b s w ɪ t o w ɨ x
wobswětowym	w o b s w ɪ t o w ɨ m
wobswěće	w o b s w ɪ tʃ e
wobuwamy	w o b u w a m ɨ
wobydlerjam	w o b ɨ d l e ʀʲ a m
wobydlerjemi	w o b ɨ d l e ʀʲ e m i
wobydlerjo	w o b ɨ d l e ʀʲ o
wobydlerjow	w o b ɨ d l e ʀʲ o w
wobydlerskeho	w o b ɨ d l e ʀ s k e h o
wobydlerstwa	w o b ɨ d l e ʀ s t w a
wobzamknjenja	w o b z a m k nʲ e nʲ a
wobzamknjenjam	w o b z a m k nʲ e nʲ a m
wobzamknjenjemi	w o b z a m k nʲ e nʲ e m i
wobzamknjenjom	w o b z a m k nʲ e nʲ o m
wobzamknjenjow	w o b z a m k nʲ e nʲ o w
wobzamknył	w o b z a m k n ɨ w
wobzamknyła	w o b z a m k n ɨ w a
wobzoru	w o b z o ʀ u
wobćežne	w o b tʃ e ʒ n e
wobě	w o b ɪ
woběmaj	w o b ɪ m a j
wobłuka	w o b w u k a
wobłuki	w o b w u k i
wobškodźene	w o b ʃ k o dʒ e n e
wobšěrna	w o b ʃ ɪ ʀ n a
wobžarował	w o b ʒ a ʀ o w a w
wochłódnić	w o x w ʊ d n i tʃ
woda	w o d a
wodnjo	w o d nʲ o
wodowych	w o d o w ɨ x
wodu	w o d u
wody	w o d ɨ
wodźacy	w o dʒ a ts ɨ
wodźenja	w o dʒ e nʲ a
wohenjow	w o h e nʲ o w
woheń	w o h e nʲ
wohnjoweje	w o h nʲ o w e j e
wohnjowy	w o h nʲ o w ɨ
wohnjowym	w o h nʲ o w ɨ m
wohnjoškita	w o h nʲ o ʃ k i t a
wohrožamy	w o h ʀ o ʒ a m ɨ
wohrožena	w o h ʀ o ʒ e n a
wohroženych	w o h ʀ o ʒ e n ɨ x
wojacy	w o j a ts ɨ
wojerec	w o j e ʀ e ts
wojerecach	w o j e ʀ e ts a x
wojerecy-wjelcej	w o j e ʀ e ts ɨ wʲ e l ts e j
wojowanja	w o j o w a nʲ a
wojował	w o j o w a w
wokolinje	w o k o l i nʲ e
wokoliny	w o k o l i n ɨ
wokolnu	w o k o l n u
wokolnych	w o k o l n ɨ x
wokoło	w o k o w o
wokoši	w o k o ʃ i
wokrjes	w o k ʀʲ e s
wokrjesa	w o k ʀʲ e s a
wokrjesej	w o k ʀʲ e s e j
wokrjesne	w o k ʀʲ e s n e
wokrjesneho	w o k ʀʲ e s n e h o
wokrjesnej	w o k ʀʲ e s n e j
wokrjesneje	w o k ʀʲ e s n e j e
wokrjesnym	w o k ʀʲ e s n ɨ m
wokrjesu	w o k ʀʲ e s u
wola	w o l a
wole	w o l e
wolejbul	w o l e j b u l
wolerjemi	w o l e ʀʲ e m i
wolerjo	w o l e ʀʲ o
wolf	w o l f
woli	w o l i
wolić	w o l i tʃ
won	w o n
wona	w o n a
wonaj	w o n a j
wone	w o n e
wonej	w o n e j
woneje	w o n e j e
woni	w o n i
wonješe	w o nʲ e ʃ e
wonka	w o n k a
wonkowneje	w o n k o w n e j e
wonu	w o n u
wopalenjach	w o p a l e nʲ a x
wopačnemu	w o p a tʃ n e m u
wopačnym	w o p a tʃ n ɨ m
wopica	w o p i ts a
wopisać	w o p i s a tʃ
wopisować	w o p i s o w a tʃ
wopisuje	w o p i s u j e
wopodstatnić	w o p o d s t a t n i tʃ
wopokazuja	w o p o k a z u j a
wopominanja	w o p o m i n a nʲ a
wopomnišćo	w o p o m n i ʃ tʃ o
wopomnjenskim	w o p o m nʲ e n s k i m
woprawdźe	w o p ʀ a w dʒ e
woprawdźite	w o p ʀ a w dʒ i t e
woprawdźiteho	w o p ʀ a w dʒ i t e h o
woprawjenju	w o p ʀ a wʲ e nʲ u
wopraša	w o p ʀ a ʃ a
woprowali	w o p ʀ o w a l i
wopušći	w o p u ʃ tʃ i
wopušćić	w o p u ʃ tʃ i tʃ
wopyt	w o p ɨ t
wopyta	w o p ɨ t a
wopytane	w o p ɨ t a n e
wopytała	w o p ɨ t a w a
wopytowarjam	w o p ɨ t o w a ʀʲ a m
wopytowarjow	w o p ɨ t o w a ʀʲ o w
wopytowarski	w o p ɨ t o w a ʀ s k i
wopłokowali	w o p w o k o w a l i
wopłokowanskej	w o p w o k o w a n s k e j
wopřijima	w o p ʃ i j i m a
woraše	w o ʀ a ʃ e
worklecach	w o ʀ k l e ts a x
worklecy	w o ʀ k l e ts ɨ
workshopow	w o ʀ k s h o p o w
world	w o ʀ l d
wosada	w o s a d a
wosadneje	w o s a d n e j e
wosadnik	w o s a d n i k
wosadny	w o s a d n ɨ
wosadnym	w o s a d n ɨ m
wosadow	w o s a d o w
wosadu	w o s a d u
wosadźe	w o s a dʒ e
wosadźenja	w o s a dʒ e nʲ a
wosebita	w o s e b i t a
wosebite	w o s e b i t e
wosebiteho	w o s e b i t e h o
wosebitej	w o s e b i t e j
wosebitosć	w o s e b i t o s tʃ
wosebitu	w o s e b i t u
wosebity	w o s e b i t ɨ
wosebitych	w o s e b i t ɨ x
wosebitym	w o s e b i t ɨ m
wosebići	w o s e b i tʃ i
wosebje	w o s e bʲ e
wosoba	w o s o b a
wosobinje	w o s o b i nʲ e
wosobinow	w o s o b i n o w
wosobinsce	w o s o b i n s ts e
wosobinske	w o s o b i n s k e
wosobinu	w o s o b i n u
wosobiny	w o s o b i n ɨ
wosobow	w o s o b o w
wosoby	w o s o b ɨ
wosom	w o s o m
wospjet	w o s pʲ e t
wospjetowanje	w o s pʲ e t o w a nʲ e
wospjetowanju	w o s pʲ e t o w a nʲ u
wosrjedź	w o s ʀʲ e dʒ
wosta	w o s t a
wostachu	w o s t a x u
wostajić	w o s t a j i tʃ
wostanje	w o s t a nʲ e
wostanjetej	w o s t a nʲ e t e j
wostanu	w o s t a n u
wostać	w o s t a tʃ
wosudy	w o s u d ɨ
wot	w o t
wotběh	w o t b ɪ h
wotběha	w o t b ɪ h a
wotběhu	w o t b ɪ h u
wotbłyšćuja	w o t b w ɨ ʃ tʃ u j a
wotbłyšćuje	w o t b w ɨ ʃ tʃ u j e
wotchadźe	w o t x a dʒ e
wotchadźeja	w o t x a dʒ e j a
wotdźělu	w o t dʒ ɪ l u
wote	w o t e
woteběra	w o t e b ɪ ʀ a
woteběrarja	w o t e b ɪ ʀ a ʀʲ a
woteběrało	w o t e b ɪ ʀ a w o
woteda	w o t e d a
wotewrjene	w o t e w ʀʲ e n e
wotewrjenej	w o t e w ʀʲ e n e j
wotewrjenja	w o t e w ʀʲ e nʲ a
wotewrěli	w o t e w ʀ ɪ l i
wothorjeka	w o t h o ʀʲ e k a
wothrajće	w o t h ʀ a j tʃ e
wothłosowanju	w o t h w o s o w a nʲ u
wotjězda	w o t j ɪ z d a
wotklumpa	w o t k l u m p a
wotkrywanskimi	w o t k ʀ ɨ w a n s k i m i
wotmołwić	w o t m o w w i tʃ
wotmołwy	w o t m o w w ɨ
wotmysł	w o t m ɨ s w
wotmě	w o t m ɪ
wotměchu	w o t m ɪ x u
wotměje	w o t m ɪ j e
wotmějetej	w o t m ɪ j e t e j
wotměnjawe	w o t m ɪ nʲ a w e
wotměnjawych	w o t m ɪ nʲ a w ɨ x
wotměwachu	w o t m ɪ w a x u
wotměwaja	w o t m ɪ w a j a
wotměł	w o t m ɪ w
wotnětka	w o t n ɪ t k a
wotpokaza	w o t p o k a z a
wotpokazało	w o t p o k a z a w o
wotpokazuje	w o t p o k a z u j e
wotpowědne	w o t p o w ɪ d n e
wotpowědnje	w o t p o w ɪ d nʲ e
wotpowědnu	w o t p o w ɪ d n u
wotpowědny	w o t p o w ɪ d n ɨ
wotpowědnych	w o t p o w ɪ d n ɨ x
wotpowěduja	w o t p o w ɪ d u j a
wotpowěduje	w o t p o w ɪ d u j e
wotpočink	w o t p o tʃ i n k
wotpočnišća	w o t p o tʃ n i ʃ tʃ a
wotpočnył	w o t p o tʃ n ɨ w
wotpósłanjom	w o t p ʊ s w a nʲ o m
wotpósłanju	w o t p ʊ s w a nʲ u
wotpłaćeć	w o t p w a tʃ e tʃ
wotrosće	w o t ʀ o s tʃ e
wotrězkach	w o t ʀ ɪ z k a x
wotrězkow	w o t ʀ ɪ z k o w
wotstaji	w o ts t a j i
wotstajić	w o ts t a j i tʃ
wotstawkom	w o ts t a w k o m
wotsunyła	w o ts u n ɨ w a
wottam	w o t t a m
wotwažować	w o t w a ʒ o w a tʃ
wotwisne	w o t w i s n e
wotwisnje	w o t w i s nʲ e
wotwódnjenskimi	w o t w ʊ d nʲ e n s k i m i
wotwěra	w o t w ɪ ʀ a
wotzamknjene	w o t z a m k nʲ e n e
wotzamknjenju	w o t z a m k nʲ e nʲ u
wowcyne	w o w ts ɨ n e
wowka	w o w k a
wowki	w o w k i
wowku	w o w k u
wozjewi	w o z j e w i
wozjewić	w o z j e w i tʃ
wozjewjenej	w o z j e wʲ e n e j
wozjewjenja	w o z j e wʲ e nʲ a
wozjewjenje	w o z j e wʲ e nʲ e
wozjewjenju	w o z j e wʲ e nʲ u
wozjewjenskich	w o z j e wʲ e n s k i x
woznamjenić	w o z n a mʲ e n i tʃ
wočakowanja	w o tʃ a k o w a nʲ a
wočakowaše	w o tʃ a k o w a ʃ e
wočakuja	w o tʃ a k u j a
wočakuje	w o tʃ a k u j e
wočerstwjenišćo	w o tʃ e ʀ s t wʲ e n i ʃ tʃ o
wočerstwjenje	w o tʃ e ʀ s t wʲ e nʲ e
wočiwidnje	w o tʃ i w i d nʲ e
wočow	w o tʃ o w
wołaja	w o w a j a
woženjenym	w o ʒ e nʲ e n ɨ m
wožiwili	w o ʒ i w i l i
wožiwił	w o ʒ i w i w
wožiwjenje	w o ʒ i wʲ e nʲ e
wrjesny	w ʀʲ e s n ɨ
wrotow	w ʀ o t o w
wróćene	w ʀ ʊ tʃ e n e
wróćichu	w ʀ ʊ tʃ i x u
wróćo	w ʀ ʊ tʃ o
wróćolěće	w ʀ ʊ tʃ o l ɪ tʃ e
wsach	w s a x
wsow	w s o w
wsu	w s u
wsy	w s ɨ
wubrane	w u b ʀ a n e
wubědźowanje	w u b ɪ dʒ o w a nʲ e
wubědźowanjom	w u b ɪ dʒ o w a nʲ o m
wubědźowanju	w u b ɪ dʒ o w a nʲ u
wuběrk	w u b ɪ ʀ k
wuběrka	w u b ɪ ʀ k a
wuběrkej	w u b ɪ ʀ k e j
wuběrki	w u b ɪ ʀ k i
wuběrkomaj	w u b ɪ ʀ k o m a j
wuběrku	w u b ɪ ʀ k u
wuchadźa	w u x a dʒ a
wuchadźeja	w u x a dʒ e j a
wuchodna	w u x o d n a
wuchodnej	w u x o d n e j
wuchodneje	w u x o d n e j e
wuchodnych	w u x o d n ɨ x
wuchodosakski	w u x o d o s a k s k i
wuchowanje	w u x o w a nʲ e
wuchować	w u x o w a tʃ
wudanił	w u d a n i w
wudawać	w u d a w a tʃ
wudawaćelej	w u d a w a tʃ e l e j
wudawki	w u d a w k i
wudało	w u d a w o
wudobywanja	w u d o b ɨ w a nʲ a
wudobywanje	w u d o b ɨ w a nʲ e
wudobywanju	w u d o b ɨ w a nʲ u
wudospołni	w u d o s p o w n i
wudospołnić	w u d o s p o w n i tʃ
wudźeržowanje	w u dʒ e ʀ ʒ o w a nʲ e
wudźěłane	w u dʒ ɪ w a n e
wuhibki	w u h i b k i
wuhla	w u h l a
wuhlada	w u h l a d a
wuhladaš	w u h l a d a ʃ
wuhladka	w u h l a d k a
wuhlerjec	w u h l e ʀʲ e ts
wuhlik	w u h l i k
wuhlo	w u h l o
wuhlowa	w u h l o w a
wuhlowych	w u h l o w ɨ x
wuhotowanja	w u h o t o w a nʲ a
wuhotowanje	w u h o t o w a nʲ e
wuhotowanju	w u h o t o w a nʲ u
wuhotowała	w u h o t o w a w a
wuhódnoćenja	w u h ʊ d n o tʃ e nʲ a
wuhódnoćenje	w u h ʊ d n o tʃ e nʲ e
wuhódnoćenjom	w u h ʊ d n o tʃ e nʲ o m
wuhódnoćić	w u h ʊ d n o tʃ i tʃ
wujemi	w u j e m i
wuježku	w u j e ʒ k u
wujěcha	w u j ɪ x a
wujězdźe	w u j ɪ z dʒ e
wukaz	w u k a z
wuklinči	w u k l i n tʃ i
wukmanjenje	w u k m a nʲ e nʲ e
wuknjacy	w u k nʲ a ts ɨ
wuknjacych	w u k nʲ a ts ɨ x
wuknjenju	w u k nʲ e nʲ u
wuknjenska	w u k nʲ e n s k a
wuknjeće	w u k nʲ e tʃ e
wuknu	w u k n u
wuknyć	w u k n ɨ tʃ
wukona	w u k o n a
wukonjamy	w u k o nʲ a m ɨ
wukonjeja	w u k o nʲ e j a
wukonjeć	w u k o nʲ e tʃ
wukonliwy	w u k o n l i w ɨ
wukraja	w u k ʀ a j a
wukrajnikam	w u k ʀ a j n i k a m
wukrajnikow	w u k ʀ a j n i k o w
wukrajnymi	w u k ʀ a j n ɨ m i
wukubłani	w u k u b w a n i
wukubłanja	w u k u b w a nʲ a
wukubłanje	w u k u b w a nʲ e
wukubłanych	w u k u b w a n ɨ x
wulijawu	w u l i j a w u
wulka	w u l k a
wulke	w u l k e
wulkeho	w u l k e h o
wulkej	w u l k e j
wulkeje	w u l k e j e
wulki	w u l k i
wulkim	w u l k i m
wulkomorawskim	w u l k o m o ʀ a w s k i m
wulkotne	w u l k o t n e
wulkotnje	w u l k o t nʲ e
wulkotnymi	w u l k o t n ɨ m i
wulkowujemi	w u l k o w u j e m i
wulkoćeta	w u l k o tʃ e t a
wulku	w u l k u
wulěty	w u l ɪ t ɨ
wumjetuje	w u mʲ e t u j e
wumrěje	w u m ʀ ɪ j e
wumyslili	w u m ɨ s l i l i
wuměna	w u m ɪ n a
wuměnjeja	w u m ɪ nʲ e j a
wuměnjenja	w u m ɪ nʲ e nʲ a
wuměnjenje	w u m ɪ nʲ e nʲ e
wuměnjenjow	w u m ɪ nʲ e nʲ o w
wuměnjeć	w u m ɪ nʲ e tʃ
wuměnu	w u m ɪ n u
wuměłc	w u m ɪ w ts
wuměłca	w u m ɪ w ts a
wuměłcow	w u m ɪ w ts o w
wuměłsce	w u m ɪ w s ts e
wuměłskeho	w u m ɪ w s k e h o
wuměłskich	w u m ɪ w s k i x
wuměłstwa	w u m ɪ w s t w a
wuměłstwo	w u m ɪ w s t w o
wuměłstwom	w u m ɪ w s t w o m
wuměłstwowa	w u m ɪ w s t w o w a
wuměłstwoweho	w u m ɪ w s t w o w e h o
wunamakarjo	w u n a m a k a ʀʲ o
wunamakała	w u n a m a k a w a
wunjese	w u nʲ e s e
wunjesli	w u nʲ e s l i
wunošnych	w u n o ʃ n ɨ x
wunuzowała	w u n u z o w a w a
wupada	w u p a d a
wupadnje	w u p a d nʲ e
wupinu	w u p i n u
wupisanje	w u p i s a nʲ e
wupožčić	w u p o ʒ tʃ i tʃ
wupraja	w u p ʀ a j a
wuprajenje	w u p ʀ a j e nʲ e
wuprózdnić	w u p ʀ ʊ z d n i tʃ
wupyšenych	w u p ɨ ʃ e n ɨ x
wupósłanja	w u p ʊ s w a nʲ a
wupósłanjom	w u p ʊ s w a nʲ o m
wupřestrěwaše	w u p ʃ e s t ʀ ɪ w a ʃ e
wuradźować	w u ʀ a dʒ o w a tʃ
wuraz	w u ʀ a z
wurazu	w u ʀ a z u
wurunanjom	w u ʀ u n a nʲ o m
wurunać	w u ʀ u n a tʃ
wurězkow	w u ʀ ɪ z k o w
wuschnje	w u s x nʲ e
wuskej	w u s k e j
wuski	w u s k i
wuskim	w u s k i m
wusko	w u s k o
wuskutkowało	w u s k u t k o w a w o
wuskutkuje	w u s k u t k u j e
wuslědkam	w u s l ɪ d k a m
wuslědki	w u s l ɪ d k i
wuslědkow	w u s l ɪ d k o w
wusměrić	w u s m ɪ ʀ i tʃ
wusměrja	w u s m ɪ ʀʲ a
wusměrjene	w u s m ɪ ʀʲ e n e
wusměrjeny	w u s m ɪ ʀʲ e n ɨ
wuspytachu	w u s p ɨ t a x u
wuspytaja	w u s p ɨ t a j a
wuspěcha	w u s p ɪ x a
wuspěšna	w u s p ɪ ʃ n a
wuspěšne	w u s p ɪ ʃ n e
wuspěšnym	w u s p ɪ ʃ n ɨ m
wustajeć	w u s t a j e tʃ
wustajeńca	w u s t a j e nʲ ts a
wustajeńcu	w u s t a j e nʲ ts u
wustajeńcy	w u s t a j e nʲ ts ɨ
wustawje	w u s t a wʲ e
wustawki	w u s t a w k i
wustawkow	w u s t a w k o w
wustawowym	w u s t a w o w ɨ m
wustojnym	w u s t o j n ɨ m
wustup	w u s t u p
wustupowanje	w u s t u p o w a nʲ e
wustupować	w u s t u p o w a tʃ
wustupuja	w u s t u p u j a
wusuda	w u s u d a
wuswobodźili	w u s w o b o dʒ i l i
wuswědčenjom	w u s w ɪ d tʃ e nʲ o m
wuswětli	w u s w ɪ t l i
wusyłanje	w u s ɨ w a nʲ e
wutoru	w u t o ʀ u
wutrobička	w u t ʀ o b i tʃ k a
wutrobnje	w u t ʀ o b nʲ e
wutrobnu	w u t ʀ o b n u
wutrobny	w u t ʀ o b n ɨ
wutrobu	w u t ʀ o b u
wutwar	w u t w a ʀ
wutwarić	w u t w a ʀ i tʃ
wutwori	w u t w o ʀ i
wutworili	w u t w o ʀ i l i
wutworić	w u t w o ʀ i tʃ
wutworjena	w u t w o ʀʲ e n a
wutworjene	w u t w o ʀʲ e n e
wutworjenje	w u t w o ʀʲ e nʲ e
wutworjenju	w u t w o ʀʲ e nʲ u
wuwi	w u w i
wuwiwa	w u w i w a
wuwiwanje	w u w i w a nʲ e
wuwiwanju	w u w i w a nʲ u
wuwiwać	w u w i w a tʃ
wuwić	w u w i tʃ
wuwića	w u w i tʃ a
wuwiće	w u w i tʃ e
wuwiću	w u w i tʃ u
wuwiło	w u w i w o
wuwjedźenskeho	w u wʲ e dʒ e n s k e h o
wuwojować	w u w o j o w a tʃ
wuwojowało	w u w o j o w a w o
wuwučowacych	w u w u tʃ o w a ts ɨ x
wuwučowanje	w u w u tʃ o w a nʲ e
wuwučowansku	w u w u tʃ o w a n s k u
wuwědomić	w u w ɪ d o m i tʃ
wuzamknje	w u z a m k nʲ e
wuzamknjene	w u z a m k nʲ e n e
wuzamkował	w u z a m k o w a w
wuzběhnyła	w u z b ɪ h n ɨ w a
wuzběhnyštaj	w u z b ɪ h n ɨ ʃ t a j
wuznam	w u z n a m
wuznamjeni	w u z n a mʲ e n i
wuznamjenić	w u z n a mʲ e n i tʃ
wuznamjenja	w u z n a mʲ e nʲ a
wuznawa	w u z n a w a
wuzwolenje	w u z w o l e nʲ e
wuzwoli	w u z w o l i
wučacy	w u tʃ a ts ɨ
wučba	w u tʃ b a
wučbje	w u tʃ bʲ e
wučbne	w u tʃ b n e
wučbnica	w u tʃ b n i ts a
wučbnicow	w u tʃ b n i ts o w
wučbny	w u tʃ b n ɨ
wučbu	w u tʃ b u
wučby	w u tʃ b ɨ
wučer	w u tʃ e ʀ
wučerjej	w u tʃ e ʀʲ e j
wučerjenjom	w u tʃ e ʀʲ e nʲ o m
wučerjo	w u tʃ e ʀʲ o
wučerjom	w u tʃ e ʀʲ o m
wučerjow	w u tʃ e ʀʲ o w
wučerka	w u tʃ e ʀ k a
wučerskim	w u tʃ e ʀ s k i m
wučerstwo	w u tʃ e ʀ s t w o
wučeštaj	w u tʃ e ʃ t a j
wučić	w u tʃ i tʃ
wułožowanja	w u w o ʒ o w a nʲ a
wuši	w u ʃ i
wuškrěwanskich	w u ʃ k ʀ ɪ w a n s k i x
wušo	w u ʃ o
wušła	w u ʃ w a
wužada	w u ʒ a d a
wužadanja	w u ʒ a d a nʲ a
wužadanje	w u ʒ a d a nʲ e
wužichmy	w u ʒ i x m ɨ
wužitny	w u ʒ i t n ɨ
wužiwa	w u ʒ i w a
wužiwachu	w u ʒ i w a x u
wužiwaja	w u ʒ i w a j a
wužiwanja	w u ʒ i w a nʲ a
wužiwarjemi	w u ʒ i w a ʀʲ e m i
wužiwać	w u ʒ i w a tʃ
wužiwaše	w u ʒ i w a ʃ e
wužłobjenjemi	w u ʒ w o bʲ e nʲ e m i
wy	w ɨ
wysoke	w ɨ s o k e
wysokorjadnej	w ɨ s o k o ʀʲ a d n e j
wyša	w ɨ ʃ a
wyše	w ɨ ʃ e
wyšeho	w ɨ ʃ e h o
wyši	w ɨ ʃ i
wyšu	w ɨ ʃ u
wza	w z a
wzachu	w z a x u
wzali	w z a l i
wzaty	w z a t ɨ
wódna	w ʊ d n a
wódnu	w ʊ d n u
wój	w ʊ j
wójnje	w ʊ j nʲ e
wójny	w ʊ j n ɨ
wólbam	w ʊ l b a m
wólbna	w ʊ l b n a
wólbnej	w ʊ l b n e j
wólbny	w ʊ l b n ɨ
wólbow	w ʊ l b o w
wólby	w ʊ l b ɨ
wón	w ʊ n
wósk	w ʊ s k
wóslacych	w ʊ s l a ts ɨ x
wóslika	w ʊ s l i k a
wóslikej	w ʊ s l i k e j
wótc	w ʊ t ts
wótře	w ʊ tʃ e
wóčku	w ʊ tʃ k u
wćipna	w tʃ i p n a
wčera	w tʃ e ʀ a
wčerawšej	w tʃ e ʀ a w ʃ e j
wčerawšim	w tʃ e ʀ a w ʃ i m
wě	w ɪ
wěcne	w ɪ ts n e
wěcnym	w ɪ ts n ɨ m
wěcow	w ɪ ts o w
wěcownosći	w ɪ ts o w n o s tʃ i
wěcy	w ɪ ts ɨ
wědomja	w ɪ d o mʲ a
wědomje	w ɪ d o mʲ e
wědomostna	w ɪ d o m o s t n a
wědomostneje	w ɪ d o m o s t n e j e
wědomostnik	w ɪ d o m o s t n i k
wědomostnych	w ɪ d o m o s t n ɨ x
wědomosć	w ɪ d o m o s tʃ
wědu	w ɪ d u
wědy	w ɪ d ɨ
wědźachu	w ɪ dʒ a x u
wědźeć	w ɪ dʒ e tʃ
wěm	w ɪ m
wěnowachu	w ɪ n o w a x u
wěnowała	w ɪ n o w a w a
wěnowaše	w ɪ n o w a ʃ e
wěnuje	w ɪ n u j e
wěri	w ɪ ʀ i
wěriwymi	w ɪ ʀ i w ɨ m i
wěrić	w ɪ ʀ i tʃ
wěrje	w ɪ ʀʲ e
wěrjomnu	w ɪ ʀʲ o m n u
wěrnosć	w ɪ ʀ n o s tʃ
wěrnosći	w ɪ ʀ n o s tʃ i
wěru	w ɪ ʀ u
wěste	w ɪ s t e
wěstu	w ɪ s t u
wěsty	w ɪ s t ɨ
wěstych	w ɪ s t ɨ x
wěsći	w ɪ s tʃ i
wětry	w ɪ t ʀ ɨ
wězo	w ɪ z o
wěža	w ɪ ʒ a
wěžu	w ɪ ʒ u
włosy	w w o s ɨ
wšak	w ʃ a k
wšako	w ʃ a k o
wšeho	w ʃ e h o
wšelacy	w ʃ e l a ts ɨ
wšelake	w ʃ e l a k e
wšelakich	w ʃ e l a k i x
wšelakore	w ʃ e l a k o ʀ e
wšelakorosću	w ʃ e l a k o ʀ o s tʃ u
wšitcy	w ʃ i t ts ɨ
wšitke	w ʃ i t k e
wšitkich	w ʃ i t k i x
wšitko	w ʃ i t k o
wšo	w ʃ o
wšojedne	w ʃ o j e d n e
wšudźe	w ʃ u dʒ e
wšón	w ʃ ʊ n
wšěch	w ʃ ɪ x
wšědna	w ʃ ɪ d n a
wšědnej	w ʃ ɪ d n e j
wšědneje	w ʃ ɪ d n e j e
wšědnje	w ʃ ɪ d nʲ e
wšědny	w ʃ ɪ d n ɨ
wšědnym	w ʃ ɪ d n ɨ m
wšěm	w ʃ ɪ m
wšěmi	w ʃ ɪ m i
z	z
za	z a
zabrać	z a b ʀ a tʃ
zaby	z a b ɨ
zabyła	z a b ɨ w a
zabyłoj	z a b ɨ w o j
zaběrać	z a b ɪ ʀ a tʃ
zaběrał	z a b ɪ ʀ a w
zaběrje	z a b ɪ ʀʲ e
zaběru	z a b ɪ ʀ u
zachowanje	z a x o w a nʲ e
zachowanju	z a x o w a nʲ u
zachować	z a x o w a tʃ
zachribjetny	z a x ʀ i bʲ e t n ɨ
zacpěwanja	z a ts p ɪ w a nʲ a
zady	z a d ɨ
zadźeržała	z a dʒ e ʀ ʒ a w a
zadźerženju	z a dʒ e ʀ ʒ e nʲ u
zadźeržeć	z a dʒ e ʀ ʒ e tʃ
zadźiwa	z a dʒ i w a
zadźěwać	z a dʒ ɪ w a tʃ
zahajene	z a h a j e n e
zahajenjom	z a h a j e nʲ o m
zahajenju	z a h a j e nʲ u
zahajili	z a h a j i l i
zahajił	z a h a j i w
zahe	z a h e
zahinu	z a h i n u
zahorił	z a h o ʀ i w
zahorjeni	z a h o ʀʲ e n i
zahrodach	z a h ʀ o d a x
zahrodnikec	z a h ʀ o d n i k e ts
zahrody	z a h ʀ o d ɨ
zahrodźe	z a h ʀ o dʒ e
zajim	z a j i m
zajima	z a j i m a
zajimawe	z a j i m a w e
zajimawostki	z a j i m a w o s t k i
zajimawy	z a j i m a w ɨ
zajimcow	z a j i m ts o w
zajimcy	z a j i m ts ɨ
zajimje	z a j i mʲ e
zajimom	z a j i m o m
zajimow	z a j i m o w
zajimowachu	z a j i m o w a x u
zajimowane	z a j i m o w a n e
zajimowało	z a j i m o w a w o
zajimuje	z a j i m u j e
zajimy	z a j i m ɨ
zajimče	z a j i m tʃ e
zakazachu	z a k a z a x u
zakazy	z a k a z ɨ
zakitowaše	z a k i t o w a ʃ e
zaklinčachu	z a k l i n tʃ a x u
zakomdźił	z a k o m dʒ i w
zakonikami	z a k o n i k a m i
zakonja	z a k o nʲ a
zakonje	z a k o nʲ e
zakonjej	z a k o nʲ e j
zakonjom	z a k o nʲ o m
zakonjow	z a k o nʲ o w
zakoń	z a k o nʲ
zakryte	z a k ʀ ɨ t e
zakónčacej	z a k ʊ n tʃ a ts e j
zakónčenju	z a k ʊ n tʃ e nʲ u
zakótwjena	z a k ʊ t wʲ e n a
zakótwjeneje	z a k ʊ t wʲ e n e j e
zakład	z a k w a d
zakładne	z a k w a d n e
zakładneho	z a k w a d n e h o
zakładnej	z a k w a d n e j
zakładnemu	z a k w a d n e m u
zakładny	z a k w a d n ɨ
zakładnych	z a k w a d n ɨ x
zakładnymi	z a k w a d n ɨ m i
zakłady	z a k w a d ɨ
zakładźe	z a k w a dʒ e
zalězu	z a l ɪ z u
zalězć	z a l ɪ z tʃ
zamołwita	z a m o w w i t a
zamołwitaj	z a m o w w i t a j
zamołwite	z a m o w w i t e
zamołwitosć	z a m o w w i t o s tʃ
zamołwitosće	z a m o w w i t o s tʃ e
zamołwitosći	z a m o w w i t o s tʃ i
zamołwity	z a m o w w i t ɨ
zamołwitych	z a m o w w i t ɨ x
zamołwitym	z a m o w w i t ɨ m
zamołwići	z a m o w w i tʃ i
zamołwja	z a m o w wʲ a
zamołwjenskim	z a m o w wʲ e n s k i m
zamóžnosć	z a m ʊ ʒ n o s tʃ
zaměr	z a m ɪ ʀ
zaměrom	z a m ɪ ʀ o m
zaměrow	z a m ɪ ʀ o w
zaměroweho	z a m ɪ ʀ o w e h o
zaměry	z a m ɪ ʀ ɨ
zanurić	z a n u ʀ i tʃ
zapadne	z a p a d n e
zapadnu	z a p a d n u
zapadźe	z a p a dʒ e
zapalimy	z a p a l i m ɨ
zapisa	z a p i s a
zapisane	z a p i s a n e
zapisanych	z a p i s a n ɨ x
zapisało	z a p i s a w o
zapodatym	z a p o d a t ɨ m
zapodała	z a p o d a w a
započa	z a p o tʃ a
započachu	z a p o tʃ a x u
započatk	z a p o tʃ a t k
započeli	z a p o tʃ e l i
zapósłancam	z a p ʊ s w a n ts a m
zapósłancow	z a p ʊ s w a n ts o w
zapřija	z a p ʃ i j a
zapřijate	z a p ʃ i j a t e
zapřijeć	z a p ʃ i j e tʃ
zapřijeće	z a p ʃ i j e tʃ e
zapřijima	z a p ʃ i j i m a
zapřijimajće	z a p ʃ i j i m a j tʃ e
zapřijimać	z a p ʃ i j i m a tʃ
zarjad	z a ʀʲ a d
zarjada	z a ʀʲ a d a
zarjadej	z a ʀʲ a d e j
zarjadniske	z a ʀʲ a d n i s k e
zarjadniski	z a ʀʲ a d n i s k i
zarjadnistwa	z a ʀʲ a d n i s t w a
zarjadnistwo	z a ʀʲ a d n i s t w o
zarjadnišća	z a ʀʲ a d n i ʃ tʃ a
zarjadnišćo	z a ʀʲ a d n i ʃ tʃ o
zarjadow	z a ʀʲ a d o w
zarjadowa	z a ʀʲ a d o w a
zarjadowanja	z a ʀʲ a d o w a nʲ a
zarjadowanje	z a ʀʲ a d o w a nʲ e
zarjadowanjom	z a ʀʲ a d o w a nʲ o m
zarjadowanjow	z a ʀʲ a d o w a nʲ o w
zarjadowanju	z a ʀʲ a d o w a nʲ u
zarjadować	z a ʀʲ a d o w a tʃ
zarjedźe	z a ʀʲ e dʒ e
zaručenje	z a ʀ u tʃ e nʲ e
zaručeć	z a ʀ u tʃ e tʃ
zaručić	z a ʀ u tʃ i tʃ
zasadach	z a s a d a x
zasadami	z a s a d a m i
zasadne	z a s a d n e
zasadnje	z a s a d nʲ e
zasadnych	z a s a d n ɨ x
zasady	z a s a d ɨ
zasadźa	z a s a dʒ a
zasadźamy	z a s a dʒ a m ɨ
zasadźe	z a s a dʒ e
zasadźeć	z a s a dʒ e tʃ
zasadźić	z a s a dʒ i tʃ
zasadźił	z a s a dʒ i w
zasadźować	z a s a dʒ o w a tʃ
zasadźowaše	z a s a dʒ o w a ʃ e
zasadźu	z a s a dʒ u
zasadźuje	z a s a dʒ u j e
zasadźujemy	z a s a dʒ u j e m ɨ
zasahow	z a s a h o w
zaso	z a s o
zastachu	z a s t a x u
zastarachu	z a s t a ʀ a x u
zastaranje	z a s t a ʀ a nʲ e
zastarować	z a s t a ʀ o w a tʃ
zastaruje	z a s t a ʀ u j e
zastojnstwa	z a s t o j n s t w a
zastojnstwo	z a s t o j n s t w o
zastupi	z a s t u p i
zastupjerja	z a s t u pʲ e ʀʲ a
zastupjerjam	z a s t u pʲ e ʀʲ a m
zastupjerjo	z a s t u pʲ e ʀʲ o
zastupjerjow	z a s t u pʲ e ʀʲ o w
zastupjerka	z a s t u pʲ e ʀ k a
zastupnicy	z a s t u p n i ts ɨ
zastupnikow	z a s t u p n i k o w
zastupować	z a s t u p o w a tʃ
zastupuje	z a s t u p u j e
zastupujemy	z a s t u p u j e m ɨ
zastupujetaj	z a s t u p u j e t a j
zasunyć	z a s u n ɨ tʃ
zasydlenej	z a s ɨ d l e n e j
zasydlić	z a s ɨ d l i tʃ
zasłuža	z a s w u ʒ a
zasłužba	z a s w u ʒ b a
zasłyša	z a s w ɨ ʃ a
zatwarjamy	z a t w a ʀʲ a m ɨ
zatřělić	z a tʃ ɪ l i tʃ
zawjazaj	z a wʲ a z a j
zawjazać	z a wʲ a z a tʃ
zawjazaš	z a wʲ a z a ʃ
zawjesć	z a wʲ e s tʃ
zawodneho	z a w o d n e h o
zawodow	z a w o d o w
zawodoweho	z a w o d o w e h o
zawostajić	z a w o s t a j i tʃ
zawěsće	z a w ɪ s tʃ e
zawěsćenju	z a w ɪ s tʃ e nʲ u
zazběhom	z a z b ɪ h o m
začiń	z a tʃ i nʲ
začuća	z a tʃ u tʃ a
załožba	z a w o ʒ b a
załožby	z a w o ʒ b ɨ
załožena	z a w o ʒ e n a
załožene	z a w o ʒ e n e
załoženje	z a w o ʒ e nʲ e
załoženju	z a w o ʒ e nʲ u
załoži	z a w o ʒ i
załožili	z a w o ʒ i l i
załožić	z a w o ʒ i tʃ
zańdźenju	z a nʲ dʒ e nʲ u
zańdźenosće	z a nʲ dʒ e n o s tʃ e
zańdźenu	z a nʲ dʒ e n u
zašo	z a ʃ o
zašćěpiło	z a ʃ tʃ ɪ p i w o
zašłeho	z a ʃ w e h o
zašłosć	z a ʃ w o s tʃ
zašły	z a ʃ w ɨ
zašłych	z a ʃ w ɨ x
zašłym	z a ʃ w ɨ m
zažnej	z a ʒ n e j
zažnym	z a ʒ n ɨ m
zbliska	z b l i s k a
zbližić	z b l i ʒ i tʃ
zbožo	z b o ʒ o
zbožownej	z b o ʒ o w n e j
zbrašenych	z b ʀ a ʃ e n ɨ x
zběhnyć	z b ɪ h n ɨ tʃ
zběhnył	z b ɪ h n ɨ w
zběrali	z b ɪ ʀ a l i
zběrkow	z b ɪ ʀ k o w
zběrku	z b ɪ ʀ k u
zda	z d a
zdalena	z d a l e n a
zdalenosće	z d a l e n o s tʃ e
zdaleny	z d a l e n ɨ
zdaloka	z d a l o k a
zdaću	z d a tʃ u
zdobom	z d o b o m
zdobyte	z d o b ɨ t e
zdobyć	z d o b ɨ tʃ
zdobyću	z d o b ɨ tʃ u
zdrjenych	z d ʀʲ e n ɨ x
zdruha	z d ʀ u h a
zdźeržał	z dʒ e ʀ ʒ a w
zdźerženja	z dʒ e ʀ ʒ e nʲ a
zdźerženje	z dʒ e ʀ ʒ e nʲ e
zdźěla	z dʒ ɪ l a
zdźělenki	z dʒ ɪ l e n k i
zdźěli	z dʒ ɪ l i
zdźělištej	z dʒ ɪ l i ʃ t e j
ze	z e
zejlerja	z e j l e ʀʲ a
zelena	z e l e n a
zelenina	z e l e n i n a
zeleninu	z e l e n i n u
zelenych	z e l e n ɨ x
zelenym	z e l e n ɨ m
zelenymi	z e l e n ɨ m i
zemi	z e m i
zemje	z e mʲ e
zemrě	z e m ʀ ɪ
zemrěteho	z e m ʀ ɪ t e h o
zemrěła	z e m ʀ ɪ w a
zemrěło	z e m ʀ ɪ w o
zepěra	z e p ɪ ʀ a
zes	z e s
zeskutkownjenje	z e s k u t k o w nʲ e nʲ e
zestajał	z e s t a j a w
zestajeja	z e s t a j e j a
zestajenju	z e s t a j e nʲ u
zestajeć	z e s t a j e tʃ
zestajić	z e s t a j i tʃ
zetka	z e t k a
zetkaja	z e t k a j a
zetkanja	z e t k a nʲ a
zetkanje	z e t k a nʲ e
zetkanju	z e t k a nʲ u
zezna	z e z n a
zeznaja	z e z n a j a
zeznajeće	z e z n a j e tʃ e
zeznajomić	z e z n a j o m i tʃ
zeznali	z e z n a l i
zeznać	z e z n a tʃ
zežiwjenje	z e ʒ i wʲ e nʲ e
zežiwjenju	z e ʒ i wʲ e nʲ u
zhladować	z h l a d o w a tʃ
zhonili	z h o n i l i
zhonimy	z h o n i m ɨ
zhonić	z h o n i tʃ
zhoniła	z h o n i w a
zhonja	z h o nʲ a
zhorjelc	z h o ʀʲ e l ts
zhorjelca	z h o ʀʲ e l ts a
zhorjelcu	z h o ʀʲ e l ts u
zhorjelskeho	z h o ʀʲ e l s k e h o
zhotowištaj	z h o t o w i ʃ t a j
zhromadne	z h ʀ o m a d n e
zhromadneho	z h ʀ o m a d n e h o
zhromadnej	z h ʀ o m a d n e j
zhromadneje	z h ʀ o m a d n e j e
zhromadnemu	z h ʀ o m a d n e m u
zhromadnje	z h ʀ o m a d nʲ e
zhromadnosć	z h ʀ o m a d n o s tʃ
zhromadnosće	z h ʀ o m a d n o s tʃ e
zhromadnu	z h ʀ o m a d n u
zhromadny	z h ʀ o m a d n ɨ
zhromadnym	z h ʀ o m a d n ɨ m
zhromadźenstwa	z h ʀ o m a dʒ e n s t w a
zhromadźenstwo	z h ʀ o m a dʒ e n s t w o
zhromadźizna	z h ʀ o m a dʒ i z n a
zhromadźiznje	z h ʀ o m a dʒ i z nʲ e
zhromadźizny	z h ʀ o m a dʒ i z n ɨ
zhromadźowaše	z h ʀ o m a dʒ o w a ʃ e
zhubi	z h u b i
zhubić	z h u b i tʃ
zhubiła	z h u b i w a
zhubja	z h u bʲ a
zjawna	z j a w n a
zjawne	z j a w n e
zjawneho	z j a w n e h o
zjawnosć	z j a w n o s tʃ
zjawnosće	z j a w n o s tʃ e
zjawnosći	z j a w n o s tʃ i
zjawnosću	z j a w n o s tʃ u
zjednoćenju	z j e d n o tʃ e nʲ u
zlutniwje	z l u t n i wʲ e
zlě	z l ɪ
zmijom	z m i j o m
zmilinjenja	z m i l i nʲ e nʲ a
zmištrowali	z m i ʃ t ʀ o w a l i
zmištrować	z m i ʃ t ʀ o w a tʃ
zmjerzlina	z mʲ e ʀ z l i n a
zmjerzlinje	z mʲ e ʀ z l i nʲ e
zmužite	z m u ʒ i t e
zmužitosć	z m u ʒ i t o s tʃ
zmysle	z m ɨ s l e
zmóžni	z m ʊ ʒ n i
zmóžnić	z m ʊ ʒ n i tʃ
změja	z m ɪ j a
změje	z m ɪ j e
změjemoj	z m ɪ j e m o j
změjeće	z m ɪ j e tʃ e
změješ	z m ɪ j e ʃ
změna	z m ɪ n a
změnach	z m ɪ n a x
změnili	z m ɪ n i l i
změnić	z m ɪ n i tʃ
změnił	z m ɪ n i w
změnjena	z m ɪ nʲ e n a
změnow	z m ɪ n o w
změnu	z m ɪ n u
změny	z m ɪ n ɨ
změrcowski	z m ɪ ʀ ts o w s k i
znaja	z n a j a
znajachu	z n a j a x u
znaje	z n a j e
znaješ	z n a j e ʃ
znajmjeńša	z n a j mʲ e nʲ ʃ a
znajomosće	z n a j o m o s tʃ e
znamki	z n a m k i
znate	z n a t e
znaty	z n a t ɨ
znazdala	z n a z d a l a
zniča	z n i tʃ a
zničić	z n i tʃ i tʃ
znižena	z n i ʒ e n a
znjeměrnjeni	z nʲ e m ɪ ʀ nʲ e n i
znjewužiwani	z nʲ e w u ʒ i w a n i
znjewužiwanju	z nʲ e w u ʒ i w a nʲ u
znosyć	z n o s ɨ tʃ
znowa	z n o w a
znutřka	z n u tʃ k a
zo	z o
zraniła	z ʀ a n i w a
zranjenjach	z ʀ a nʲ e nʲ a x
zrjadowane	z ʀʲ a d o w a n e
zrjadować	z ʀʲ a d o w a tʃ
zrozumjenje	z ʀ o z u mʲ e nʲ e
zrozumliwe	z ʀ o z u m l i w e
zrudni	z ʀ u d n i
zrudoby	z ʀ u d o b ɨ
zrěčenje	z ʀ ɪ tʃ e nʲ e
zrěčenjow	z ʀ ɪ tʃ e nʲ o w
zt	z t
zubornički	z u b o ʀ n i tʃ k i
zuwamy	z u w a m ɨ
zwickauwa	z w i ts k a u w a
zwisk	z w i s k
zwiski	z w i s k i
zwisku	z w i s k u
zwisuje	z w i s u j e
zwičnili	z w i tʃ n i l i
zwičnjenje	z w i tʃ nʲ e nʲ e
zwjazane	z wʲ a z a n e
zwjazanosć	z wʲ a z a n o s tʃ
zwjazany	z wʲ a z a n ɨ
zwjazk	z wʲ a z k
zwjazka	z wʲ a z k a
zwjazkaj	z wʲ a z k a j
zwjazkarjow	z wʲ a z k a ʀʲ o w
zwjazki	z wʲ a z k i
zwjazkow	z wʲ a z k o w
zwjazkowe	z wʲ a z k o w e
zwjazkoweho	z wʲ a z k o w e h o
zwjazkowej	z wʲ a z k o w e j
zwjazkoweje	z wʲ a z k o w e j e
zwjazkowemu	z wʲ a z k o w e m u
zwjazkowy	z wʲ a z k o w ɨ
zwjazkowych	z wʲ a z k o w ɨ x
zwjazkowym	z wʲ a z k o w ɨ m
zwjazkowymi	z wʲ a z k o w ɨ m i
zwjazowacu	z wʲ a z o w a ts u
zwjazujeće	z wʲ a z u j e tʃ e
zwjesela	z wʲ e s e l a
zwjetša	z wʲ e tʃ a
zwobraznichu	z w o b ʀ a z n i x u
zwonka	z w o n k a
zwonkastejaceho	z w o n k a s t e j a ts e h o
zwony	z w o n ɨ
zwoprawdźenje	z w o p ʀ a w dʒ e nʲ e
zwoprawdźenju	z w o p ʀ a w dʒ e nʲ u
zwoprawdźeć	z w o p ʀ a w dʒ e tʃ
zwoprawdźi	z w o p ʀ a w dʒ i
zwoprawdźił	z w o p ʀ a w dʒ i w
zwosadźane	z w o s a dʒ a n e
zwostanje	z w o s t a nʲ e
zwotkel	z w o t k e l
zwrěšćili	z w ʀ ɪ ʃ tʃ i l i
zwrěšćimy	z w ʀ ɪ ʃ tʃ i m ɨ
zwrěšćiła	z w ʀ ɪ ʃ tʃ i w a
zwuk	z w u k
zwukami	z w u k a m i
zwuraznić	z w u ʀ a z n i tʃ
zwuraznjena	z w u ʀ a z nʲ e n a
zwučowanjach	z w u tʃ o w a nʲ a x
zwučowanju	z w u tʃ o w a nʲ u
zwučować	z w u tʃ o w a tʃ
zwučuje	z w u tʃ u j e
zwyšenja	z w ɨ ʃ e nʲ a
zwyšenju	z w ɨ ʃ e nʲ u
zwólniwosć	z w ʊ l n i w o s tʃ
zwěrjata	z w ɪ ʀʲ a t a
zwěrjatow	z w ɪ ʀʲ a t o w
zwěrjenca	z w ɪ ʀʲ e n ts a
zwěrječich	z w ɪ ʀʲ e tʃ i x
zwěrjo	z w ɪ ʀʲ o
zwěsćić	z w ɪ s tʃ i tʃ
zymje	z ɨ mʲ e
zymnaj	z ɨ m n a j
zymske	z ɨ m s k e
zymskich	z ɨ m s k i x
zymskim	z ɨ m s k i m
złahodźić	z w a h o dʒ i tʃ
złe	z w e
złoženja	z w o ʒ e nʲ a
{lachen}	spn
{laughter}	spn
{laugh}	spn
{lg}	spn
ćah	tʃ a h
ćahać	tʃ a h a tʃ
ćahnyli	tʃ a h n ɨ l i
će	tʃ e
ćehnješ	tʃ e h nʲ e ʃ
ćeknyć	tʃ e k n ɨ tʃ
ćekła	tʃ e k w a
ćerń	tʃ e ʀ nʲ
ćeta	tʃ e t a
ćežisćo	tʃ e ʒ i s tʃ o
ćežišći	tʃ e ʒ i ʃ tʃ i
ćežišćo	tʃ e ʒ i ʃ tʃ o
ćežkej	tʃ e ʒ k e j
ćežkim	tʃ e ʒ k i m
ćežko	tʃ e ʒ k o
ći	tʃ i
ćiche	tʃ i x e
ćim	tʃ i m
ćisk	tʃ i s k
ćiskowski	tʃ i s k o w s k i
ćisnyć	tʃ i s n ɨ tʃ
ćišć	tʃ i ʃ tʃ
ćišćanskim	tʃ i ʃ tʃ a n s k i m
ćišćerske	tʃ i ʃ tʃ e ʀ s k e
ćmowe	tʃ m o w e
ćmowej	tʃ m o w e j
ćmowym	tʃ m o w ɨ m
ćěkancam	tʃ ɪ k a n ts a m
ćěkancami	tʃ ɪ k a n ts a m i
ćěła	tʃ ɪ w a
ćěłach	tʃ ɪ w a x
ćěło	tʃ ɪ w o
čaka	tʃ a k a
čakachu	tʃ a k a x u
čakać	tʃ a k a tʃ
čakaše	tʃ a k a ʃ e
čamarjec	tʃ a m a ʀʲ e ts
čas	tʃ a s
časa	tʃ a s a
časach	tʃ a s a x
časnikarja	tʃ a s n i k a ʀʲ a
časniki	tʃ a s n i k i
časom	tʃ a s o m
časopisy	tʃ a s o p i s ɨ
časow	tʃ a s o w
často	tʃ a s t o
času	tʃ a s u
čehodla	tʃ e h o d l a
čeje	tʃ e j e
čerpać	tʃ e ʀ p a tʃ
čerstwym	tʃ e ʀ s t w ɨ m
čert	tʃ e ʀ t
čertow	tʃ e ʀ t o w
čerwjeny	tʃ e ʀ wʲ e n ɨ
čerwjenych	tʃ e ʀ wʲ e n ɨ x
čerće	tʃ e ʀ tʃ e
česaki	tʃ e s a k i
čestnohamtsce	tʃ e s t n o h a m ts ts e
čestnohamtske	tʃ e s t n o h a m ts k e
čestnohamtski	tʃ e s t n o h a m ts k i
čestnosć	tʃ e s t n o s tʃ
česćownosć	tʃ e s tʃ o w n o s tʃ
čim	tʃ i m
čini	tʃ i n i
činili	tʃ i n i l i
činić	tʃ i n i tʃ
činił	tʃ i n i w
činiła	tʃ i n i w a
činja	tʃ i nʲ a
činjenju	tʃ i nʲ e nʲ u
činještaj	tʃ i nʲ e ʃ t a j
čiste	tʃ i s t e
čisće	tʃ i s tʃ e
čitali	tʃ i t a l i
čitanja	tʃ i t a nʲ a
čitanju	tʃ i t a nʲ u
čitanku	tʃ i t a n k u
čitanske	tʃ i t a n s k e
čitać	tʃ i t a tʃ
čitaštej	tʃ i t a ʃ t e j
čiń	tʃ i nʲ
čmjeła	tʃ mʲ e w a
čo	tʃ o
čorna	tʃ o ʀ n a
čornakec	tʃ o ʀ n a k e ts
čorneho	tʃ o ʀ n e h o
čornej	tʃ o ʀ n e j
čorneje	tʃ o ʀ n e j e
čorni	tʃ o ʀ n i
čornjowje	tʃ o ʀ nʲ o wʲ e
čornoboha	tʃ o ʀ n o b o h a
čornu	tʃ o ʀ n u
čornych	tʃ o ʀ n ɨ x
čornym	tʃ o ʀ n ɨ m
črijach	tʃ ʀ i j a x
črije	tʃ ʀ i j e
čuje	tʃ u j e
čěskej	tʃ ɪ s k e j
čěskim	tʃ ɪ s k i m
čěšćinje	tʃ ɪ ʃ tʃ i nʲ e
čłon	tʃ w o n
čłonam	tʃ w o n a m
čłonami	tʃ w o n a m i
čłonka	tʃ w o n k a
čłonojo	tʃ w o n o j o
čłonow	tʃ w o n o w
čłonske	tʃ w o n s k e
čłonskimi	tʃ w o n s k i m i
čłonstwo	tʃ w o n s t w o
čłowjek	tʃ w o wʲ e k
čłowjeka	tʃ w o wʲ e k a
čłowjekom	tʃ w o wʲ e k o m
čłowjestwa	tʃ w o wʲ e s t w a
łahodnje	w a h o d nʲ e
łaka	w a k a
ławce	w a w ts e
ławku	w a w k u
łopjeno	w o pʲ e n o
łoža	w o ʒ a
łožo	w o ʒ o
łožu	w o ʒ u
łubi	w u b i
łuce	w u ts e
łuki	w u k i
łuku	w u k u
łužica	w u ʒ i ts a
łužica-delnja	w u ʒ i ts a d e l nʲ a
łužicu	w u ʒ i ts u
łužicy	w u ʒ i ts ɨ
łužiska	w u ʒ i s k a
łužiskeho	w u ʒ i s k e h o
łužiskeje	w u ʒ i s k e j e
łužiskich	w u ʒ i s k i x
łužiskimi	w u ʒ i s k i m i
łódźnistwa	w ʊ dʒ n i s t w a
šampinjonow	ʃ a m p i nʲ o n o w
šansach	ʃ a n s a x
šansu	ʃ a n s u
šansy	ʃ a n s ɨ
šaty	ʃ a t ɨ
šaće	ʃ a tʃ e
šefa	ʃ e f a
šesćiměstow	ʃ e s tʃ i m ɪ s t o w
šišce	ʃ i ʃ ts e
škit	ʃ k i t
škitane	ʃ k i t a n e
škitaneje	ʃ k i t a n e j e
škitarka	ʃ k i t a ʀ k a
škitać	ʃ k i t a tʃ
škitne	ʃ k i t n e
škitom	ʃ k i t o m
škiće	ʃ k i tʃ e
škleńca	ʃ k l e nʲ ts a
škleńčki	ʃ k l e nʲ tʃ k i
šklě	ʃ k l ɪ
škoda	ʃ k o d a
škrički	ʃ k ʀ i tʃ k i
škričkowc	ʃ k ʀ i tʃ k o w ts
škódnikow	ʃ k ʊ d n i k o w
škórcy	ʃ k ʊ ʀ ts ɨ
škórnjach	ʃ k ʊ ʀ nʲ a x
šleska	ʃ l e s k a
šližika	ʃ l i ʒ i k a
šmecle	ʃ m e ts l e
šołćina	ʃ o w tʃ i n a
španiskeje	ʃ p a n i s k e j e
špatne	ʃ p a t n e
špihele	ʃ p i h e l e
štefi	ʃ t e f i
što	ʃ t o
štoma	ʃ t o m a
štomow	ʃ t o m o w
štomy	ʃ t o m ɨ
štož	ʃ t o ʒ
štryčkom	ʃ t ʀ ɨ tʃ k o m
štwórta	ʃ t w ʊ ʀ t a
štwórte	ʃ t w ʊ ʀ t e
štwórtk	ʃ t w ʊ ʀ t k
štwórtkach	ʃ t w ʊ ʀ t k a x
štwórty	ʃ t w ʊ ʀ t ɨ
štwórć	ʃ t w ʊ ʀ tʃ
štyri	ʃ t ɨ ʀ i
štyričłonkaty	ʃ t ɨ ʀ i tʃ w o n k a t ɨ
štyrjoch	ʃ t ɨ ʀʲ o x
štó	ʃ t ʊ
štóž	ʃ t ʊ ʒ
šula	ʃ u l a
šulach	ʃ u l a x
šulam	ʃ u l a m
šule	ʃ u l e
šulerja	ʃ u l e ʀʲ a
šulerjemi	ʃ u l e ʀʲ e m i
šulerjo	ʃ u l e ʀʲ o
šulerjow	ʃ u l e ʀʲ o w
šulerski	ʃ u l e ʀ s k i
šuli	ʃ u l i
šulow	ʃ u l o w
šulska	ʃ u l s k a
šulske	ʃ u l s k e
šulskeho	ʃ u l s k e h o
šulskej	ʃ u l s k e j
šulskeje	ʃ u l s k e j e
šulskemu	ʃ u l s k e m u
šulskich	ʃ u l s k i x
šulskim	ʃ u l s k i m
šulsku	ʃ u l s k u
šulu	ʃ u l u
šumješe	ʃ u mʲ e ʃ e
šwinca	ʃ w i n ts a
šćežkami	ʃ tʃ e ʒ k a m i
šćežki	ʃ tʃ e ʒ k i
šćežkow	ʃ tʃ e ʒ k o w
šěrimy	ʃ ɪ ʀ i m ɨ
šěrinach	ʃ ɪ ʀ i n a x
šěroki	ʃ ɪ ʀ o k i
šěrokim	ʃ ɪ ʀ o k i m
šěsć	ʃ ɪ s tʃ
šło	ʃ w o
žabow	ʒ a b o w
žabu	ʒ a b u
žada	ʒ a d a
žadaja	ʒ a d a j a
žadamy	ʒ a d a m ɨ
žadanja	ʒ a d a nʲ a
žadanje	ʒ a d a nʲ e
žadaše	ʒ a d a ʃ e
žadyn	ʒ a d ɨ n
žana	ʒ a n a
žane	ʒ a n e
žani	ʒ a n i
žanoho	ʒ a n o h o
žanu	ʒ a n u
žanych	ʒ a n ɨ x
žarliwa	ʒ a ʀ l i w a
žałostny	ʒ a w o s t n ɨ
žehliwa	ʒ e h l i w a
železa	ʒ e l e z a
železnica	ʒ e l e z n i ts a
ženje	ʒ e nʲ e
židow	ʒ i d o w
židowskim	ʒ i d o w s k i m
žitawa	ʒ i t a w a
žitawje	ʒ i t a wʲ e
žiwa	ʒ i w a
žiwe	ʒ i w e
žiwjenja	ʒ i wʲ e nʲ a
žiwjenjahódny	ʒ i wʲ e nʲ a h ʊ d n ɨ
žiwjenje	ʒ i wʲ e nʲ e
žiwjenju	ʒ i wʲ e nʲ u
žiwjenskeho	ʒ i wʲ e n s k e h o
žiwjenski	ʒ i wʲ e n s k i
žiwjenskich	ʒ i wʲ e n s k i x
žiwjensku	ʒ i wʲ e n s k u
žiwu	ʒ i w u
žiwy	ʒ i w ɨ
žnjenskich	ʒ nʲ e n s k i x
žona	ʒ o n a
žonopowe	ʒ o n o p o w e
žonu	ʒ o n u
žony	ʒ o n ɨ
žortne	ʒ o ʀ t n e
žratwu	ʒ ʀ a t w u
župa	ʒ u p a
župy	ʒ u p ɨ
žurli	ʒ u ʀ l i
žónsku	ʒ ʊ n s k u
＜lachen＞	spn
＜laughter＞	spn
＜laugh＞	spn
＜lg＞	spn
